price,bedrooms,bathrooms,sqft_living,sqft_lot,sqft_above,sqft_basement,lat,long
221900,3,1,1180,5650,1180,0,47.5112,-122.257
538000,3,2.25,2570,7242,2170,400,47.721,-122.319
180000,2,1,770,10000,770,0,47.7379,-122.233
604000,4,3,1960,5000,1050,910,47.5208,-122.393
510000,3,2,1680,8080,1680,0,47.6168,-122.045
1.225E+06,4,4.5,5420,101930,3890,1530,47.6561,-122.005
257500,3,2.25,1715,6819,1715,0,47.3097,-122.327
291850,3,1.5,1060,9711,1060,0,47.4095,-122.315
229500,3,1,1780,7470,1050,730,47.5123,-122.337
323000,3,2.5,1890,6560,1890,0,47.3684,-122.031
662500,3,2.5,3560,9796,1860,1700,47.6007,-122.145
468000,2,1,1160,6000,860,300,47.69,-122.292
310000,3,1,1430,19901,1430,0,47.7558,-122.229
400000,3,1.75,1370,9680,1370,0,47.6127,-122.045
530000,5,2,1810,4850,1810,0,47.67,-122.394
650000,4,3,2950,5000,1980,970,47.5714,-122.375
395000,3,2,1890,14040,1890,0,47.7277,-121.962
485000,4,1,1600,4300,1600,0,47.6648,-122.343
189000,2,1,1200,9850,1200,0,47.3089,-122.21
230000,3,1,1250,9774,1250,0,47.3343,-122.306
385000,4,1.75,1620,4980,860,760,47.7025,-122.341
2E+06,3,2.75,3050,44867,2330,720,47.5316,-122.233
285000,5,2.5,2270,6300,2270,0,47.3266,-122.169
252700,2,1.5,1070,9643,1070,0,47.3533,-122.166
329000,3,2.25,2450,6500,2450,0,47.3739,-122.172
233000,3,2,1710,4697,1710,0,47.3048,-122.218
937000,3,1.75,2450,2691,1750,700,47.6386,-122.36
667000,3,1,1400,1581,1400,0,47.6221,-122.314
438000,3,1.75,1520,6380,790,730,47.695,-122.304
719000,4,2.5,2570,7173,2570,0,47.7073,-122.11
580500,3,2.5,2320,3980,2320,0,47.5391,-122.07
280000,2,1.5,1190,1265,1190,0,47.7274,-122.357
687500,4,1.75,2330,5000,1510,820,47.6823,-122.368
535000,3,1,1090,3000,1090,0,47.6889,-122.375
322500,4,2.75,2060,6659,1280,780,47.4276,-122.157
696000,3,2.5,2300,3060,1510,790,47.6827,-122.31
550000,4,1,1660,34848,930,730,47.6621,-122.132
640000,4,2,2360,6000,2360,0,47.6702,-122.362
240000,4,1,1220,8075,890,330,47.3341,-122.282
605000,4,2.5,2620,7553,2620,0,47.5301,-122.18
625000,4,2.5,2570,5520,2570,0,47.6145,-122.027
775000,4,2.25,4220,24186,2600,1620,47.445,-122.347
861990,5,2.75,3595,5639,3595,0,47.6848,-122.016
685000,3,1,1570,2280,1570,0,47.6413,-122.364
309000,3,1,1280,9656,920,360,47.4485,-122.175
488000,3,2.5,3160,13603,3160,0,47.7443,-121.977
210490,3,1,990,8528,990,0,47.3066,-122.371
785000,4,2.5,2290,13416,2290,0,47.6194,-122.151
450000,3,1.75,1250,5963,1250,0,47.6796,-122.301
1.35E+06,3,2.5,2753,65005,2165,588,47.4041,-122.451
228000,3,1,1190,9199,1190,0,47.4258,-122.322
345000,5,2.5,3150,9134,1640,1510,47.4934,-122.189
600000,3,1.75,1410,4080,1000,410,47.6808,-122.384
585000,2,1.75,1980,8550,990,990,47.6989,-122.369
920000,5,2.25,2730,6000,2130,600,47.6571,-122.281
885000,4,2.5,2830,5000,2830,0,47.6597,-122.29
292500,4,2.5,2250,4495,2250,0,47.3663,-122.114
301000,3,2.5,2420,4750,2420,0,47.3663,-122.122
951000,5,3.25,3250,14342,3250,0,47.588,-122.116
430000,4,3,1850,9976,1850,0,47.5059,-122.149
650000,3,2.25,2150,21235,1590,560,47.4336,-122.339
289000,3,1.75,1260,8400,1260,0,47.4366,-122.335
505000,3,1.75,2519,8690,2519,0,47.4428,-122.344
549000,3,1.75,1540,1044,1540,0,47.6765,-122.32
425000,3,2.25,1660,6000,1110,550,47.6113,-122.297
317625,3,2.75,2770,3809,1770,1000,47.5747,-122.304
975000,4,2.5,2720,11049,2720,0,47.5815,-122.192
287000,4,2.5,2240,4648,2240,0,47.3378,-122.257
204000,3,1,1000,12070,1000,0,47.3621,-122.11
1.325E+06,5,2.25,3200,20158,1600,1600,47.6303,-122.215
1.04E+06,5,3.25,4770,50094,3070,1700,47.6525,-122.16
325000,3,2,1260,5612,1260,0,47.7362,-122.179
571000,4,2,2750,7807,2250,500,47.7168,-122.287
360000,4,2.5,2380,5000,2380,0,47.3608,-122.036
349000,3,1.75,1790,50529,1090,700,47.3511,-122.073
832500,4,4,3430,35102,2390,1040,47.5822,-121.987
380000,4,1.75,1760,7300,880,880,47.6034,-122.125
480000,3,1,1040,5060,1040,0,47.5636,-122.394
410000,3,1,1410,5060,910,500,47.7073,-122.34
720000,4,2.5,3450,39683,3450,0,47.342,-122.025
390000,3,2.5,2350,5100,2350,0,47.3512,-122.008
360000,4,2.5,1900,5889,1900,0,47.349,-122.031
355000,2,1,2020,6720,1010,1010,47.5474,-122.291
356000,3,1.5,1680,8712,1680,0,47.4811,-122.149
315000,3,1,960,6634,960,0,47.7264,-122.31
940000,3,1.5,2140,3600,1900,240,47.6337,-122.365
305000,5,2.25,2660,8400,2660,0,47.2909,-122.189
461000,3,3.25,2770,6278,1980,790,47.5228,-122.199
215000,2,2.25,1610,2040,1610,0,47.518,-122.194
335000,2,1.75,1030,1066,765,265,47.5394,-122.387
243500,4,2.5,1980,7403,1980,0,47.2897,-122.372
1.09988E+06,5,2.75,3520,6353,3520,0,47.6506,-122.391
153000,3,1,1200,10500,1200,0,47.322,-122.351
430000,3,1.5,1580,5000,1290,290,47.687,-122.386
700000,3,1.5,1580,5000,1290,290,47.687,-122.386
905000,4,2.5,3300,10250,2390,910,47.5873,-122.249
247500,3,1.75,1960,15681,1960,0,47.3576,-122.277
199000,4,1.5,1160,6400,1160,0,47.3036,-122.378
314000,3,1.75,1810,41800,1210,600,47.4109,-121.958
437500,3,2.5,2320,36847,2320,0,47.4838,-121.714
850830,3,2.5,2070,13241,1270,800,47.6415,-122.315
555000,3,2,1980,3478,1440,540,47.6775,-122.372
699950,3,2.25,2190,107593,2190,0,47.7731,-122.08
1.088E+06,3,2.5,2920,8113,2920,0,47.5814,-122.196
290000,3,1,1210,33919,1210,0,47.4375,-122.184
375000,3,2.5,2340,10005,1460,880,47.4431,-122.133
460000,3,1,1670,4005,1170,500,47.6878,-122.38
188500,2,1.75,1240,2493,1240,0,47.3813,-122.322
680000,4,2.5,3140,28037,3140,0,47.7304,-122.082
470000,5,1.75,2030,12342,2030,0,47.6417,-122.109
597750,4,2.5,2310,9624,2310,0,47.5386,-122.053
570000,3,1.75,1260,3328,700,560,47.6823,-122.349
272500,3,1.75,1540,12600,1160,380,47.3624,-122.031
329950,3,1.75,2080,5969,1080,1000,47.5474,-122.295
480000,4,2.5,3230,16171,2520,710,47.3183,-122.253
740500,3,3.5,4380,6350,2780,1600,47.6981,-122.368
518500,3,3.5,1590,1102,1590,0,47.6824,-122.347
205425,2,1,880,6780,880,0,47.5009,-122.248
171800,4,2,1570,9600,1570,0,47.4965,-122.303
535000,4,1,1610,2982,1610,0,47.587,-122.294
660000,3,2.5,2400,6474,1560,840,47.7728,-122.386
391500,3,2,1450,9132,1450,0,47.7288,-122.226
395000,2,1,770,6000,770,0,47.6999,-122.364
445000,4,1.75,2100,4400,1720,380,47.5299,-122.266
770000,3,2.25,2910,10204,2910,0,47.6897,-122.098
1.45E+06,4,2.75,2750,17789,1980,770,47.6141,-122.212
445000,3,2.25,2100,8201,1620,480,47.5091,-122.244
260000,4,2.25,2160,8811,1360,800,47.3129,-122.39
822500,5,3.5,2320,4960,1720,600,47.6763,-122.352
430000,4,2.5,2070,4310,2070,0,47.5319,-121.85
212000,3,1.75,1060,7875,1060,0,47.2761,-122.152
660500,4,2.25,2010,9603,1440,570,47.5343,-122.054
784000,3,3.5,3950,111078,2460,1490,47.697,-122.072
453246,3,2.5,2010,2287,1390,620,47.5517,-121.998
675000,4,3.5,2140,2278,2140,0,47.6734,-122.38
199000,3,1.75,1320,17390,1320,0,47.3257,-122.296
220000,4,1.75,2020,7840,1010,1010,47.3309,-122.299
452000,4,2.25,2590,10002,1340,1250,47.7689,-122.266
382500,2,1,1190,4440,1190,0,47.7135,-122.287
519950,3,2.25,1170,1249,1170,0,47.6722,-122.381
665000,2,1,1110,3200,1110,0,47.6338,-122.358
527700,5,2.5,2820,9375,1550,1270,47.5707,-122.128
205000,3,1,1610,8579,1010,600,47.4563,-122.171
420000,3,1,1060,8097,940,120,47.7144,-122.351
500000,4,2.25,2030,8517,1380,650,47.5495,-122.174
921500,4,2.5,3670,315374,3670,0,47.7421,-122.026
890000,4,1,2550,4000,2370,180,47.6354,-122.353
430000,2,2.5,2420,60984,2420,0,47.5262,-121.943
258000,5,2,2260,12500,1130,1130,47.3887,-122.286
511000,3,1,1430,3455,980,450,47.6873,-122.336
532170,3,2,1360,3090,1360,0,47.6838,-122.353
560000,3,1,1110,5000,1110,0,47.655,-122.359
282950,3,1,1250,8200,1250,0,47.3255,-122.304
2.25E+06,4,3.25,5180,19850,3540,1640,47.562,-122.162
350000,1,1,700,5100,700,0,47.679,-122.3
215000,3,1,1180,7669,1180,0,47.4479,-122.176
650000,5,3.5,3960,25245,2500,1460,47.525,-122.172
320000,4,2.75,2640,7500,1620,1020,47.3135,-122.369
247000,3,2,1270,7198,1270,0,47.2086,-121.996
320000,4,1.75,1760,11180,1760,0,47.4715,-122.118
255000,5,2.25,2060,8632,1030,1030,47.4877,-122.335
438000,3,1.75,1780,9660,1780,0,47.7171,-122.193
900000,3,2.5,3400,16603,3400,0,47.6012,-122.023
441000,3,2.75,1910,7280,1160,750,47.7319,-122.224
420000,3,2,2020,38332,1010,1010,47.4582,-122.023
370000,3,1.75,1580,7000,1180,400,47.7209,-122.168
269950,2,1.75,1340,7250,700,640,47.408,-122.327
807100,4,2.5,2680,4499,2680,0,47.565,-122.125
653000,3,2.5,2680,9750,1610,1070,47.7028,-122.231
371500,3,2,1370,8336,1370,0,47.7458,-122.331
284000,3,1.75,1560,21000,1560,0,47.4776,-122.337
272000,3,1.75,2160,7140,1670,490,47.3026,-122.374
313000,3,1.5,1340,7912,1340,0,47.7658,-122.339
917500,4,2.5,3880,35003,2570,1310,47.6477,-122.182
673000,4,2.25,2590,8190,2590,0,47.5619,-122.125
425000,3,2.5,1120,1100,820,300,47.6106,-122.31
399950,5,2.75,1970,5400,1320,650,47.5868,-122.308
385000,3,1,1220,4800,1220,0,47.6101,-122.307
269950,3,1.5,1950,7560,1320,630,47.1976,-121.999
330000,2,1,1350,8220,1060,290,47.7224,-122.358
260000,3,2.5,1670,5797,1670,0,47.3505,-122.179
470000,4,3,2380,5125,1680,700,47.5384,-122.376
589000,4,3,2440,9600,2440,0,47.7044,-122.2
163500,2,1.5,1050,3419,1050,0,47.3848,-122.039
835000,4,2.75,3130,13412,2140,990,47.6993,-122.102
1.095E+06,5,3,4090,12850,2090,2000,47.6627,-122.188
269000,4,1.75,1490,10000,1100,390,47.3099,-122.379
560000,3,2.5,1900,8744,1900,0,47.62,-122.043
615000,4,1,1330,2400,1330,0,47.65,-122.34
585188,3,2.25,2230,10026,1430,800,47.6647,-122.153
305000,3,1.75,1650,9480,1220,430,47.726,-122.191
166950,3,1,1190,8820,1190,0,47.4616,-122.184
799000,3,2.5,2140,9897,2140,0,47.5505,-122.219
400000,3,2.5,2180,7508,1420,760,47.7606,-122.336
230000,3,1,1060,10228,1060,0,47.7481,-122.3
256883,3,2.5,1690,5025,1690,0,47.2779,-122.347
423000,4,2,1970,6480,1130,840,47.5511,-122.312
465000,3,2.5,2150,4084,2150,0,47.5488,-122.372
440000,3,2.5,1910,66211,1910,0,47.5385,-121.911
385000,3,1.75,1350,155073,1350,0,47.4058,-121.994
210000,3,1,860,11725,860,0,47.5093,-122.184
297000,3,2.5,1940,14952,1940,0,47.3777,-122.165
470000,3,1,1010,5000,1010,0,47.675,-122.394
226500,3,1.5,1300,7370,900,400,47.3025,-122.37
274250,3,1,910,8450,910,0,47.4787,-122.158
840000,4,1.75,2480,11010,1630,850,47.5378,-122.219
677900,3,2.5,2440,4587,2440,0,47.7073,-122.114
425000,3,1,1010,5864,1010,0,47.5733,-122.381
180250,2,0.75,900,9600,900,0,47.4604,-122.339
464000,6,3,2300,3404,1600,700,47.7067,-122.343
320000,4,2.25,1550,7579,1550,0,47.354,-122.047
625504,3,2.25,1270,1566,1060,210,47.6647,-122.284
592500,4,2.5,2240,12032,2240,0,47.6143,-122.017
465000,3,2.5,2714,17936,2714,0,47.3185,-122.275
477000,4,2.75,1720,6270,1720,0,47.5458,-122.268
280000,2,1,850,16400,850,0,47.4889,-122.299
1.505E+06,5,3,3300,33474,1870,1430,47.5673,-122.21
445838,3,2.5,2250,5692,2250,0,47.5133,-122.379
1.072E+06,2,2.25,3900,14864,1950,1950,47.5884,-122.291
467000,2,1.5,1320,10800,1320,0,47.7145,-122.367
686000,4,2.5,2760,6440,2760,0,47.5836,-122.026
279950,3,2,1750,9750,1350,400,47.398,-122.299
527000,4,2.25,2330,19436,2330,0,47.7663,-122.215
325000,3,2.25,2220,16020,1780,440,47.3758,-122.217
328000,3,2.25,2020,8379,2020,0,47.3828,-122.023
390000,3,2.25,1250,7500,1250,0,47.5123,-122.373
479950,2,2,1510,6516,1510,0,47.7076,-122.013
264950,4,2.25,1720,9753,1120,600,47.2922,-122.371
235000,3,1,1430,15246,980,450,47.4075,-122.214
516500,3,2.5,1480,4729,1480,0,47.6794,-122.034
655000,2,1.75,1450,15798,1230,220,47.4497,-122.375
500000,4,2.75,2280,15347,2280,0,47.5218,-122.164
315000,6,2.75,2940,7350,1780,1160,47.3103,-122.339
213000,2,1,1000,10200,1000,0,47.5687,-121.899
475000,3,1.5,2480,5280,1620,860,47.5575,-122.303
1.025E+06,5,4,3760,28040,3760,0,47.6489,-122.183
416000,3,2,2220,94300,1640,580,47.3459,-121.95
410000,4,1,1970,4740,1670,300,47.6136,-122.303
800000,3,3.5,3830,221284,3530,300,47.7641,-122.023
472000,6,2.5,4410,14034,2350,2060,47.3376,-122.324
225000,3,1.75,1430,8505,1430,0,47.3173,-122.319
210000,2,1,830,6000,830,0,47.5308,-122.376
455000,2,1,1430,5000,1430,0,47.6727,-122.299
225000,3,1,1300,8316,1300,0,47.3221,-122.216
480000,2,1,1030,3060,790,240,47.6779,-122.353
363000,3,2.5,2740,11872,2740,0,47.3076,-122.395
2.4E+06,4,2.5,3650,8354,1830,1820,47.6338,-122.072
181000,2,1.5,720,5120,720,0,47.5218,-122.357
250000,4,2,2010,7312,2010,0,47.2785,-122.213
481000,3,1.75,1560,3000,770,790,47.6846,-122.345
260000,3,2,1810,7209,1240,570,47.3656,-122.278
455000,4,2.5,3360,7685,3360,0,47.4369,-122.111
415000,3,2.25,1510,36224,1510,0,47.4616,-121.711
349500,3,1,1400,3538,800,600,47.5405,-122.27
245000,3,2.5,1730,7442,1730,0,47.3507,-122.178
592500,2,2,1420,9191,1420,0,47.6979,-122.32
385000,4,1.75,2360,7620,1180,1180,47.5278,-122.345
315000,3,1.75,1580,11455,1200,380,47.4756,-122.147
255000,3,1,1230,10170,1230,0,47.4437,-121.772
693000,4,2.5,2460,4425,2460,0,47.7048,-122.109
780000,3,1,1660,4400,1460,200,47.6362,-122.302
237000,3,1.75,1270,8470,1270,0,47.4207,-122.29
525000,3,2.25,2100,40510,1320,780,47.6154,-122.047
425000,2,1,770,5040,770,0,47.5964,-122.299
369900,1,0.75,760,10079,760,0,47.4683,-122.438
290000,4,2.5,1700,7280,1700,0,47.4045,-122.171
285000,3,1,1120,10701,1120,0,47.5544,-122.358
415000,2,1,1070,4500,1070,0,47.6802,-122.29
272500,3,2.5,2070,9900,1420,650,47.2988,-122.371
2.9E+06,4,3.25,5050,20100,4750,300,47.6312,-122.223
1.365E+06,4,4.75,5310,57346,5310,0,47.7285,-122.042
436000,2,1,1040,7538,1040,0,47.7107,-122.352
210000,3,1,1700,11390,1700,0,47.3271,-122.323
236000,3,1,1300,5898,1300,0,47.5053,-122.255
331000,3,1.75,1080,1306,580,500,47.6601,-122.4
365000,3,2.5,2653,4510,2653,0,47.4145,-122.166
450000,3,2,2290,16258,2290,0,47.4672,-122.165
770000,4,2.75,3820,26300,2850,970,47.7618,-122.261
455000,4,2.5,2210,49375,2210,0,47.3828,-122.071
405000,3,1.75,2390,6000,1240,1150,47.5362,-122.268
304900,4,1.75,2600,11325,1610,990,47.3954,-122.206
170000,2,1,860,5265,860,0,47.5048,-122.272
2.05E+06,5,3,3830,8480,2630,1200,47.6166,-122.287
780000,4,2.5,3500,7048,3500,0,47.6811,-122.025
330000,3,3,2420,13959,1740,680,47.7486,-122.23
370000,4,2.5,2720,8666,2720,0,47.3846,-122.169
467000,5,2.25,2500,13500,1850,650,47.7564,-122.144
405000,3,1.75,1670,6720,1140,530,47.7198,-122.193
675000,5,2.25,2900,10300,1450,1450,47.5461,-122.151
500000,2,1,1640,14100,1140,500,47.5712,-122.143
389999,4,2.5,1890,15770,1890,0,47.4281,-122.343
630000,4,1.75,2950,9025,1780,1170,47.7128,-122.223
360000,4,2.5,2160,9528,2160,0,47.3341,-122.255
580000,4,3,3280,11060,2270,1010,47.5399,-122.181
550000,3,2,1970,4166,1270,700,47.5717,-122.375
879000,4,2.5,3360,22111,3360,0,47.5951,-122.017
265000,3,2,1320,8959,1320,0,47.3536,-122.144
446500,3,2.5,2650,7286,2650,0,47.5084,-122.154
404000,3,1.5,2030,8880,1330,700,47.5586,-122.311
267500,3,1.75,1590,11914,1090,500,47.4427,-122.274
3.075E+06,4,5,4550,18641,2600,1950,47.6053,-122.077
335000,3,2.5,2440,7632,2440,0,47.3494,-122.301
576000,3,2.5,1940,9000,970,970,47.6933,-122.393
208633,3,2.5,2040,3810,2040,0,47.3537,-122
315000,3,2.25,2200,8750,1120,1080,47.476,-122.337
725000,3,1.75,1920,3300,960,960,47.6239,-122.298
550000,4,2.75,1800,7750,1400,400,47.7776,-122.384
610750,4,2.25,2180,7297,2180,0,47.6459,-122.058
550700,2,1,1010,5000,1010,0,47.6692,-122.297
665000,4,2.75,3320,10574,2220,1100,47.5376,-122.18
834000,4,2.5,2370,4000,1980,390,47.601,-122.294
201000,5,1.75,1660,78408,1660,0,47.529,-121.837
2.384E+06,5,2.5,3650,9050,3370,280,47.6345,-122.367
1.384E+06,4,3.25,4290,12103,2690,1600,47.5503,-122.102
1.4E+06,4,3.25,4290,12103,2690,1600,47.5503,-122.102
305000,4,2.25,1950,7700,1350,600,47.4441,-122.125
487000,3,2,2590,14052,1720,870,47.7357,-122.333
390000,3,2.5,1930,64904,1930,0,47.346,-122.157
548000,2,1,1470,3864,1170,300,47.6638,-122.345
268750,4,1,800,8775,800,0,47.48,-122.336
819900,5,2.75,3150,7119,3150,0,47.6759,-122.151
520000,3,2.25,2030,16200,2030,0,47.5162,-122.057
230000,3,2,1450,11204,1450,0,47.2639,-122.252
240000,3,1.75,1510,10248,1510,0,47.2929,-122.371
232000,2,1,1240,12092,960,280,47.4957,-122.352
240500,2,1,1240,12092,960,280,47.4957,-122.352
274975,3,2.5,3030,45004,3030,0,47.7721,-122.093
740000,4,2,2050,4400,2050,0,47.644,-122.319
186375,3,1,1000,7636,1000,0,47.472,-122.344
790000,3,2.25,2370,10289,1590,780,47.592,-122.166
880000,4,3.5,2800,6750,1890,910,47.669,-122.275
279000,6,1.75,2240,11180,2240,0,47.42,-122.323
295000,3,2,1810,10530,1810,0,47.1913,-122.012
640000,2,1,1070,5000,1070,0,47.6666,-122.331
940000,4,2,2490,9525,2490,0,47.5639,-122.217
260000,4,2.5,1960,5238,1960,0,47.3483,-122.052
559900,3,2.75,2930,5569,1860,1070,47.7648,-122.164
791500,4,2,1510,3500,1510,0,47.6794,-122.357
265000,3,1.75,1420,8250,1420,0,47.7535,-122.354
245000,3,1.75,1740,11547,1740,0,47.4945,-122.22
485000,4,1.75,2560,43995,2560,0,47.6945,-122.093
684000,4,3.5,3040,8414,2420,620,47.5222,-122.157
425000,3,1.75,2500,6840,1300,1200,47.7222,-122.32
309600,4,1.75,1275,20000,1275,0,47.3796,-122.49
552250,4,2.5,2580,5823,2580,0,47.5374,-121.875
165000,4,1,1000,7134,1000,0,47.4897,-122.24
239900,4,1,1000,7134,1000,0,47.4897,-122.24
320000,2,1,1070,32633,1070,0,47.4716,-122.078
206600,3,2,1390,13464,1390,0,47.3581,-122.173
387000,4,1.75,2500,7690,1250,1250,47.7713,-122.307
299000,1,0.75,560,12120,560,0,47.675,-121.854
855000,4,2.75,2270,10460,2270,0,47.5603,-122.222
315000,3,1,1900,14400,1300,600,47.4147,-122.337
437500,2,1,990,3120,790,200,47.68,-122.353
252000,4,1.5,1550,19800,1050,500,47.3117,-122.27
375000,4,1.75,2200,7475,1100,1100,47.543,-122.28
300000,4,2.5,1910,4862,1910,0,47.3607,-122.034
420000,4,1,1750,9600,1750,0,47.5759,-122.137
900000,3,1,1330,77972,1330,0,47.6891,-122.159
679900,3,2.5,2440,5750,1980,460,47.565,-122.381
463000,3,2.5,1640,29970,1640,0,47.6359,-121.974
380000,5,2.5,2760,11340,2760,0,47.4769,-122.141
329500,4,2.5,1820,7912,1820,0,47.3845,-122.029
604950,3,2.5,2110,5608,1340,770,47.6743,-122.184
795000,5,2.5,3040,9570,1640,1400,47.5651,-122.164
465000,3,2,1840,40438,1840,0,47.4853,-121.709
673000,4,2.5,2990,10400,2990,0,47.4508,-122.359
810000,4,2.5,3520,15420,3520,0,47.6375,-122.016
785000,4,2.75,2440,69415,1910,530,47.5944,-122.042
338000,4,3,2090,7500,1370,720,47.4888,-122.182
280000,3,2.25,1430,7222,1430,0,47.5112,-122.19
315000,4,2.25,2180,10754,1100,1080,47.7711,-122.341
530000,4,2.25,2180,10754,1100,1080,47.7711,-122.341
380000,5,3,3450,9914,3450,0,47.2813,-122.345
297000,3,2.25,1450,7562,1450,0,47.5038,-122.189
730000,4,2.5,3230,7331,3230,0,47.5823,-121.97
450000,3,1.75,1640,13500,1110,530,47.7164,-122.304
275000,3,3,1590,7750,1060,530,47.3624,-122.045
595000,4,2,2020,2849,2020,0,47.6831,-122.329
435000,3,1.5,1300,3348,1300,0,47.592,-122.307
270000,2,1.5,1380,209959,1380,0,47.7461,-122.195
950000,3,3,4040,14338,3030,1010,47.7268,-122.06
389000,4,2.25,2130,5337,2130,0,47.7237,-121.959
560000,4,2.25,2550,7800,1580,970,47.6283,-122.095
1.35E+06,5,3.5,4800,14984,3480,1320,47.5543,-122.148
799000,4,2.25,2510,11585,2510,0,47.5483,-122.226
365500,3,2,1410,9600,1410,0,47.7591,-122.146
252350,3,2,1650,7352,1160,490,47.4612,-122.169
403950,4,2.5,2120,13780,2120,0,47.4987,-122.365
385000,4,1.5,2040,10726,1380,660,47.772,-122.358
345000,4,1,1550,7620,1550,0,47.5287,-122.35
490000,3,2.75,1980,3128,1980,0,47.6109,-122.114
330000,3,2.5,1600,26977,1600,0,47.7736,-121.901
927000,4,2.75,3300,12090,3300,0,47.6294,-122.218
1.118E+06,4,2.5,3840,16619,3840,0,47.5634,-122.213
330000,2,1,1220,10000,1220,0,47.7405,-122.241
530000,5,2.25,2720,8800,1500,1220,47.5976,-122.118
365000,4,2,1940,25600,1940,0,47.5722,-122.129
378750,3,2.5,2160,3000,1260,900,47.5644,-122.289
269900,4,1.75,1530,8750,1530,0,47.4556,-122.157
557000,3,3.5,1710,2096,1290,420,47.6055,-122.305
360000,4,1.75,3730,16980,2150,1580,47.1775,-122.022
352000,2,1,940,5000,940,0,47.6879,-122.385
437000,3,2.5,1750,22357,1750,0,47.4807,-121.779
322500,4,2.5,1820,6753,1820,0,47.3845,-122.032
650000,3,3.25,1510,2000,1330,180,47.5815,-122.402
450000,3,2,1290,1213,1290,0,47.6609,-122.344
278500,3,2,1570,5250,1570,0,47.3163,-122.188
364950,4,2.5,1930,6957,1930,0,47.4309,-122.191
840000,4,3.5,2840,40139,2840,0,47.401,-122.026
268000,3,2.5,1550,8134,1550,0,47.404,-122.191
517534,2,1,833,143947,833,0,47.3889,-122.482
632925,3,2.5,2990,32239,2990,0,47.7718,-122.095
577500,3,2.5,2000,7251,2000,0,47.7067,-122.2
339000,4,1.5,2390,7480,2390,0,47.504,-122.227
570000,3,1.75,2910,37461,1530,1380,47.7015,-122.164
563500,4,1.75,2085,174240,1610,475,47.5753,-121.95
423000,4,2.25,2200,9351,1290,910,47.7448,-122.333
355000,3,2.25,1860,5028,1860,0,47.7318,-121.982
1.55E+06,5,4.25,6070,171626,6070,0,47.5954,-121.95
482000,2,1,950,3960,950,0,47.6885,-122.337
625000,3,1.75,1600,9135,1600,0,47.5724,-122.179
538000,3,2.5,2250,11632,2250,0,47.5272,-122.169
380000,3,2.5,2280,10255,2280,0,47.4334,-122.161
375000,2,1,940,5120,940,0,47.6073,-122.308
245000,3,2.5,1530,8500,1030,500,47.3592,-122.046
310000,5,1.75,2190,27260,2190,0,47.4546,-122.337
1.3E+06,3,2,2350,15021,1770,580,47.6408,-122.219
397000,4,2,1440,7680,1200,240,47.7245,-122.2
365000,3,2.5,2200,4052,2200,0,47.4362,-122.178
328500,4,3,2290,8250,2290,0,47.3739,-122.156
988000,4,3,4040,19700,4040,0,47.7205,-122.127
1E+06,4,2.5,2610,3277,1920,690,47.6636,-122.33
237000,3,2.5,1490,2138,1490,0,47.4324,-122.197
525000,4,2.5,2450,5280,2450,0,47.7734,-122.224
749000,4,2.5,1710,9627,1440,270,47.559,-122.164
722500,5,2.5,4870,11800,3470,1400,47.633,-122.041
843000,3,2.5,3130,8750,3130,0,47.6954,-122.103
438000,2,2,1270,1372,1270,0,47.6776,-122.318
578000,3,1.75,2120,10875,1540,580,47.504,-122.382
227950,3,1.5,1670,8230,1670,0,47.2613,-122.255
196000,3,2.25,2070,11576,2070,0,47.3417,-122.271
641000,2,1,1420,5332,1070,350,47.6694,-122.275
350000,3,1.5,1250,219978,1250,0,47.4056,-121.955
205000,3,1,940,7980,940,0,47.3838,-122.289
400000,3,1.75,1920,9102,1920,0,47.7487,-122.082
1.03E+06,3,2.5,3545,9816,2610,935,47.5534,-122.078
505000,3,2,1260,5460,1260,0,47.7355,-122.18
475000,5,2.5,2340,7200,1300,1040,47.7206,-122.211
520000,3,2.25,2590,9263,1440,1150,47.7691,-122.262
1.45E+06,3,4.5,3970,24920,3260,710,47.7183,-122.258
333500,3,1.75,1220,9732,1220,0,47.7736,-122.214
232000,3,1,1400,10403,1400,0,47.362,-122.029
691100,3,2.75,2360,16117,1710,650,47.5698,-122.121
811000,3,1.75,1870,9897,1870,0,47.5505,-122.221
551000,3,2.5,2830,5802,2830,0,47.7605,-122.234
496500,3,2.5,2260,3640,2260,0,47.7356,-122.157
705000,3,3,1970,20978,1770,200,47.3844,-122.438
578000,4,2.5,3140,9225,1770,1370,47.4904,-122.226
255000,3,1.75,1240,8659,1240,0,47.3663,-122.089
1.05E+06,4,3.5,3450,7832,3450,0,47.5637,-122.123
348000,3,2.25,2570,8491,2570,0,47.3759,-122.125
230000,3,2,1510,3413,1510,0,47.3912,-122.167
359500,4,2.25,2390,11250,2390,0,47.3305,-122.371
330000,3,1,980,7000,980,0,47.7617,-122.357
80000,1,0.75,430,5050,430,0,47.6499,-121.909
465000,3,1.75,1480,6360,1480,0,47.7311,-122.353
325000,4,2.5,1850,7324,1850,0,47.3701,-122.107
340500,3,2,2270,28025,1920,350,47.4857,-122.318
342500,3,2.5,1810,5192,1810,0,47.3724,-122.042
290900,2,2,1610,17600,1610,0,47.4855,-122.266
868700,3,4.25,3840,6161,3840,0,47.6336,-122.064
1.199E+06,4,2.75,4110,8400,3130,980,47.717,-122.281
1.15E+06,4,3.25,4190,10259,3150,1040,47.6332,-122.066
859900,4,2.75,3390,6298,3390,0,47.5906,-122.062
520000,4,2.25,1890,3006,1890,0,47.5461,-121.998
460000,3,2.5,1610,2527,1080,530,47.5674,-122.29
438924,3,1.5,1050,4590,850,200,47.6943,-122.29
315000,2,1,630,6550,630,0,47.5486,-122.38
590000,4,2.75,2910,10650,1780,1130,47.6658,-122.188
378500,4,1.75,1700,8640,850,850,47.5772,-122.153
328500,3,2.5,1950,8130,1950,0,47.3875,-122.161
849950,3,3,2990,9773,2990,0,47.6344,-122.174
525000,3,1.5,1350,6000,900,450,47.5275,-122.391
1.385E+06,4,3.25,4860,181319,4860,0,47.6179,-122.005
295000,4,2.5,2160,7725,1460,700,47.3078,-122.378
1.067E+06,6,3.5,4860,11793,3860,1000,47.5521,-122.137
207950,2,2,890,5000,890,0,47.5158,-122.264
699900,4,2.75,2810,7302,2810,0,47.5985,-121.977
1.28E+06,5,2.5,3400,9500,3400,0,47.5645,-122.082
452000,4,1.5,1580,7350,960,620,47.6734,-122.154
370000,3,2,1680,5036,1680,0,47.4734,-122.186
232000,3,1.75,1300,11230,1300,0,47.3811,-122.087
669950,5,2.5,2820,14062,2380,440,47.7081,-122.215
397500,3,2,1510,6710,1070,440,47.7193,-122.216
490000,2,2.5,1230,1391,870,360,47.6192,-122.301
725000,4,2,2110,4140,1710,400,47.5836,-122.387
299000,3,2.75,3080,19635,1610,1470,47.3841,-122.284
625000,2,1.5,1490,5750,1190,300,47.5872,-122.39
437500,3,2.5,2120,4500,2120,0,47.5322,-121.88
650000,4,2.5,3180,5438,3180,0,47.5416,-121.864
475000,2,1,1490,3825,860,630,47.6799,-122.381
342000,3,2,1930,11947,1930,0,47.3672,-122.151
1.19735E+06,4,2.5,2770,7800,2770,0,47.684,-122.205
280000,3,1.5,1670,11610,1670,0,47.4404,-122.191
240000,2,1.75,1330,7200,1330,0,47.4467,-122.281
529000,3,1,1210,3328,1210,0,47.6729,-122.363
442000,3,1,1190,5100,1030,160,47.5346,-122.385
615000,2,1,1540,6872,820,720,47.6454,-122.373
1.485E+06,4,3.75,4030,10800,4030,0,47.6821,-122.196
585000,4,1.75,2430,7559,1580,850,47.7206,-122.11
480000,4,2.5,2600,7787,2600,0,47.4877,-122.139
1.095E+06,5,3.5,4410,57063,4410,0,47.6554,-122.018
290000,4,1,1330,8184,1330,0,47.7343,-122.347
615000,3,1.75,1900,5000,950,950,47.5789,-122.393
300000,2,1,1100,7680,1100,0,47.7439,-122.339
308000,3,1,1980,39150,1580,400,47.3818,-122.225
750000,3,2.5,2400,7745,2400,0,47.6734,-122.173
2.25E+06,4,2.25,4760,8036,3390,1370,47.6415,-122.285
890000,4,3.25,3180,194278,3180,0,47.4711,-122.084
288000,3,1,1190,7560,1190,0,47.452,-122.177
190000,2,1,630,6000,630,0,47.4973,-122.221
515000,5,3,2530,5105,1520,1010,47.7546,-122.341
235000,4,1.5,1690,11054,1690,0,47.4667,-122.215
275000,2,1,940,5000,940,0,47.5186,-122.374
727500,2,2,1240,9119,1240,0,47.6221,-122.193
650000,4,2.5,3040,6587,3040,0,47.683,-122.039
1.6E+06,6,5,6050,230652,6050,0,47.6033,-121.943
365000,4,1,1590,7085,1590,0,47.7315,-122.305
662000,3,1.75,2500,36947,2500,0,47.6917,-122.084
270500,3,2.5,1780,7848,1320,460,47.3608,-122.056
200000,2,1.5,1360,1898,1360,0,47.2852,-122.19
970000,4,3.25,4740,76230,4740,0,47.5931,-122.071
160000,3,1.5,1010,9600,1010,0,47.4097,-122.316
204000,3,1,1040,7405,1040,0,47.3105,-122.021
358000,3,2.25,1610,6655,1610,0,47.4296,-122.161
452000,4,1.75,1570,8268,1570,0,47.7373,-122.197
595000,2,2,1510,4000,1010,500,47.6582,-122.345
249000,3,2,1360,6082,1360,0,47.3577,-122.16
346900,4,2.5,1970,5106,1970,0,47.449,-122.205
2.125E+06,3,2.5,5403,24069,5403,0,47.4169,-122.348
280000,4,2.5,1560,4350,1560,0,47.5025,-122.186
318888,4,1.75,2320,12000,2270,50,47.3644,-122.28
530000,3,2.25,2120,40518,2120,0,47.5896,-122.009
375000,3,2.25,2120,18500,2120,0,47.3914,-122.169
910000,4,2.5,3350,29242,3350,0,47.7197,-122.131
782000,4,2.5,2380,9614,2380,0,47.5623,-122.116
259950,2,2,1070,649,720,350,47.5213,-122.357
315000,4,2.75,2300,18360,1560,740,47.4518,-122.16
215000,2,1,1320,8865,1320,0,47.4949,-122.3
705000,3,1.75,2180,10221,1140,1040,47.5885,-122.248
1.45E+06,3,3,4380,6320,3580,800,47.6452,-122.411
451000,3,1.75,1790,9813,1790,0,47.749,-122.305
261000,2,1,750,8125,750,0,47.4727,-122.198
396000,3,1.5,1300,8280,1300,0,47.7403,-122.256
725000,4,2.5,2990,29170,2990,0,47.5146,-122.117
1.95E+06,7,3.5,4640,15235,2860,1780,47.5666,-122.231
238000,4,1,1400,7242,1400,0,47.4339,-122.291
750000,6,1.75,2750,9563,2750,0,47.6368,-122.097
331500,4,2.5,2050,10271,2050,0,47.3628,-122.075
460000,4,3,2230,108900,1410,820,47.52,-121.845
404950,4,2.25,2340,217014,2340,0,47.2953,-122.083
880000,3,2.5,2870,5163,2870,0,47.6935,-122.352
863000,4,2.5,4120,22370,4120,0,47.6239,-122.023
638700,3,1.75,2080,9162,1370,710,47.5846,-122.168
435000,3,2.5,1840,5680,1840,0,47.6969,-122.026
260000,3,1,1180,5350,1180,0,47.505,-122.259
671500,5,2.75,2160,4000,1530,630,47.667,-122.289
610000,3,1,1180,3400,1180,0,47.6376,-122.353
405000,2,0.75,1160,15029,870,290,47.6929,-121.87
338900,4,2.5,1830,5612,1830,0,47.3572,-122.015
720000,4,4,3200,7708,3200,0,47.5816,-121.97
442000,5,3,2560,5445,1760,800,47.5502,-122.311
650000,5,2.75,2550,5040,2550,0,47.6136,-122.299
263500,3,1.75,1330,9917,1040,290,47.4478,-122.161
300000,2,1,1220,75794,1220,0,47.4219,-122.007
266000,3,2.5,1805,3402,1805,0,47.3521,-122.212
930000,4,4,6050,84942,4150,1900,47.7466,-122.029
530000,4,2.5,2320,5493,2320,0,47.7727,-122.229
180000,3,1,1384,8960,1384,0,47.3062,-122.371
619000,3,2.5,2720,6439,2720,0,47.5422,-121.86
264000,3,1.5,1820,10608,1820,0,47.3366,-122.306
730000,2,2.25,2130,4920,1530,600,47.573,-122.409
439000,4,2.25,2060,10070,2060,0,47.7258,-122.177
268500,4,1.75,1420,7500,1080,340,47.4025,-122.176
330000,3,1.75,1510,15744,1510,0,47.476,-121.755
640000,3,2.5,2160,4000,1960,200,47.6045,-122.307
900000,3,2.5,3180,12600,3180,0,47.6366,-122.058
370000,3,2.25,2110,13300,2110,0,47.3725,-122.06
685000,3,2,2060,2900,1330,730,47.5897,-122.292
505000,3,1.5,1830,217800,1010,820,47.6277,-121.972
265000,3,1.75,1820,32666,1820,0,47.1803,-121.974
290000,3,2.5,1610,2937,1610,0,47.4489,-122.188
296000,4,2.5,1780,3600,1780,0,47.3665,-122.017
360000,4,2.5,1840,9611,1840,0,47.4964,-122.251
240500,3,1.75,1460,10584,990,470,47.492,-122.317
372500,2,2.5,1400,2958,1400,0,47.5496,-122.373
595000,3,2.5,3370,14402,3370,0,47.5008,-121.776
515000,4,3,3590,8249,3590,0,47.2846,-122.341
1.22E+06,4,2.25,3200,15367,3200,0,47.5494,-122.216
507000,2,1.75,1670,6460,1670,0,47.7123,-122.027
399950,4,2,2420,31465,2420,0,47.3131,-122.115
185000,3,1.75,1430,10816,1430,0,47.3122,-121.996
460000,3,1.75,1440,7070,1440,0,47.6947,-122.125
435500,3,2.25,1450,4789,1450,0,47.5665,-122.018
469000,4,2.75,3550,13938,2100,1450,47.425,-122.283
531000,2,3,1270,1175,1110,160,47.6634,-122.34
443500,2,1,940,6804,940,0,47.7047,-122.373
223000,3,2,1670,6824,1300,370,47.3666,-122.084
590000,4,3.5,3100,15842,2400,700,47.7466,-122.242
340000,2,2.5,1100,1760,1100,0,47.6972,-122.35
650000,3,2,1870,3388,1230,640,47.6372,-122.395
533600,3,2.5,1930,5080,1930,0,47.5694,-122.001
695000,3,2.75,2540,4694,2540,0,47.6214,-122.024
242000,3,1.75,1280,7524,1280,0,47.3961,-122.188
425000,3,2.25,1820,8814,1280,540,47.7162,-122.309
525000,3,2.25,1490,9414,1490,0,47.6844,-122.113
485000,3,2.5,1880,5502,1880,0,47.5737,-122.018
175000,3,1,1250,9775,1250,0,47.4474,-121.771
210000,3,2,1440,7210,1440,0,47.3128,-122.184
260000,3,2.5,1920,7415,1920,0,47.4022,-122.171
577000,3,2.5,2060,5750,1330,730,47.5671,-122.391
200000,3,1.5,1210,10588,1210,0,47.2876,-122.212
605000,2,1.75,1760,5000,940,820,47.682,-122.372
325000,3,1,990,6750,990,0,47.7125,-122.331
289500,3,1,960,6400,820,140,47.496,-122.239
559950,3,2.5,1660,1458,1660,0,47.5876,-122.309
1.0425E+06,3,1.75,1900,9375,1330,570,47.6821,-122.273
543500,3,2.25,1270,2790,990,280,47.6581,-122.396
480000,4,2.25,3250,34293,3250,0,47.3496,-122.094
218000,3,1,960,9633,960,0,47.1951,-122.001
565000,2,1.75,1330,6000,960,370,47.6539,-122.396
426700,3,1.75,2080,7700,1600,480,47.5375,-122.178
650000,3,2.5,2690,11575,2130,560,47.7605,-122.267
542000,2,1,890,3060,770,120,47.6663,-122.326
415000,3,1.75,1070,8000,1070,0,47.6978,-122.13
214000,3,1,1200,8316,1200,0,47.3221,-122.215
245000,3,1.5,1360,8910,1360,0,47.4488,-122.275
314500,3,2,2050,13303,2050,0,47.2681,-122.31
1.12E+06,3,1.5,3000,5750,2000,1000,47.5821,-122.39
378000,2,2,1300,3850,800,500,47.5395,-122.39
305000,4,2.5,2250,9091,1340,910,47.336,-122.269
595000,5,2.75,3740,6750,1980,1760,47.7679,-122.261
729500,3,2.5,1660,1091,1530,130,47.5818,-122.402
430000,3,2.5,2360,6699,2360,0,47.5317,-121.853
240000,3,1.75,1760,6500,1150,610,47.3647,-122.05
545000,3,1.75,1680,6200,1680,0,47.5338,-122.384
530000,3,1.75,1320,2500,870,450,47.6681,-122.305
157000,1,1,870,26326,870,0,47.4152,-122.3
425000,4,1,1260,7645,1260,0,47.5044,-122.35
220000,3,1,1000,6020,1000,0,47.4793,-122.346
521000,4,1.75,2020,36400,1550,470,47.7627,-122.076
325000,3,1,1920,6862,1120,800,47.5193,-122.274
597500,3,2,2150,5400,1380,770,47.555,-122.379
337000,3,2.5,1470,3976,1470,0,47.526,-121.826
1E+06,3,2.5,3180,10492,3180,0,47.655,-122.124
3.07E+06,3,2.5,3930,55867,2330,1600,47.7022,-122.224
495000,3,1,990,6000,990,0,47.6718,-122.267
748000,4,3.5,2770,3330,1970,800,47.6327,-122.109
888000,3,1.5,1250,8710,1250,0,47.6245,-122.198
269900,3,1.75,1140,22267,1140,0,47.4761,-121.758
496500,4,2.5,2250,14440,1550,700,47.5221,-122.045
475000,3,2.5,1640,5097,1640,0,47.7522,-122.278
312000,3,1.5,1255,1374,1255,0,47.7145,-122.311
323000,3,1,1290,12231,1290,0,47.7404,-122.11
331000,3,1.75,1300,9079,1300,0,47.4834,-122.159
306000,3,1.5,1220,1086,1220,0,47.7049,-122.353
655000,4,2.5,2630,4000,2630,0,47.6915,-122.381
290000,3,1.5,1950,15954,1950,0,47.336,-122.319
1.25E+06,4,3.25,3160,5000,2360,800,47.6597,-122.274
460000,3,1.75,1550,4708,860,690,47.6759,-122.286
435000,4,2.5,1700,6380,850,850,47.6988,-122.319
664000,4,2.75,2510,11880,1630,880,47.5427,-122.181
865000,4,1.75,1800,4180,1800,0,47.6462,-122.318
385000,3,1.75,1800,18000,1200,600,47.4406,-122.146
497000,3,2.25,1870,9315,1350,520,47.705,-122.202
280000,2,1,1010,3000,1010,0,47.4965,-121.785
188000,2,1.5,1120,17487,1120,0,47.5024,-122.271
478500,3,1,2090,4755,1200,890,47.5304,-122.387
1.145E+06,4,3.5,4370,18361,4370,0,47.544,-121.872
222000,3,2,1440,7187,970,470,47.291,-122.368
799000,4,3,2580,209523,2580,0,47.6932,-122.006
609900,4,2.5,3190,7399,3190,0,47.3558,-122.004
413000,4,3.5,2380,5809,1750,630,47.5536,-122.359
400000,4,1,1420,4875,1420,0,47.6942,-122.321
802541,5,2.75,2990,6768,2990,0,47.5462,-122.182
320000,3,2.5,2680,7757,2680,0,47.2918,-122.346
507000,4,2.5,2730,7649,2730,0,47.5441,-121.882
387500,3,1,1220,8329,1220,0,47.6982,-122.298
396000,3,1,1500,12616,1500,0,47.7415,-122.101
373000,3,1.75,1830,11788,1430,400,47.4862,-122.224
1.4849E+06,5,2.5,4570,19252,4570,0,47.5553,-122.22
359900,4,2.25,2470,7698,2470,0,47.4406,-122.141
410000,2,1,800,4342,670,130,47.6997,-122.316
690000,4,2.5,2900,23488,2900,0,47.6726,-122.03
245000,3,2,1410,5760,1410,0,47.3702,-122.185
700000,5,2.5,2830,25958,1610,1220,47.5896,-122.083
268000,4,1.75,1680,9966,1100,580,47.3923,-122.311
225000,3,1.75,1760,26055,920,840,47.3664,-122.1
980000,4,2.25,2240,11034,2240,0,47.5894,-122.195
795000,2,1,1380,5000,1380,0,47.5708,-122.359
195000,2,1,820,5100,820,0,47.5156,-122.262
480000,4,2,2180,10575,1730,450,47.589,-122.177
485000,4,2,1400,3600,1100,300,47.6385,-122.37
130000,2,1,880,9000,880,0,47.4672,-122.291
325000,2,1,1060,5703,1060,0,47.3444,-122.327
440000,3,1.75,1530,7245,1530,0,47.731,-122.191
550000,4,1.75,2480,14782,1460,1020,47.7646,-122.271
310000,3,1.75,1490,7150,1490,0,47.5015,-122.124
530000,3,2.5,3660,39478,3260,400,47.2413,-121.972
390000,4,2.5,2340,8548,2340,0,47.4206,-122.183
243000,3,1.75,1450,12125,1450,0,47.3575,-122.28
639000,4,2.5,2210,9875,2210,0,47.6285,-122.025
215000,4,1,1130,7400,1130,0,47.3437,-122.316
405000,5,1.75,1550,10500,1100,450,47.7573,-122.22
250000,4,1.75,1710,7140,1010,700,47.3745,-122.275
405500,3,1.5,1010,8108,1010,0,47.7359,-122.309
452000,6,2.25,2660,13579,2660,0,47.7142,-122.286
730000,6,2.25,2660,13579,2660,0,47.7142,-122.286
267000,3,2,1300,9644,1300,0,47.3131,-121.998
289950,3,2.5,1670,6186,1670,0,47.3668,-122.031
565000,2,1,960,4080,960,0,47.6893,-122.349
1.578E+06,4,3.25,4670,51836,4670,0,47.635,-122.164
636000,3,2.5,2140,2770,1770,370,47.6664,-122.131
350000,5,3,2520,5500,1550,970,47.4938,-122.255
320000,3,1.5,1650,9380,1130,520,47.4525,-122.162
210000,2,1.75,1440,5680,1440,0,47.3825,-122.319
245000,2,1,1050,5900,1050,0,47.5326,-122.376
328000,3,1.75,1470,7650,1130,340,47.4818,-122.161
985000,4,2.25,4230,37769,4230,0,47.7287,-122.077
501000,3,1.75,1970,7972,1370,600,47.4908,-122.225
315000,3,2.25,1540,17424,1540,0,47.4429,-121.759
403000,3,2.75,2090,8354,2090,0,47.7336,-121.965
550000,3,2,2380,17950,2110,270,47.7591,-122.28
347500,4,2.5,2156,3562,2156,0,47.3591,-122.201
365000,4,2.25,2070,8893,2070,0,47.4388,-122.162
588000,3,1,1910,8167,1270,640,47.7004,-122.368
605000,3,1.75,1920,7400,1260,660,47.5633,-122.131
1.3E+06,3,3.25,3400,5979,2290,1110,47.6585,-122.273
233000,3,2,1400,9177,1400,0,47.3415,-122.272
360000,4,2.5,2210,17715,2210,0,47.3818,-122.2
459000,2,1.75,1170,4887,1020,150,47.695,-122.366
740000,3,2,2100,72745,2100,0,47.7479,-122.062
305000,3,1,1160,9750,1160,0,47.7422,-122.073
395000,3,1,1500,4000,900,600,47.6921,-122.38
560000,4,2.5,2940,6000,2940,0,47.7533,-122.198
650000,4,1.75,2010,5070,1300,710,47.5793,-122.402
449950,3,2.5,2170,4912,2170,0,47.7767,-122.239
517500,3,1.5,1430,5200,1250,180,47.6988,-122.387
435000,4,1.5,1510,6460,1070,440,47.7121,-122.214
329999,3,1,1150,6908,800,350,47.7447,-122.313
950000,3,1.75,2150,4200,1140,1010,47.5671,-122.405
447000,3,1,1370,6001,1230,140,47.5646,-122.317
699800,2,2.5,2380,6600,2380,0,47.717,-122.02
850000,3,1.75,1370,3850,770,600,47.6374,-122.279
316500,3,1.75,1600,14250,1070,530,47.3272,-122.355
942500,5,3.5,3750,9612,2030,1720,47.5511,-122.157
1.31E+06,2,2.25,3950,3938,2910,1040,47.5912,-122.384
856600,4,2.25,2400,13430,2400,0,47.5987,-122.178
405600,5,1.5,2830,4000,2830,0,47.5132,-122.262
565000,4,2.5,2440,22594,2440,0,47.6333,-121.97
400000,3,2.25,1190,1149,1050,140,47.5818,-122.387
330000,3,2,1400,218252,1400,0,47.7576,-121.934
374950,4,2.75,2730,4683,2730,0,47.3608,-122.043
405300,3,2.75,2390,7939,1610,780,47.4987,-122.166
560000,3,2.25,2060,31400,2060,0,47.6216,-122.056
824000,4,2.25,2490,9864,1290,1200,47.6051,-122.195
260000,3,1.75,1100,10968,1100,0,47.363,-122.08
760000,4,2.5,2430,6099,1470,960,47.6777,-122.287
405000,3,2.5,3170,12750,2360,810,47.3384,-122.336
429900,4,2.5,2640,8625,2640,0,47.4598,-122.15
341500,3,1.5,1130,7223,1130,0,47.5089,-122.189
465250,5,2,1940,7642,1940,0,47.7751,-122.38
450000,2,2,1100,3000,1100,0,47.6797,-122.362
390000,3,1,1200,10800,1200,0,47.5771,-122.144
420000,3,2.25,2000,8030,1000,1000,47.6188,-122.114
269950,3,2.5,1890,4838,1730,160,47.4802,-122.279
493000,4,2,1910,2874,1060,850,47.6101,-122.295
370000,4,2.5,2710,5880,2710,0,47.3314,-122.172
2.25E+06,5,4.25,4860,9453,3100,1760,47.6196,-122.286
305000,3,1,1250,23680,1250,0,47.475,-122.11
400000,3,1.75,1590,8219,970,620,47.7146,-122.217
320000,3,1.5,1240,1221,1050,190,47.7073,-122.356
715000,4,1,2000,4800,2000,0,47.6583,-122.351
650000,6,2.75,3610,10003,3610,0,47.6261,-122.125
218000,5,1.75,1930,8040,1930,0,47.3109,-122.376
500000,2,1,1280,5400,1280,0,47.6949,-122.371
460000,4,2,2090,40419,2090,0,47.4691,-121.993
232500,3,1.5,1940,9887,1140,800,47.3289,-122.327
408200,3,2.5,1800,5761,1800,0,47.5293,-122.363
522000,3,1.75,1730,8400,1400,330,47.6792,-122.115
675000,4,2.5,2810,11120,2810,0,47.6337,-122.044
1.355E+06,4,3.5,3550,11000,2260,1290,47.5506,-122.134
249950,4,1,1330,7980,1330,0,47.492,-122.333
210000,2,1,750,34133,750,0,47.4781,-122.294
429950,4,1,1760,7216,1090,670,47.7041,-122.355
737500,4,2.5,3200,36276,3200,0,47.6304,-121.994
710000,4,2,1740,9000,1740,0,47.6815,-122.198
470000,3,2.5,2100,4700,2100,0,47.5341,-121.867
1.1E+06,4,3.5,4270,40097,4270,0,47.7354,-122.078
650000,3,2,1340,2720,1340,0,47.6518,-122.335
1.216E+06,4,2.5,3190,8684,1680,1510,47.5619,-122.162
422120,3,2.5,1630,4534,1630,0,47.7148,-122.205
625000,5,2.5,2990,15085,2990,0,47.746,-122.218
385200,4,1,1550,7740,1550,0,47.5222,-122.375
500000,3,2.25,1690,4964,1690,0,47.5756,-122.01
308000,4,2.25,1960,12243,1960,0,47.3405,-122.058
565000,3,2.75,2390,9966,1360,1030,47.5433,-122.185
581000,3,2.5,2600,4438,2600,0,47.6799,-122.034
361000,3,2,1950,8698,1950,0,47.39,-122.153
345000,3,1,1250,7210,1250,0,47.6329,-122.121
419000,2,2.25,1180,1253,840,340,47.6124,-122.309
347000,3,2.5,1680,4308,1680,0,47.4802,-122.179
625000,4,2.25,2220,36085,2220,0,47.5839,-121.991
2.4E+06,4,4.25,4890,15188,3090,1800,47.5602,-122.227
379000,3,3.25,2660,17852,2660,0,47.3077,-122.011
310000,3,1.5,1150,3323,1150,0,47.5707,-122.017
250000,2,2,1130,5500,1130,0,47.3839,-122.225
682000,5,2.75,2760,5000,2760,0,47.539,-122.188
246500,3,2,1430,8919,1430,0,47.2118,-121.983
325000,3,1,1490,57381,1490,0,47.2597,-122.228
310950,4,2.5,2030,4997,2030,0,47.393,-122.184
1.1E+06,3,2,3010,5000,1890,1120,47.6347,-122.396
287500,3,1,1810,7200,1130,680,47.7493,-122.351
431000,3,1,1810,7200,1130,680,47.7493,-122.351
226000,3,1,970,5000,970,0,47.5282,-122.279
825000,3,1.75,2010,3090,1510,500,47.682,-122.348
175000,4,1,1300,6030,1300,0,47.4778,-122.286
465750,3,1.5,1260,10350,1260,0,47.6357,-122.123
659000,4,2.25,2610,24931,2610,0,47.5771,-122.05
595000,3,1.75,1910,5753,1110,800,47.6898,-122.327
350000,3,2.25,1780,16290,1780,0,47.4622,-122.127
270000,4,2.25,1900,8600,1900,0,47.3102,-122.381
662500,6,2.25,2450,25600,1340,1110,47.6061,-122.117
249900,3,1.75,1380,14000,1380,0,47.294,-122.281
324500,3,1.75,1920,11340,1230,690,47.3272,-122.362
430000,2,1.75,1350,4003,1350,0,47.7176,-122.033
419950,2,1.75,1350,4003,1350,0,47.7176,-122.033
285000,4,1.75,2510,7440,1290,1220,47.3748,-122.276
332000,4,2.5,2470,7780,2470,0,47.3337,-122.191
282000,4,1.75,1660,10725,960,700,47.5033,-122.3
320000,3,1,1340,5175,940,400,47.7321,-122.34
428750,3,1,1620,30736,1620,0,47.5719,-122.119
330000,3,2.25,2300,35287,2300,0,47.2477,-121.937
456500,4,3.5,2000,2309,2000,0,47.7027,-122.361
352000,3,2.25,1640,11050,1640,0,47.4723,-122.121
664000,4,2,1530,4080,1530,0,47.6645,-122.325
628000,3,1.75,4000,11894,2190,1810,47.7738,-122.203
512000,3,1.75,1610,12555,1080,530,47.6618,-122.136
254000,3,2,2070,9000,1450,620,47.3085,-122.376
535800,4,2.5,1900,5790,1900,0,47.5691,-121.996
287653,3,1,1050,16050,1050,0,47.3841,-122.006
438000,3,2.5,1520,1304,1180,340,47.5446,-122.385
450000,4,1.75,2390,23899,1750,640,47.7557,-122.237
327000,5,2.75,2400,8050,2400,0,47.2635,-122.209
370500,4,2.5,1790,6120,1790,0,47.4829,-122.128
265000,3,2.5,1720,6271,1720,0,47.3898,-122.049
450000,4,2.75,2980,13260,1800,1180,47.5152,-122.197
425000,3,1,1520,213444,1520,0,47.5081,-122.093
166600,3,1.75,1150,8690,1150,0,47.3729,-122.115
245000,1,0.75,380,15000,380,0,47.481,-122.323
565000,3,1,910,5212,910,0,47.6742,-122.284
539900,3,1.75,1650,10150,1230,420,47.6963,-122.169
910000,3,3.5,2480,3200,2480,0,47.5951,-122.307
280000,4,2.5,2050,7416,2050,0,47.2658,-122.219
275000,3,2.25,1420,8549,1420,0,47.3576,-122.039
467000,3,2.5,3460,6590,3460,0,47.4802,-122.188
457500,3,2.5,1500,4445,1500,0,47.5682,-122.005
381156,2,1,1320,3090,1320,0,47.5517,-122.276
289999,5,2.5,2180,8240,1220,960,47.3122,-122.191
642450,3,1.75,1830,4160,1230,600,47.5962,-122.288
469950,3,2.25,1620,8701,1220,400,47.6071,-122.137
795000,3,2,2920,13650,1460,1460,47.6652,-122.188
785000,4,2.5,3300,10514,3300,0,47.6323,-122.036
860000,3,2.25,3060,12095,3060,0,47.5611,-122.106
1.095E+06,0,0,3064,4764,3064,0,47.6362,-122.322
147500,3,1,1530,8498,1530,0,47.404,-122.203
390000,3,2,1910,11576,1410,500,47.7356,-122.198
229000,3,1,1020,8100,1020,0,47.3586,-122.314
185000,3,1,1150,8100,1150,0,47.494,-122.307
414900,3,1.5,1260,9570,870,390,47.7004,-122.305
200000,4,2,1920,4822,920,1000,47.5507,-122.381
225000,4,2.25,1800,9350,1800,0,47.2959,-122.191
720000,3,1.75,2040,4000,1360,680,47.6675,-122.289
930000,4,2.5,2200,4000,1430,770,47.6402,-122.37
1.27E+06,5,2.5,3200,17204,2160,1040,47.6209,-122.222
700000,5,3.25,2400,3118,1780,620,47.6094,-122.291
466000,2,1.5,1140,1058,1140,0,47.6608,-122.333
374000,3,1.5,1330,10640,1330,0,47.7364,-122.193
480000,3,2.5,1940,10035,1940,0,47.7438,-122.172
740000,3,2.5,3000,25341,3000,0,47.6724,-122.013
1.01E+06,4,1,1820,5400,1820,0,47.6476,-122.318
395000,4,2.5,2910,5000,2910,0,47.3782,-122.127
340000,2,1,1090,6771,1090,0,47.5185,-122.352
209000,3,2,1230,1340,1020,210,47.526,-122.361
431650,5,2.5,1710,7700,1710,0,47.5922,-122.146
980000,5,2.5,3160,11470,1780,1380,47.5368,-122.216
660000,3,2.5,2680,28243,2680,0,47.7637,-122.05
730000,4,2.25,2190,9009,1840,350,47.6916,-122.188
291500,3,1.75,1260,9600,1260,0,47.3592,-122.076
905000,4,3.5,2970,14486,2340,630,47.5627,-122.215
800000,4,2.5,2570,50308,2570,0,47.7418,-122.039
839900,4,3.5,3810,13592,2560,1250,47.5134,-122.2
200000,1,1.5,1010,1157,950,60,47.5492,-122.372
300000,3,2,1480,6698,1080,400,47.4614,-122.168
530000,3,1.75,1250,6041,1250,0,47.69,-122.304
314950,3,2.25,1654,8479,1654,0,47.3627,-122.037
255000,3,1.75,1410,9315,1410,0,47.3969,-122.198
550000,5,2.75,2160,5720,1500,660,47.5728,-122.304
435000,3,1,1400,4800,700,700,47.5499,-122.391
234000,3,1.75,1420,8738,1420,0,47.3113,-122.207
615000,4,2.25,2500,10062,1600,900,47.639,-122.1
205000,3,2,1410,8384,1410,0,47.3315,-122.263
384000,4,1.75,2100,7135,1050,1050,47.5353,-122.349
324000,3,2.5,1750,7208,1750,0,47.4315,-122.192
645000,3,1.75,2070,5500,1130,940,47.6733,-122.301
570000,3,3.25,1570,1777,1260,310,47.6655,-122.369
324000,3,2.5,1920,5322,1920,0,47.4095,-122.195
270000,2,1,1000,10320,1000,0,47.527,-122.356
290000,5,1.5,2120,7700,2120,0,47.4599,-122.172
250000,3,2,1440,9220,1440,0,47.3702,-122.317
342000,3,1.75,1660,16275,1660,0,47.6903,-121.915
255000,3,1.5,1340,8450,1340,0,47.4405,-122.28
800000,3,2.25,2380,11824,1450,930,47.5371,-122.218
451000,3,1.75,1560,4049,1000,560,47.5666,-122.375
990000,4,2.5,2780,10480,1390,1390,47.6597,-122.204
288400,4,2.5,1860,6687,1220,640,47.4046,-122.186
420000,3,1.5,2390,4600,1750,640,47.5383,-122.268
359000,2,2.75,1370,1140,1080,290,47.7052,-122.343
390000,4,3,2570,262018,1420,1150,47.4417,-122.09
300000,3,2.5,1320,2614,1320,0,47.5355,-122.283
545000,5,2.5,2520,7863,1500,1020,47.7096,-122.199
288349,3,1,1250,18616,1250,0,47.3414,-122.047
299900,3,2.25,1560,35026,1290,270,47.3023,-122.069
891000,4,2,2330,5000,1720,610,47.6804,-122.358
1.2E+06,3,2,3660,22410,1830,1830,47.6972,-122.4
378000,4,2.5,2790,4650,2790,0,47.3556,-122.026
299995,2,1,1060,7200,1060,0,47.7463,-122.315
253000,3,2.5,2020,6564,1310,710,47.3545,-122.158
350000,3,2.25,1580,47916,1580,0,47.5583,-121.852
565000,4,3,2020,4300,2020,0,47.6653,-122.372
315000,2,1,970,5665,970,0,47.5513,-122.273
570000,4,3,1490,6766,1490,0,47.5446,-122.382
971000,5,3.5,4390,10140,3350,1040,47.7174,-122.282
915000,5,2.5,2750,5589,1840,910,47.6364,-122.3
419000,4,1.5,2150,23568,2150,0,47.4522,-122.355
260000,4,1.75,1810,7480,1230,580,47.3275,-122.361
1.3215E+06,3,3,2230,12968,2230,0,47.6271,-122.197
369950,3,1,2430,10720,2430,0,47.4895,-121.787
1.0299E+06,3,2.5,3680,13384,3680,0,47.5484,-122.119
435000,5,1,1410,6750,1410,0,47.5453,-122.278
601000,3,1.75,1330,6743,1330,0,47.7012,-122.286
460500,3,1,1490,10650,1150,340,47.663,-122.178
720000,3,2.5,2020,1159,2020,0,47.6617,-122.356
851000,4,2.5,3130,13202,3130,0,47.5878,-121.976
550000,4,3,2670,5000,2670,0,47.5784,-122.377
700000,4,1,1980,4560,1980,0,47.6606,-122.331
323000,3,1.75,2100,14850,2100,0,47.3622,-122.059
345500,3,1,1350,8581,1350,0,47.7612,-122.362
378000,4,1.5,2140,7920,1190,950,47.5491,-122.272
650000,4,2,2208,5000,2208,0,47.5711,-122.383
385000,3,2,1010,7380,1010,0,47.6273,-122.062
425000,2,1,970,2970,970,0,47.6233,-122.319
210000,4,2,1520,6174,1520,0,47.2105,-121.989
630000,4,2.5,2740,43101,2740,0,47.7649,-122.049
335000,3,1.75,1570,7500,1300,270,47.4999,-122.368
196500,3,1,1320,9000,1320,0,47.3461,-122.272
582800,4,2.75,2550,7636,1440,1110,47.6471,-122.06
440000,3,1.75,1560,7207,1250,310,47.7283,-122.222
752500,4,2.25,2360,8616,2360,0,47.6495,-122.198
532500,3,1.75,1330,5000,1210,120,47.5724,-122.384
265000,3,1,1070,9000,1070,0,47.4061,-122.33
397500,3,1.25,1510,13737,810,700,47.7289,-122.283
524250,3,2.5,1710,3469,1710,0,47.546,-122.011
765000,4,2.75,2790,10819,2790,0,47.5515,-122.08
648000,4,2.5,2620,5450,2620,0,47.6301,-122.019
469500,5,2.5,2970,24759,1670,1300,47.3908,-122.173
237500,3,1.75,1050,7854,1050,0,47.3011,-122.369
216000,3,1,1280,8712,1280,0,47.3298,-122.297
427200,3,1,1030,8400,1030,0,47.5364,-122.173
280000,3,2.25,1900,7800,1390,510,47.4545,-122.208
718000,5,3,3070,9804,1740,1330,47.5702,-122.128
420000,2,2.75,1760,4139,1760,0,47.5175,-121.878
379000,2,1,930,5400,930,0,47.6971,-122.372
326100,2,1,880,7683,880,0,47.7145,-122.361
535000,3,2.5,1360,1016,1310,50,47.6774,-122.324
283000,4,2.75,2130,8560,1560,570,47.1949,-122.01
260000,3,1,1480,7469,1120,360,47.5048,-122.301
399000,4,1,1500,6388,1500,0,47.5303,-122.378
484950,3,2.25,1670,5004,1670,0,47.5688,-122.017
640000,4,1.75,2060,9828,2060,0,47.5867,-122.174
585000,4,2.5,2160,8158,1660,500,47.6948,-122.328
645000,4,2,2780,11583,1190,1590,47.7293,-122.284
253000,3,2,1490,7651,1490,0,47.3211,-122.325
178500,2,1,740,6460,740,0,47.5077,-122.344
291000,4,2.5,1860,6325,1860,0,47.3492,-122.03
199950,2,2.75,1590,20917,1590,0,47.2786,-122.25
553500,2,1,850,2340,850,0,47.6707,-122.328
189950,2,1,1030,4188,1030,0,47.3738,-122.057
289000,3,2,1850,9550,1850,0,47.3225,-122.273
700000,4,2,1830,4590,1830,0,47.6593,-122.327
270000,3,2,1560,8853,1560,0,47.4312,-122.171
258000,4,1.75,1730,8320,1230,500,47.327,-122.361
530000,3,2.5,1930,7214,1930,0,47.7191,-122.309
245000,3,2.25,1422,3677,1422,0,47.3204,-122.178
563000,3,2,1380,5000,1380,0,47.6807,-122.369
515000,3,2.5,2430,4203,2430,0,47.5346,-121.875
325000,4,2.5,2610,7091,2610,0,47.3017,-122.349
540000,3,2.25,2000,217800,2000,0,47.5599,-121.911
280300,2,1,920,5000,490,430,47.7008,-122.338
460000,4,1.75,1750,5500,1050,700,47.6802,-122.388
475000,3,1.75,2020,8970,1180,840,47.7571,-122.145
900000,4,2.25,2460,44431,2460,0,47.6042,-122.147
538200,4,3,1780,7260,1780,0,47.627,-122.114
429000,2,1,1080,3600,1080,0,47.6078,-122.291
164808,3,1,1250,5411,1250,0,47.5064,-122.265
520000,4,2.25,1870,7700,1870,0,47.6937,-122.127
475000,3,1.75,1700,8432,1230,470,47.7221,-122.317
283000,4,1.5,1480,47045,1480,0,47.4809,-122.3
321500,4,2.5,1930,6228,1930,0,47.3572,-122.191
840000,4,2.75,3130,21810,3130,0,47.7083,-122.073
287000,3,2.25,1370,6000,1370,0,47.3484,-122.033
375000,3,1.75,960,8106,960,0,47.6737,-122.156
349500,3,1.75,1260,7128,1260,0,47.7263,-122.205
446450,3,1.5,1480,7749,1480,0,47.5144,-122.379
315000,4,2.5,1930,9643,1930,0,47.4065,-122.18
271310,2,1,870,5340,870,0,47.5849,-122.302
315000,4,1,1300,8400,1300,0,47.7612,-122.332
245000,3,1.75,1490,6930,1490,0,47.3682,-122.179
543115,2,1,1380,5484,1030,350,47.6382,-122.399
900000,4,2,1190,8190,1190,0,47.6908,-122.397
2.45E+06,4,4.25,4250,6552,2870,1380,47.5747,-122.283
554000,2,2,1920,6045,1920,0,47.7107,-122.031
249900,3,1.75,2080,12522,2080,0,47.267,-122.25
768000,3,2.5,3220,54160,2690,530,47.5468,-122.109
980000,4,3,3680,5854,2060,1620,47.6327,-122.395
395000,5,2.5,2070,9600,1270,800,47.4997,-122.364
415000,3,1.75,1480,2200,1480,0,47.6969,-122.35
380000,4,2.5,2000,6921,2000,0,47.3559,-122.014
566000,3,2.5,1560,5259,1560,0,47.5985,-122.016
218500,2,1,1600,8961,1390,210,47.3098,-122.21
550000,4,2.5,1940,10500,1140,800,47.683,-122.114
512031,3,1.75,1540,3000,770,770,47.6769,-122.36
197500,2,1,820,8860,820,0,47.452,-122.19
470000,3,2.25,1780,8784,1230,550,47.701,-122.172
590000,3,1.75,1560,242629,1560,0,47.6493,-121.956
465000,4,2.25,2210,8862,1270,940,47.7725,-122.198
499000,2,1.75,2040,114562,2040,0,47.4985,-122.092
515000,3,2.25,1920,11500,1920,0,47.5498,-122.188
716500,3,1.75,1930,5000,1230,700,47.6582,-122.278
410000,3,2,1700,4250,890,810,47.6542,-122.385
850000,4,3.25,3450,6500,2450,1000,47.5437,-122.388
1.05E+06,4,3.25,3440,35021,3440,0,47.6476,-122.184
648000,4,2.5,2380,13435,2380,0,47.5833,-122.028
620000,4,2.25,2400,5350,1460,940,47.6763,-122.37
935000,4,4.5,5670,84267,5670,0,47.323,-122.044
379000,3,1,1140,10320,1140,0,47.7168,-122.196
699000,3,1.75,1670,5375,1270,400,47.6416,-122.397
528000,4,2.25,1910,8005,1280,630,47.7259,-122.298
425000,3,1.75,1560,9452,1560,0,47.5197,-122.18
249500,2,1.75,1500,8645,1500,0,47.3643,-122.115
1.03548E+06,5,3.25,4475,6642,4475,0,47.6849,-122.018
790000,4,2.75,2840,11900,1640,1200,47.5271,-122.386
399950,3,1,1020,18050,1020,0,47.5254,-122.043
275000,3,1.5,1410,9000,1410,0,47.7635,-122.35
550000,3,1,1520,2500,1520,0,47.6347,-122.352
140000,1,1,730,6890,730,0,47.467,-122.215
250000,3,1,1190,6250,990,200,47.5658,-122.292
318000,3,2.25,1410,8909,1410,0,47.3983,-122.31
505000,2,1,1240,57000,1240,0,47.597,-122.059
470500,5,2.5,2500,9248,1300,1200,47.5415,-122.18
360000,3,1,1050,9206,1050,0,47.7071,-122.301
1.2425E+06,4,2.75,2680,8500,1480,1200,47.5634,-122.156
986000,3,2.5,2380,16080,1340,1040,47.5262,-122.386
515000,2,1,1060,4228,860,200,47.6231,-122.293
320000,3,1.75,2300,41900,1310,990,47.477,-122.292
310000,4,3,2010,7426,1090,920,47.5042,-122.265
356700,2,1,1090,5000,730,360,47.5258,-122.378
775000,4,1.75,2320,5595,1510,810,47.6397,-122.388
325000,3,1,1040,7541,1040,0,47.7565,-122.339
208000,4,2.75,1810,8677,1810,0,47.3668,-122.31
825000,2,1,1150,12775,1150,0,47.502,-122.222
515000,3,2.5,2360,11254,2360,0,47.3356,-122.333
490000,3,1.5,1970,3400,1420,550,47.6163,-122.292
675000,4,3,2690,28300,2690,0,47.4458,-122.343
360000,4,2.5,2080,4080,1040,1040,47.572,-122.29
550000,4,2.5,2080,4080,1040,1040,47.572,-122.29
225000,3,1.5,1370,9000,1370,0,47.4973,-122.328
500000,3,2.75,3410,9360,3410,0,47.4497,-122.147
385000,4,2,1850,11700,1850,0,47.4702,-122.12
837700,5,2.75,3010,12611,3010,0,47.696,-122.102
448000,3,2.25,1530,3056,1530,0,47.6817,-122.035
730000,5,1.75,2690,21357,1420,1270,47.5831,-122.191
575000,4,1.5,2810,7140,1490,1320,47.5252,-122.382
430000,3,1.75,1810,7300,1240,570,47.7299,-122.192
435000,3,2.5,1560,3987,1560,0,47.687,-122.043
241000,3,1,1010,9611,1010,0,47.3006,-122.066
453500,2,1.75,1000,1760,600,400,47.6261,-122.355
285000,2,1.5,990,1380,990,0,47.7218,-122.356
151000,2,1,720,4222,720,0,47.4965,-122.186
1.57E+06,5,4.5,6070,14731,6070,0,47.5306,-122.134
631000,5,2,2270,2400,2270,0,47.6051,-122.319
285000,2,2.5,1380,1073,1140,240,47.5462,-122.369
195000,3,1,1260,8378,840,420,47.3274,-122.348
817500,4,2.5,2910,35679,2910,0,47.5859,-121.991
550000,3,2,1810,12825,1810,0,47.5953,-122.14
1.127E+06,4,2.5,3160,8281,3160,0,47.6699,-122.195
609850,2,2.75,1910,1369,1910,0,47.6544,-122.373
200000,3,1,1230,4380,1230,0,47.5352,-122.361
367000,4,2.5,2960,6219,2960,0,47.3603,-122.037
285167,3,2.25,2200,8375,2200,0,47.2626,-122.218
275000,2,1.5,1270,32175,1270,0,47.3347,-122.304
350900,4,2.5,2540,12843,2540,0,47.3866,-122.169
660000,4,3.25,3030,9273,3030,0,47.5747,-122.014
525000,3,1.75,1520,8835,1520,0,47.6054,-122.118
262000,4,2.5,1560,7800,1560,0,47.514,-122.316
690000,2,1,970,4560,970,0,47.6561,-122.332
624000,5,3.75,3570,14648,3570,0,47.7377,-121.974
353000,3,1,1350,7740,860,490,47.7098,-122.291
552500,4,3.5,3710,10400,2290,1420,47.5041,-122.186
224500,4,1,1430,8355,1430,0,47.3178,-122.174
239000,3,1,940,8571,940,0,47.5006,-122.336
975000,5,4.5,4300,12250,4300,0,47.5557,-122.027
1.2E+06,4,1.75,3990,13470,3990,0,47.5305,-122.131
505000,3,1,1380,4000,1380,0,47.6261,-122.296
302000,4,1.75,2020,7865,1010,1010,47.5008,-122.162
170000,3,1,1480,5670,780,700,47.5175,-122.36
195000,2,1,1190,27007,1190,0,47.524,-122.04
272000,5,1.5,2550,6300,1560,990,47.5014,-122.172
369000,5,1.5,2550,6300,1560,990,47.5014,-122.172
332500,3,1.5,1500,6332,1500,0,47.7274,-122.312
515000,3,2.5,3000,8250,1760,1240,47.6191,-122.112
269000,3,1,1690,4250,1020,670,47.4945,-122.258
1.278E+06,4,4,4390,17832,2430,1960,47.5283,-122.143
303000,3,2.5,1560,4100,1560,0,47.4733,-122.189
420000,7,3,2940,8624,1690,1250,47.7555,-122.307
400000,3,1,1130,4100,990,140,47.6856,-122.385
225000,3,1,1020,8437,1020,0,47.2093,-122
219000,2,2,1310,2550,1310,0,47.3496,-122.022
605000,3,2.5,2570,9487,2570,0,47.7408,-122.216
625000,4,2,2020,6867,1010,1010,47.7,-122.292
380000,5,2,1680,3240,840,840,47.5965,-122.311
620000,4,2,1770,7700,1770,0,47.5916,-122.146
687500,4,2.75,3190,10970,3190,0,47.5862,-122.029
225500,4,2,1440,7950,1440,0,47.4517,-122.082
252500,3,2,1150,6000,1150,0,47.498,-122.263
510000,3,2.5,1860,3658,1860,0,47.5703,-122.004
510000,4,2.5,2430,5203,2430,0,47.7402,-122.317
725000,3,2.5,1940,4000,1940,0,47.6372,-122.352
75000,1,0,670,43377,670,0,47.2638,-121.906
492000,2,1,880,2970,880,0,47.6868,-122.349
425000,4,2.5,1930,14196,1330,600,47.7407,-122.097
1.955E+06,4,2.75,3120,7898,1560,1560,47.7165,-122.259
298900,3,2.5,1830,6162,1830,0,47.3291,-122.17
699000,4,2.5,3230,40319,3230,0,47.4856,-122.069
310000,2,1,700,3000,700,0,47.6846,-122.346
350000,3,1.75,1010,8580,1010,0,47.6703,-122.174
790000,4,1.75,2460,10061,1410,1050,47.5105,-122.238
305000,4,2.5,2230,5000,2230,0,47.3919,-122.184
315000,3,2.5,1570,2865,1570,0,47.5412,-122.288
267500,5,3.5,2390,6600,2390,0,47.3737,-122.115
1.75E+06,4,3.25,3460,7749,3020,440,47.6849,-122.273
435000,6,3.5,2400,8620,1640,760,47.7152,-122.162
482500,6,4.5,2940,7500,2940,0,47.7208,-122.182
5.1108E+06,5,5.25,8010,45517,5990,2020,47.6767,-122.211
439995,3,1.75,1570,8400,1570,0,47.76,-122.34
460000,3,3,1520,7500,1180,340,47.7276,-122.181
194000,3,1,1070,6440,1070,0,47.3186,-122.373
290000,2,0.75,440,8313,440,0,47.4339,-122.512
274700,4,2,2440,9600,1220,1220,47.4142,-122.179
900000,4,2.5,2660,3672,1800,860,47.6609,-122.324
1.15E+06,4,4,4460,103382,4460,0,47.634,-121.997
605000,3,2.5,2010,3667,2010,0,47.545,-122.015
359000,3,2.5,1450,3850,1450,0,47.5318,-121.85
850000,3,1.75,1400,9900,1400,0,47.6272,-122.209
505000,3,2,1500,2500,1500,0,47.6748,-122.385
565000,3,2.5,2500,7394,2500,0,47.7441,-122.173
585000,2,1.75,1280,7110,1000,280,47.5569,-122.273
328000,4,3.25,3380,7500,2420,960,47.4092,-122.33
749950,4,2.75,2910,18700,2210,700,47.7557,-122.368
826000,4,2.5,3060,7140,3060,0,47.5393,-121.998
535000,3,1,1330,40259,1330,0,47.552,-121.89
925000,4,2.5,3300,101930,3300,0,47.576,-121.976
875000,3,3.5,3250,6000,2500,750,47.5533,-122.391
902000,4,2.25,2530,9200,1570,960,47.5612,-122.152
423000,3,1,1830,13900,1830,0,47.7654,-122.352
235000,3,1,1170,11100,1170,0,47.4954,-122.164
545000,2,2,2930,14057,1680,1250,47.4025,-122.463
343000,2,1,1230,7560,1230,0,47.7298,-122.34
334950,3,2.5,1620,2930,1620,0,47.4491,-122.12
405000,3,1.75,1760,5355,1160,600,47.5368,-122.267
220000,4,1,1440,8250,1440,0,47.4325,-122.291
173000,2,1,1740,8100,1050,690,47.4942,-122.304
655000,3,1,1270,3600,1270,0,47.6368,-122.37
406000,2,1,880,3000,880,0,47.6749,-122.323
632000,6,2.5,2560,8320,1370,1190,47.7021,-122.287
357000,5,2.75,1540,4000,1140,400,47.533,-122.354
361000,3,1.75,1150,17585,1150,0,47.6503,-121.908
277000,2,1,770,8149,770,0,47.7458,-122.298
630000,4,3.75,4610,40202,2500,2110,47.4599,-122
254000,3,2.5,1850,4597,1850,0,47.3755,-122.136
472800,3,2.25,1840,8400,1290,550,47.5497,-122.172
263000,3,1.75,1490,3800,700,790,47.5554,-122.27
510000,3,1.75,1490,3800,700,790,47.5554,-122.27
179950,3,1,960,10125,960,0,47.3335,-122.305
525000,4,2.25,1580,7307,1160,420,47.569,-122.086
479000,3,2.5,1260,889,1260,0,47.6277,-122.345
651000,3,2,1940,6440,970,970,47.5664,-122.389
949000,4,1.75,2490,7834,1240,1250,47.6851,-122.209
392400,5,2.5,2520,27951,1890,630,47.7733,-122.318
585000,4,1.75,1760,5356,920,840,47.679,-122.288
460000,4,2.5,4190,7504,4190,0,47.4394,-122.114
470000,3,1,1170,4400,870,300,47.6584,-122.391
245000,3,2.5,1600,4271,1600,0,47.386,-122.036
500000,4,2,2760,27631,1800,960,47.7484,-122.291
455000,3,2.5,2090,8653,2090,0,47.7498,-122.184
485500,4,2.5,2320,3974,2320,0,47.532,-121.88
1.875E+06,5,3.25,4110,7920,3150,960,47.617,-122.282
100000,2,1,770,17334,770,0,47.2997,-122.269
307000,3,1.75,1410,16105,1410,0,47.6927,-121.913
475000,4,3.5,3660,14401,2660,1000,47.3076,-122.396
330000,4,2.5,2180,7210,1190,990,47.7419,-122.181
130000,3,1,1110,7520,1110,0,47.683,-122.176
320000,3,2.5,2280,7417,2280,0,47.3557,-122.278
735000,4,2.5,2820,6180,2050,770,47.5529,-122.281
365000,4,2.5,1570,9600,800,770,47.7757,-122.303
234000,3,1.5,1200,11935,1200,0,47.3434,-122.082
211000,4,2,1710,8288,1710,0,47.3947,-122.174
680000,6,3.5,3000,6320,2400,600,47.562,-122.279
457000,4,3,2800,7845,2800,0,47.3544,-122.013
349000,3,2.25,1640,7261,1640,0,47.7192,-122.176
360000,3,2.75,2030,6840,1210,820,47.5413,-122.299
350000,4,2.5,2530,10155,2530,0,47.351,-122.146
208000,3,1,990,7420,990,0,47.2898,-122.221
250275,2,1,790,11234,790,0,47.4413,-122.349
435000,2,1,790,11234,790,0,47.4413,-122.349
270000,3,1.75,1800,7763,1470,330,47.3766,-122.184
438000,3,1.75,1650,12940,1650,0,47.7629,-122.268
659000,4,2,1980,23625,1980,0,47.7553,-122.092
645000,4,2.75,2340,6350,1310,1030,47.5559,-122.379
685100,4,2.5,2790,5423,2790,0,47.6085,-122.017
350000,7,3,2800,9569,1400,1400,47.5102,-122.183
375000,2,1,1840,81892,1840,0,47.7694,-122.124
170000,3,1.5,1350,81549,1350,0,47.3099,-122.09
880000,4,2.5,3030,3841,3030,0,47.6781,-122.369
410500,4,2.5,1980,5000,1980,0,47.6492,-121.908
780000,4,2.5,3690,13609,3690,0,47.5872,-121.972
1.225E+06,5,4.5,3732,4426,2932,800,47.6189,-122.288
449000,2,1.75,1510,6852,1510,0,47.7073,-122.012
546000,3,1.75,2000,5000,1110,890,47.6859,-122.399
317000,3,2,1760,11410,1060,700,47.4528,-122.163
276900,3,1,1270,7566,1270,0,47.5074,-122.175
399000,5,2,2620,7030,1420,1200,47.7338,-122.352
495000,5,2.75,2630,10165,1690,940,47.5196,-122.049
258000,3,1.75,2270,9000,1330,940,47.3077,-122.381
600000,2,2.5,2410,102366,1940,470,47.5629,-121.918
265000,3,2.75,1120,881,1120,0,47.6914,-122.343
321000,5,2.75,3030,7000,1540,1490,47.3661,-122.28
682000,5,2.25,2120,4000,1720,400,47.644,-122.353
295700,4,2.5,1720,5805,1720,0,47.3286,-122.208
609000,4,2.5,2150,37981,2150,0,47.7227,-122.098
995000,3,4.5,4380,47044,3720,660,47.4734,-122.365
530000,3,2.25,2010,11817,2010,0,47.5665,-122.023
614000,5,2.5,3150,5150,1870,1280,47.5506,-122.269
390000,3,2.5,2500,21780,1770,730,47.3282,-122.198
467000,3,2.5,1690,6642,1690,0,47.6793,-122.033
484000,6,2.5,3300,13501,2060,1240,47.5116,-122.163
340000,3,2.5,1240,1115,1240,0,47.6985,-122.34
302495,3,2.5,2200,7201,2200,0,47.3821,-122.207
532500,3,1.75,1620,3360,980,640,47.6886,-122.361
441500,3,2.5,2420,9592,1780,640,47.5093,-122.153
470000,4,2.5,2680,8062,1530,1150,47.4132,-122.328
2.3E+06,4,3.25,4250,8570,4250,0,47.6154,-122.21
590000,3,2.5,2400,99752,2400,0,47.3917,-122.084
320000,3,1.75,2300,12000,1770,530,47.7599,-122.343
363000,2,2,920,1201,800,120,47.5926,-122.295
747500,4,2.25,2350,18600,2350,0,47.7473,-122.257
750000,2,2.5,2630,7957,2630,0,47.7106,-122.023
831000,4,3,2170,4000,1610,560,47.6196,-122.292
403000,3,2.5,1700,4125,1700,0,47.5305,-121.854
445000,3,2.5,2470,4565,2470,0,47.514,-122.189
345000,3,1,1250,17380,1250,0,47.7502,-122.108
2.26E+06,3,3.5,3110,14872,3110,0,47.6178,-122.209
371025,3,2,1530,8925,1530,0,47.736,-122.199
355000,2,1,960,6250,960,0,47.5491,-122.386
270000,3,1,1240,14110,1240,0,47.4579,-122.09
425000,4,2.75,2440,15349,2440,0,47.4117,-122.333
364808,3,1.75,2320,7875,1620,700,47.4524,-122.146
320000,3,2.25,1580,6561,1200,380,47.4394,-122.14
325000,4,2.5,2963,5797,2963,0,47.3831,-122.185
350000,3,2.25,2470,10290,2230,240,47.4459,-122.124
170000,3,1.5,1370,10176,1370,0,47.4738,-122.263
255000,2,1,960,28717,960,0,47.3356,-122.502
550000,3,1,1130,7500,880,250,47.6973,-122.389
835000,4,4.25,4930,25714,4930,0,47.3069,-122.148
420000,3,1,1150,5120,800,350,47.5588,-122.392
925000,4,2.5,2190,7350,2190,0,47.5786,-122.236
389250,2,1.5,1490,4080,930,560,47.5344,-122.381
748000,3,2.5,2600,10183,1300,1300,47.6984,-122.201
284000,3,1.75,1530,9600,1200,330,47.3594,-122.076
588000,4,2,1680,5000,980,700,47.6858,-122.286
372500,3,1.75,1680,8648,1680,0,47.7338,-122.332
285000,4,3,1900,7194,1900,0,47.3768,-122.117
360000,3,1,1570,9467,1570,0,47.7683,-122.359
275000,3,1,1370,17859,1150,220,47.5617,-121.859
428000,2,2,1350,4225,1350,0,47.7106,-122.03
847000,6,2.5,3010,17864,3010,0,47.7209,-122.372
316000,3,1,1010,7838,1010,0,47.7422,-121.981
375000,3,2.5,2050,7205,2050,0,47.3487,-122.304
533000,3,1,1670,4080,1170,500,47.6899,-122.321
556000,5,2.5,3840,16905,3840,0,47.2996,-122.342
225000,4,2,2220,14120,1200,1020,47.361,-122.116
537250,4,2.5,2590,9530,1640,950,47.7752,-122.285
255000,3,1,1180,13650,1180,0,47.4551,-122.154
530000,4,2.5,2950,4836,2950,0,47.479,-122.129
5.3E+06,6,6,7390,24829,5000,2390,47.5631,-122.21
595000,3,2.75,2150,31238,2150,0,47.6596,-121.96
548000,4,2,2100,8880,2100,0,47.6115,-122.124
234975,3,1.75,1650,8073,1100,550,47.3187,-122.182
600000,3,1.75,1620,1325,1430,190,47.6498,-122.321
432000,4,1,1750,12528,1750,0,47.743,-122.097
455000,3,1.5,1380,6657,1380,0,47.7085,-122.217
279950,3,1.75,1510,11234,1210,300,47.7571,-122.328
267500,3,1.5,1600,9072,1600,0,47.3737,-122.216
620000,4,2.5,1840,220308,1840,0,47.4306,-122.049
110000,2,1,830,7590,830,0,47.4784,-122.335
625000,3,3.5,1810,1846,1440,370,47.607,-122.305
389000,2,1,910,7000,910,0,47.6999,-122.305
1.2E+06,4,2,2120,3360,2120,0,47.6227,-122.31
788500,4,2.25,2510,133729,2510,0,47.4569,-122.02
567000,5,2.25,2100,6936,1600,500,47.6737,-122.169
515000,2,2.25,2690,15000,1870,820,47.3361,-122.353
605000,4,2.5,2430,11870,1590,840,47.7761,-122.285
430000,4,3.75,2452,4800,2452,0,47.4744,-122.213
805000,2,1.75,1550,6000,1550,0,47.6712,-122.409
567500,3,2.5,2080,4556,2080,0,47.6036,-122.014
647500,3,1.75,1290,3870,1290,0,47.5873,-122.29
495000,2,1.75,1850,2530,1850,0,47.6106,-122.31
825000,4,2.5,3370,5000,3370,0,47.541,-121.998
435000,4,2.25,2730,7506,2730,0,47.4627,-122.152
445950,3,1.75,1300,7800,1300,0,47.7321,-122.195
960000,5,2.75,3040,10257,3040,0,47.5531,-122.119
780000,4,3,2440,3600,1480,960,47.6853,-122.331
274500,3,2.25,1720,9000,1320,400,47.3191,-122.383
729953,5,3,3230,5167,2000,1230,47.7053,-122.34
464950,3,1.5,1200,890,1030,170,47.6384,-122.342
620000,4,1.75,2350,18800,2350,0,47.5904,-122.177
735000,4,3.5,3100,5600,3100,0,47.5968,-121.978
450000,4,2.25,2040,9565,1400,640,47.7356,-122.335
450000,4,1,2000,4676,1250,750,47.5529,-122.268
842500,4,2.5,2160,5298,2160,0,47.6106,-122.31
360000,3,2,1970,79714,1070,900,47.4674,-122.107
585000,3,2.5,2270,100545,2270,0,47.4815,-122.47
461000,3,2.25,1850,7923,1150,700,47.7011,-122.171
345000,2,1,1350,4494,920,430,47.5315,-122.38
1.075E+06,3,2.5,3280,10302,1680,1600,47.6948,-122.286
643000,4,2.5,2270,8391,2270,0,47.574,-122.013
690000,4,2.5,2820,8307,2820,0,47.6253,-122.027
282000,4,1,1200,11111,1200,0,47.7529,-122.306
549000,3,1.75,2000,6130,1120,880,47.6925,-122.388
815000,3,2,2310,6000,1560,750,47.648,-122.395
2.2E+06,5,4.25,4640,22703,2860,1780,47.6393,-122.097
700000,3,2.25,2330,11424,2330,0,47.6386,-122.11
933399,3,2.5,3940,10360,3110,830,47.6468,-122.116
290000,3,1,1440,11250,1440,0,47.4627,-122.213
372000,4,1.75,1960,9300,1340,620,47.4487,-121.772
450000,2,1.75,1250,2890,790,460,47.6795,-122.353
303700,3,2.5,1981,5700,1981,0,47.3668,-122.178
672000,4,2.5,2440,10049,2440,0,47.5744,-121.993
334000,4,1.5,1150,9360,1150,0,47.7197,-122.173
260000,2,1,1120,5650,1120,0,47.4979,-122.241
749950,3,1.75,1800,5700,1000,800,47.6491,-122.367
330000,4,2.25,2380,122038,2380,0,47.2624,-122.015
830000,5,3,2920,2808,2140,780,47.654,-122.342
1.131E+06,3,2.25,2790,13791,2790,0,47.4389,-122.351
320000,3,1,1560,7552,910,650,47.7552,-122.327
260000,2,1,1550,15250,1550,0,47.407,-122.045
225000,3,2,1700,11475,970,730,47.4851,-122.338
279200,1,1,640,6350,640,0,47.6976,-122.359
520000,4,3.5,2680,10000,2040,640,47.726,-122.296
505000,3,2.5,1860,8060,1860,0,47.5674,-122.017
234000,3,1.75,1490,8366,1010,480,47.375,-122.14
503000,4,2.5,2470,5044,2470,0,47.7728,-122.271
606000,4,2.25,2390,8858,1740,650,47.6925,-122.184
433500,3,1,1230,6000,780,450,47.6839,-122.281
250000,3,1.5,2840,10182,1510,1330,47.524,-122.2
719000,3,2.5,2120,9307,2120,0,47.5477,-122.141
381000,3,2,1770,14400,1770,0,47.415,-122.337
267000,3,2.5,2495,4400,2495,0,47.288,-122.283
275000,1,0.75,1170,14149,880,290,47.2653,-121.91
651000,4,2.5,2740,7140,2740,0,47.6334,-122.021
439000,2,1,1050,5671,850,200,47.6767,-122.286
325000,2,1,1130,5070,1130,0,47.5141,-122.377
490000,2,1,880,6380,880,0,47.6924,-122.322
519900,4,2.5,2403,6172,2403,0,47.7361,-122.234
545000,4,2.75,3410,35040,3410,0,47.4054,-122.03
1.0625E+06,4,4,5320,20041,5320,0,47.5852,-121.966
542000,4,1.75,1900,8250,950,950,47.5765,-122.147
465000,4,1.75,1810,21650,1810,0,47.7358,-122.076
408000,2,2,1200,3900,1200,0,47.72,-122.024
292000,4,2.5,2060,5950,2060,0,47.3631,-122.192
253000,3,1.75,1250,10122,1250,0,47.3277,-122.001
280000,2,1,910,4662,910,0,47.5232,-122.354
658588,3,2.25,2560,41346,2560,0,47.4871,-122.065
635000,4,2.25,1920,8910,1200,720,47.5897,-122.156
439000,4,2.25,2240,8300,2240,0,47.7746,-122.197
300000,3,2.5,1260,3855,1260,0,47.4908,-122.154
345000,3,1.5,1360,13496,1360,0,47.4032,-122.314
283500,4,2.25,2100,8050,2100,0,47.4391,-122.193
425000,2,1,2110,4920,1460,650,47.6872,-122.339
685000,3,1.75,2210,8955,1560,650,47.6621,-122.189
750000,3,2.5,2360,12987,2360,0,47.5471,-122.149
245000,4,1.5,1280,8000,1280,0,47.4949,-122.255
585444,6,3.75,2740,6924,1640,1100,47.5816,-122.296
706000,4,2.5,2740,7571,2740,0,47.6962,-122.179
445000,4,2,2630,9099,1830,800,47.5067,-122.361
241000,3,2,1650,6000,1650,0,47.2904,-122.353
1.175E+06,2,2.5,1770,7155,1770,0,47.7345,-122.285
530000,3,1,1500,5750,1050,450,47.5677,-122.376
350000,3,1.5,1430,12199,1130,300,47.7352,-122.33
1.7E+06,4,3.75,3190,17186,3190,0,47.5115,-122.246
389000,3,1,1280,9630,1280,0,47.7677,-122.163
799000,4,2.75,2390,6820,2140,250,47.6788,-122.27
1.4E+06,4,2.5,4040,9630,2020,2020,47.6408,-122.41
340895,2,1,920,8612,920,0,47.734,-122.301
780000,4,2.5,2730,10281,2730,0,47.6227,-122.029
350000,2,1.5,1320,73600,1320,0,47.2755,-122.271
470000,3,2.5,2620,4874,2620,0,47.5328,-121.879
914600,4,3,3180,80837,3180,0,47.7336,-122.134
354000,4,2.5,2900,4762,2900,0,47.3663,-122.129
470000,5,2,1900,6000,1900,0,47.6831,-122.186
715000,3,2,1760,5400,1160,600,47.6558,-122.331
265000,2,1,760,4000,760,0,47.5466,-122.304
2.537E+06,4,3,3710,20000,2760,950,47.6696,-122.261
640000,3,1,1530,4944,1530,0,47.6857,-122.341
290000,4,1.75,1990,18900,1870,120,47.5131,-122.313
480000,5,4.75,3830,35000,2130,1700,47.7597,-122.079
535000,3,2,2040,5600,1120,920,47.5959,-122.293
907000,3,1.75,2170,12220,2170,0,47.6537,-122.195
459000,3,1.75,1620,7330,1090,530,47.7148,-122.213
1.355E+06,3,2.5,3600,21399,2310,1290,47.6191,-122.099
264950,3,1.5,1470,11599,1070,400,47.3632,-122.188
352950,3,1,1760,3000,1760,0,47.6598,-122.348
491500,3,2.25,2230,13100,1510,720,47.5413,-122.174
1.229E+06,4,3.5,3770,37034,2830,940,47.6463,-122.151
369500,3,1,1200,9194,1200,0,47.7362,-122.319
566000,3,2.5,2090,6294,2090,0,47.686,-122.095
290000,3,2.25,1500,7308,1210,290,47.4621,-122.187
5.35E+06,5,5,8000,23985,6720,1280,47.6232,-122.22
180000,3,1,870,5330,870,0,47.369,-122.077
215000,2,1,1010,6000,1010,0,47.771,-122.353
302000,2,1,1010,6000,1010,0,47.771,-122.353
352500,3,1.75,1860,7881,1160,700,47.3855,-122.322
235867,4,2,1330,5926,1330,0,47.496,-122.19
500000,3,2.25,1760,11946,1760,0,47.624,-122.05
382000,3,2.25,1800,4500,1800,0,47.7462,-121.98
515000,5,2.5,1690,2402,990,700,47.6903,-122.38
250000,1,1,660,2600,660,0,47.5723,-122.304
672500,3,2.25,2400,5300,1250,1150,47.6876,-122.384
755000,3,2.25,3020,13031,3020,0,47.6897,-122.098
707500,3,1,1500,2555,1500,0,47.627,-122.353
459000,4,2,1560,3840,960,600,47.6882,-122.365
140000,3,1,1090,10620,1090,0,47.3748,-122.294
495000,2,1,970,4284,970,0,47.6667,-122.333
757000,3,3.25,3190,5283,3190,0,47.5534,-122.002
765000,3,3.25,3190,5283,3190,0,47.5534,-122.002
359000,4,1.5,1890,6052,1890,0,47.7055,-122.3
440000,3,1,1050,7500,1050,0,47.5473,-122.396
400000,4,1.5,1390,7200,1140,250,47.7224,-122.332
652000,3,2,1700,4080,850,850,47.6785,-122.393
260000,3,1.75,1050,5850,1050,0,47.4574,-122.358
1.328E+06,5,3,3340,10796,2120,1220,47.5421,-122.229
519500,4,2,1540,17859,1540,0,47.5326,-122.032
650000,3,1,1710,5992,1560,150,47.6861,-122.354
280000,4,2.25,2100,8075,2100,0,47.3251,-122.329
515000,4,1.75,1730,7980,1730,0,47.6219,-122.138
400000,3,2.25,1500,2692,1500,0,47.7159,-122.203
652100,3,2.5,2380,5017,2380,0,47.6297,-122.021
235000,6,3,2180,7956,2180,0,47.3054,-122.305
701000,4,1.5,1840,10080,1840,0,47.5575,-122.279
640000,4,2.5,2341,9594,2341,0,47.6993,-122.115
455800,3,2.5,1690,4584,1690,0,47.6866,-122.043
504750,3,2.5,2490,21937,2490,0,47.6442,-121.898
483000,3,3,2440,15540,2440,0,47.6104,-122.06
530000,3,0.75,920,20412,920,0,47.4781,-122.49
250000,2,1,1030,8786,1030,0,47.4814,-122.341
229950,5,2.75,2000,5885,1260,740,47.3155,-122.347
884744,4,3.5,4210,9414,4210,0,47.6067,-122.022
514000,3,1.5,1610,9964,1080,530,47.6681,-122.143
532000,3,2.25,1910,35015,1430,480,47.4672,-122.006
423000,4,2.5,2660,5539,2660,0,47.4981,-122.162
420000,2,1,820,4025,820,0,47.5649,-122.38
521000,3,1.75,1730,18250,1730,0,47.737,-122.201
577000,4,2.25,2360,7490,2360,0,47.6988,-122.169
425000,3,1,970,8040,970,0,47.603,-122.132
495000,4,2.5,2460,4862,2460,0,47.7719,-122.235
340000,3,2.5,2690,8577,2690,0,47.3026,-122.351
499950,3,3.5,1820,1991,1430,390,47.596,-122.298
1.218E+06,4,3,3470,4750,2370,1100,47.5917,-122.386
720000,4,2.75,3370,7634,2110,1260,47.5259,-122.204
249000,3,1.5,1700,8247,1010,690,47.4216,-122.174
206135,3,1,1340,11070,1340,0,47.3527,-122.178
300000,5,2.75,2000,9276,2000,0,47.444,-122.19
612000,6,3,3840,14040,2460,1380,47.506,-122.241
1.10203E+06,5,2.5,3890,27311,3890,0,47.7291,-122.363
230000,4,2,1220,9100,1220,0,47.2964,-122.376
850000,3,1,2280,4600,1250,1030,47.6378,-122.372
355000,4,2.5,2770,7000,1940,830,47.3396,-122.256
442000,4,2.5,2520,7253,2520,0,47.5148,-122.159
399000,4,3,3060,5000,3060,0,47.3786,-122.126
360000,4,2.5,2390,7115,2390,0,47.2593,-122.222
390000,3,1.75,1320,7725,1320,0,47.4425,-122.133
413000,5,2.5,2900,8711,1650,1250,47.7752,-122.197
190000,2,1,700,9500,700,0,47.5294,-122.276
432900,3,2.5,2210,9226,2210,0,47.4849,-121.782
621138,3,2.25,2180,7741,2180,0,47.6482,-122.072
270000,3,2.25,2080,4252,1550,530,47.4203,-122.157
610000,4,2.25,2090,35040,1490,600,47.5739,-122.032
500000,3,2,1720,5525,960,760,47.559,-122.298
715000,4,2.25,2460,40635,2460,0,47.6627,-122.032
264000,3,1.5,1470,14821,1470,0,47.3658,-122.148
550000,3,1.75,1650,3200,1650,0,47.6209,-122.317
337000,3,2,1690,9087,1690,0,47.3724,-122.108
170000,3,1,970,8710,970,0,47.4167,-122.302
405000,4,2.5,2030,9095,1130,900,47.7321,-122.185
775000,4,2.5,2540,28563,2540,0,47.7185,-122.114
425000,3,2.25,1570,7475,1200,370,47.7223,-122.174
713000,5,2.75,2580,9242,1720,860,47.5943,-122.133
555000,5,2.5,2090,8712,1420,670,47.5968,-122.127
810000,4,2.5,3260,5608,3260,0,47.5453,-121.995
1.25E+06,4,3.75,3830,41263,3830,0,47.7237,-122.042
819000,3,3.5,2130,6150,1530,600,47.6491,-122.405
409900,3,2.5,1690,1200,1410,280,47.5389,-122.367
935000,2,2.5,1780,2067,1780,0,47.6132,-122.21
657500,4,1.75,1620,7560,1380,240,47.6981,-122.4
900000,6,3.75,4210,6105,3280,930,47.5211,-122.157
932800,5,3.25,2980,7095,2980,0,47.6919,-122.294
391000,3,2,1490,9000,1490,0,47.5455,-122.184
420000,4,2.5,2110,9825,2110,0,47.4979,-122.153
1.3E+06,6,3.5,6563,32670,5153,1410,47.6078,-122.157
415000,3,1.5,1510,16800,1510,0,47.751,-122.338
350000,3,1.75,1830,9425,1590,240,47.5038,-122.379
375000,2,1,1230,1820,830,400,47.6684,-122.401
860000,3,1.75,2180,14135,1300,880,47.673,-122.187
495000,4,2.25,2220,8872,1110,1110,47.5491,-122.17
250000,4,2.25,1730,8400,1730,0,47.3386,-122.288
365000,4,2.25,1990,21312,1990,0,47.439,-122.144
503000,3,2.75,1540,6760,1210,330,47.7163,-122.212
150000,2,1,1100,7200,1100,0,47.4752,-122.172
450000,4,1.75,1640,1480,820,820,47.6684,-122.314
355000,4,3,2590,7213,2590,0,47.2609,-122.289
245000,3,2,1450,9333,1450,0,47.346,-122.315
265900,3,2,1180,7793,1180,0,47.4053,-122.181
299000,4,2.5,1820,7575,1220,600,47.4339,-122.167
957500,4,2.25,2360,11523,2360,0,47.5318,-122.224
343000,3,1,1120,7250,1120,0,47.7143,-122.211
307500,3,2.25,1646,7364,1646,0,47.3646,-122.037
937500,5,3.75,4210,14599,4210,0,47.5364,-121.858
610000,3,3,2480,45302,1620,860,47.7591,-122.073
720000,3,1.5,1590,7080,1310,280,47.5244,-122.386
610000,4,2,2130,2620,1650,480,47.6515,-122.346
434500,3,1.75,1650,7965,1650,0,47.7335,-122.193
602500,2,2.5,3090,47044,2250,840,47.4291,-122.177
607010,4,2.5,2180,4000,1700,480,47.5553,-122.269
610000,3,1,1800,5750,1040,760,47.686,-122.395
828500,4,2.5,3720,35000,3720,0,47.7582,-122.13
199990,3,1,1100,8560,1100,0,47.329,-122.338
294000,3,1.75,1530,9362,1530,0,47.3643,-122.049
789500,4,2.5,3010,6100,3010,0,47.6647,-122.08
797000,3,3.5,3500,9473,3500,0,47.5807,-121.972
539950,5,3,3100,5250,3100,0,47.5369,-121.888
284950,4,1.5,2000,6778,1170,830,47.3708,-122.311
776500,4,1.5,2290,10372,1510,780,47.6888,-122.199
525000,4,2.5,2400,10070,1510,890,47.7104,-122.24
303000,3,2.5,1850,4957,1850,0,47.3311,-122.17
722080,3,3.25,3680,7650,2340,1340,47.6272,-122.033
140000,3,1,1060,7473,1060,0,47.3699,-122.309
235000,3,1,1060,7473,1060,0,47.3699,-122.309
440000,3,1,1610,5500,1610,0,47.698,-122.351
605000,3,1.75,2330,6000,1630,700,47.5765,-122.378
380000,2,1,1210,4800,1060,150,47.5625,-122.316
352000,4,1,1530,8890,980,550,47.5308,-122.35
420000,4,2.25,2270,12000,1360,910,47.7559,-122.148
1.175E+06,4,2,2590,7220,2590,0,47.647,-122.41
1.375E+06,3,1.5,1850,10572,1850,0,47.6194,-122.208
300000,3,1.5,1500,14750,1500,0,47.495,-122.318
1.15E+06,4,3.25,4740,49091,4740,0,47.6624,-122.071
453500,2,1.5,1710,4189,1160,550,47.5286,-122.383
443500,3,2,1920,7598,1920,0,47.7735,-122.363
332000,2,1,1150,8138,1150,0,47.737,-122.325
655000,3,2.5,2320,4721,2320,0,47.591,-122.017
475000,4,1,1420,6000,1420,0,47.6844,-122.302
372500,3,1.75,1550,12956,1210,340,47.4711,-121.752
1.05E+06,4,2.5,2920,7200,1470,1450,47.5947,-122.288
500000,3,1.75,1620,4200,830,790,47.6743,-122.285
900000,6,2.75,2300,24773,2300,0,47.5833,-122.242
327500,3,1,1070,7140,1070,0,47.5427,-122.288
390000,3,1.75,1790,7123,1790,0,47.7429,-121.981
451101,2,1.5,1510,1962,1510,0,47.6214,-122.153
455000,4,1,1340,5800,1340,0,47.5658,-122.389
650000,4,2.5,3350,46748,3350,0,47.3432,-122.025
895000,3,2.5,2500,7746,1910,590,47.6393,-122.311
800000,4,2.25,2350,10664,1510,840,47.5743,-122.238
703770,4,2.25,2550,12918,2550,0,47.5623,-122.109
249950,3,1.75,1320,10454,1320,0,47.2844,-122.216
512000,2,2,1270,3881,610,660,47.6694,-122.298
780000,5,2.5,3480,74052,1980,1500,47.4961,-122.063
336000,3,2.25,2820,11625,2820,0,47.2621,-122.218
285000,3,2,2110,6900,1220,890,47.504,-122.26
229900,3,1.75,1100,7224,1100,0,47.3717,-122.277
667500,4,3,1920,4000,1540,380,47.5718,-122.385
378000,4,2.5,1890,12236,1230,660,47.4491,-121.78
454000,3,2.5,2530,43733,1530,1000,47.46,-121.708
537500,4,2.5,2550,4630,2550,0,47.5928,-122.004
425000,3,1,1550,4160,1550,0,47.5387,-122.265
290000,3,2,1760,6600,1760,0,47.3836,-122.184
349500,3,2,1270,3600,1270,0,47.6099,-122.297
370000,3,2.75,1250,1655,830,420,47.5554,-122.382
549500,3,1.75,1620,8438,1620,0,47.703,-122.281
245000,2,1,710,6322,710,0,47.5165,-122.376
208000,3,1.75,1070,7200,1070,0,47.3134,-122.023
248000,4,2.25,2320,8760,1160,1160,47.3627,-122.285
610000,4,3.25,5450,37058,5450,0,47.351,-122.087
550000,4,2.5,1670,5116,1670,0,47.7667,-122.33
750000,3,2.75,3010,206910,3010,0,47.4881,-121.721
192000,2,1.75,1340,7380,1340,0,47.4785,-122.229
169317,2,1,790,4000,790,0,47.6248,-122.301
1.198E+06,4,3.5,3400,3850,2790,610,47.6258,-122.302
880000,2,1,1530,6350,1530,0,47.6325,-122.303
210000,1,1,930,7129,930,0,47.7234,-122.333
180500,3,1.5,1540,9800,1010,530,47.4676,-122.184
540000,4,2,1990,29078,1990,0,47.6471,-122.057
520000,3,1.75,2300,35722,2300,0,47.7455,-122.112
177500,3,1.5,1220,6000,1220,0,47.4904,-122.222
415000,3,1.75,2380,5650,1190,1190,47.5119,-122.255
495000,4,2.5,2020,7200,1010,1010,47.7289,-122.201
325000,3,2.25,1890,9646,1890,0,47.4838,-122.299
440000,2,1.75,1330,4903,1330,0,47.6819,-122.161
411000,3,1.75,1490,9844,1190,300,47.7626,-122.297
810000,5,3.5,3550,9600,2550,1000,47.5484,-122.269
561750,5,1.75,2040,8996,1020,1020,47.588,-122.118
835100,4,2.5,2380,12573,2380,0,47.5984,-122.176
450000,3,2.25,1780,9969,1450,330,47.7286,-122.168
238000,3,2.5,1650,2807,1650,0,47.4328,-122.196
299000,3,1,1510,142803,1510,0,47.3192,-122.287
570000,2,1,1100,6240,1100,0,47.6446,-122.403
340000,3,1.75,2190,12626,2190,0,47.3845,-122.154
450000,2,1.75,1760,2275,1040,720,47.5803,-122.393
272750,4,1.5,1800,8786,1330,470,47.4982,-122.345
520000,4,2,2000,6380,1860,140,47.6956,-122.303
284950,3,1,990,10723,990,0,47.4887,-122.133
255000,2,1.5,1480,9660,1480,0,47.4577,-122.289
231500,2,1,1200,9488,1200,0,47.4832,-122.299
415000,1,2,3000,204732,3000,0,47.6331,-121.945
330000,4,2.5,3504,6000,3504,0,47.3012,-122.285
365000,3,1.5,1300,12240,1300,0,47.737,-122.243
425000,4,2,1330,9188,1330,0,47.401,-122.319
400000,4,1.75,1850,6480,1120,730,47.5525,-122.313
335000,4,2.5,2240,9701,2240,0,47.3086,-122.392
342000,3,3,1260,1251,1040,220,47.5943,-122.296
490000,8,5,2800,2580,1880,920,47.6086,-122.303
331500,4,1.75,1820,14319,1820,0,47.4757,-122.148
960000,3,2.5,1730,4102,1730,0,47.645,-122.084
720500,4,2.5,3350,35298,3350,0,47.6506,-122.036
830000,3,2.5,3370,6550,2840,530,47.5442,-122.38
662990,3,1.75,1240,3600,1240,0,47.5797,-122.405
220000,4,2,2340,10507,2340,0,47.3578,-122.178
349950,5,2,1880,4179,940,940,47.5536,-122.283
550000,3,2,1810,2159,1010,800,47.6273,-122.345
396000,3,1.75,2340,5668,1200,1140,47.5588,-122.364
635000,4,1.5,2820,4000,2820,0,47.6638,-122.348
293000,3,1,1020,7650,1020,0,47.7198,-122.352
339000,3,2.25,2090,10120,1290,800,47.4654,-122.174
285000,4,2.25,1830,8734,1830,0,47.3679,-122.179
775000,6,2.75,2980,5000,2480,500,47.6684,-122.331
224000,4,1.5,1600,9289,1600,0,47.3107,-122.212
2.25E+06,4,3.5,4440,8125,3140,1300,47.5744,-122.283
165050,3,1,1200,8514,1200,0,47.2043,-122.008
275000,3,1.25,1230,4500,1230,0,47.5301,-122.271
445000,5,3,2930,5500,1750,1180,47.5572,-122.281
510000,3,2.25,2370,38639,1930,440,47.771,-122.099
1.23E+06,4,2.5,3040,7000,3040,0,47.5934,-122.244
390000,3,1.5,1610,13500,1060,550,47.7674,-122.31
460000,3,2.25,2350,10450,1390,960,47.7433,-122.259
700000,3,1.75,2000,14733,2000,0,47.6001,-122.178
874150,4,3.5,3530,14406,2570,960,47.7073,-122.244
470000,3,2.25,2220,9800,2220,0,47.7635,-122.286
374000,3,1.75,2000,9416,2000,0,47.697,-122.175
510000,2,1.75,1210,131115,1210,0,47.4599,-122.45
467000,2,2.5,1140,1181,1140,0,47.6713,-122.383
576000,4,2.5,2440,28405,2440,0,47.7386,-122.238
196440,3,2,1560,7352,1560,0,47.2804,-122.251
825000,4,2.5,3210,18901,3210,0,47.709,-122.073
281000,2,1,930,2600,930,0,47.7242,-122.161
326000,3,2.5,1782,1577,1782,0,47.7114,-122.301
340000,3,1.75,1740,46580,1740,0,47.3583,-121.927
440000,5,1.75,3690,36036,1890,1800,47.3473,-122.085
749000,4,2.5,2930,18199,2930,0,47.5937,-122.047
340000,4,1,1230,8316,1230,0,47.7269,-122.24
561000,3,2,2000,7000,2000,0,47.5452,-122.393
270000,3,2.25,1520,7930,1160,360,47.3605,-122.049
600000,2,1,1040,3600,1040,0,47.619,-122.311
219900,4,1.5,1120,5427,1120,0,47.3628,-122.087
617000,3,1.75,3020,360241,3020,0,47.2662,-122.088
469000,3,2.25,1820,8446,1820,0,47.7208,-122.236
229000,3,1,1370,56628,1370,0,47.3058,-122.306
1.265E+06,4,3,3130,2646,2290,840,47.6272,-122.316
365000,3,1.5,1640,8301,1290,350,47.7443,-122.327
429000,4,2.5,2650,9301,2650,0,47.3477,-122.271
550000,4,2.5,2850,6809,2850,0,47.7353,-121.973
453000,3,2.5,1820,16300,1220,600,47.4582,-122.365
187500,3,1.5,1180,7000,1180,0,47.2966,-122.374
520500,6,2.5,1880,14350,1640,240,47.7556,-122.352
300000,3,1.75,1280,12776,1280,0,47.4212,-122.199
799000,4,3.25,3120,5000,2370,750,47.69,-122.299
338000,3,2.5,2470,4948,2470,0,47.3438,-122.039
800000,3,1,1700,4400,1700,0,47.612,-122.292
360000,2,2,1180,3200,590,590,47.5275,-122.383
442500,6,2.5,2800,10490,1400,1400,47.7735,-122.378
700000,4,1,1300,1651359,1300,0,47.2313,-122.023
830000,5,3,3040,9601,1970,1070,47.5562,-122.22
360400,3,2.5,1630,11592,1630,0,47.7574,-122.228
345000,3,1,1340,9339,1340,0,47.5407,-122.177
300000,3,1.75,1830,51836,1430,400,47.4774,-122.098
350000,3,1,1240,10800,1240,0,47.5233,-122.185
368000,4,2,2500,36900,1540,960,47.3708,-122.049
264000,3,1.75,1760,7482,1760,0,47.3129,-122.369
435000,3,2,2660,16677,2210,450,47.3689,-122.055
200000,3,1.5,2060,15837,2060,0,47.4819,-122.223
620000,5,2.5,2540,3832,1760,780,47.6848,-122.398
1.679E+06,5,4.25,4830,11466,3720,1110,47.5774,-122.222
337000,3,1.75,1400,6000,700,700,47.5283,-122.321
1.928E+06,4,3.25,4280,20296,4280,0,47.6377,-122.212
544500,4,2.5,2230,10414,1450,780,47.5816,-122
252000,1,1,680,1638,680,0,47.5832,-122.399
445000,4,2.5,2340,3784,2340,0,47.535,-122.348
379500,3,2.25,2070,14196,2070,0,47.4617,-122.07
189950,4,2,1910,4225,910,1000,47.3084,-122.234
469000,3,1,950,4250,950,0,47.609,-122.307
600000,5,2.75,2910,53898,1510,1400,47.7201,-122.062
785000,3,2.5,2930,33981,2930,0,47.5151,-122.12
372000,4,2.75,2610,8967,2610,0,47.3747,-122.124
445000,5,3,3880,7180,3880,0,47.4797,-122.179
508000,4,2.25,3320,53392,2000,1320,47.4724,-122.014
780000,5,1.5,1940,4800,1940,0,47.6845,-122.332
541100,4,2.25,2510,9800,2510,0,47.753,-122.145
729000,4,2.5,2660,5608,2660,0,47.5449,-121.995
397000,3,2,1710,134489,1710,0,47.2207,-121.984
451555,2,1,1320,4520,1320,0,47.5655,-122.394
300000,2,1,960,8153,960,0,47.7341,-122.3
416000,3,2.5,1790,11542,1190,600,47.5124,-122.16
490000,2,1,950,3060,810,140,47.6698,-122.323
480000,6,3.75,2940,5054,2940,0,47.5122,-122.385
368000,2,2,930,1662,670,260,47.6518,-122.4
1.038E+06,3,2.5,4570,10615,4570,0,47.5533,-122.097
545000,3,2.5,2370,9000,1570,800,47.4922,-122.365
850000,5,2.75,3430,15119,3430,0,47.5678,-122.032
550000,4,3.5,3540,4750,3540,0,47.473,-122.193
600000,3,2.25,2240,9314,2240,0,47.6216,-122.032
535000,4,2.5,2710,12138,1700,1010,47.7657,-122.29
599950,3,2.5,2660,4975,2660,0,47.5487,-122.272
531000,5,2.75,2540,5022,1540,1000,47.5593,-122.3
530000,4,2.25,2210,7665,2210,0,47.5424,-122.168
597326,4,4,3570,8250,2860,710,47.5784,-122.226
805000,4,2.5,3450,33460,3450,0,47.7673,-122.1
390000,4,1.75,2330,8364,2330,0,47.4568,-122.146
487250,4,2,1690,3250,1550,140,47.6637,-122.346
301000,3,1.5,1030,8414,1030,0,47.7654,-122.297
1.175E+06,5,2.75,2560,5618,2220,340,47.6416,-122.355
299000,4,2.5,1950,3000,1950,0,47.4977,-122.226
2.35E+06,4,2.25,4370,22863,3670,700,47.6878,-122.215
400000,4,2.5,2350,3904,2350,0,47.5305,-122.351
467500,4,2.5,3160,7210,1880,1280,47.7368,-122.183
305000,4,2.5,2430,9103,2430,0,47.2939,-122.368
210000,3,1,1340,306848,1340,0,47.7534,-121.912
300000,3,1,1010,10168,1010,0,47.6453,-121.912
327500,3,2.25,1770,8755,1330,440,47.4464,-122.123
269000,3,2,1210,7136,1210,0,47.3996,-122.203
975000,4,3.25,3330,17533,1750,1580,47.652,-122.2
355000,3,1,1240,5400,1060,180,47.7115,-122.355
712000,3,1,1250,4620,1150,100,47.651,-122.341
883000,4,2.5,2960,41656,2960,0,47.7319,-122.132
190000,2,1,840,12252,840,0,47.3069,-122.013
443000,3,1.75,1530,8028,1200,330,47.7768,-122.361
920000,4,3,3750,11025,3750,0,47.6367,-122.059
285000,4,2.25,2150,8250,1240,910,47.3045,-122.378
901000,4,3.25,1560,4080,1560,0,47.5347,-122.38
552500,3,1.75,2040,5775,1410,630,47.6592,-122.393
256000,2,1,860,5000,860,0,47.5133,-122.356
341000,3,1.5,1720,7119,1720,0,47.7535,-122.314
279000,4,2.25,2090,8941,2090,0,47.4332,-122.167
686000,4,2.25,2130,10650,2130,0,47.5567,-122.159
225000,2,1,1300,11867,1300,0,47.3221,-121.903
215500,2,1.75,1220,15600,1220,0,47.2853,-122.265
950000,4,3,2420,4800,1520,900,47.6453,-122.358
503000,4,2.5,2940,156988,1870,1070,47.6214,-121.946
780000,3,2.5,2610,7567,2610,0,47.6654,-122.137
212000,4,2,1880,7500,980,900,47.495,-122.266
580000,4,2.75,2330,6703,1710,620,47.7066,-122.359
465000,4,2.5,2200,3141,2060,140,47.5726,-122.305
206000,4,2,1720,7560,1720,0,47.2845,-122.25
615000,3,2.5,2250,10171,2250,0,47.5613,-122.11
519000,4,1,1640,6305,1640,0,47.5563,-122.28
1.135E+06,4,3.25,4130,11444,4130,0,47.5208,-122.15
330000,5,2.5,2600,3839,2600,0,47.4324,-122.145
240000,4,1.5,1920,7973,1920,0,47.4961,-122.235
574000,3,2,2060,7000,2060,0,47.5644,-122.012
930000,4,4.25,5710,24663,5710,0,47.3065,-122.158
850000,4,3,2720,183823,2720,0,47.6749,-122.002
415000,3,1.5,1490,7275,1090,400,47.7148,-122.213
480000,3,2.5,2360,9005,1340,1020,47.7076,-122.337
300000,5,1,1940,8875,1940,0,47.4407,-122.275
439000,4,2.25,2570,9503,2570,0,47.764,-122.167
450000,3,1,1160,36831,1160,0,47.7507,-122.237
589000,3,2.5,2660,206480,2660,0,47.6042,-121.956
477000,3,2.25,1260,3000,1260,0,47.5459,-121.997
587500,4,2.25,1780,6120,1310,470,47.6955,-122.287
1.315E+06,4,2.25,3180,6105,3180,0,47.6255,-122.314
1.43E+06,4,2.5,3380,27589,3380,0,47.6292,-122.225
700000,4,2.25,2690,15000,1890,800,47.612,-122.064
275000,2,1,1180,6552,1180,0,47.7477,-122.342
367500,3,1,1660,11783,1160,500,47.7563,-122.075
453250,4,2.5,2260,6300,2260,0,47.7235,-121.958
607000,5,1.75,1910,5428,1390,520,47.5333,-122.392
255000,4,2,2430,8960,1430,1000,47.4979,-122.232
501000,2,2,1300,2500,770,530,47.6831,-122.373
450000,3,1,1060,4650,910,150,47.5784,-122.393
360000,3,2.25,2200,8000,2200,0,47.4522,-122.208
460000,4,1.75,1720,3050,1040,680,47.5654,-122.384
753000,3,1.75,2360,8290,1180,1180,47.6738,-122.281
389950,2,1,820,4234,820,0,47.5294,-122.386
469000,2,1,1030,4400,1030,0,47.681,-122.361
550000,4,1.75,2030,5688,1730,300,47.5071,-122.387
565000,5,3.5,2700,11675,1950,750,47.7172,-122.349
189650,2,1.75,1100,7600,1100,0,47.4136,-122.318
1.525E+06,4,3.25,3620,5131,2350,1270,47.6499,-122.37
260000,3,1.75,1340,8000,1340,0,47.3651,-122.044
243000,3,1.75,1790,12000,1040,750,47.3945,-122.313
1.1E+06,4,2.5,3830,13800,2030,1800,47.5671,-122.157
249000,3,1.5,1580,7200,1080,500,47.2761,-122.152
720000,2,1,2020,7200,1700,320,47.506,-122.384
905000,4,2.5,3330,9557,3330,0,47.5526,-122.102
824500,4,2.5,2610,3500,1610,1000,47.6848,-122.326
762500,4,2.75,2610,8760,1760,850,47.5875,-122.229
580000,3,2.5,1740,1280,1740,0,47.589,-122.387
380000,3,2,1840,8580,1840,0,47.4626,-122.132
805000,3,1.75,1080,3200,880,200,47.6503,-122.338
520000,4,1.75,1240,4532,1240,0,47.6892,-122.378
1.5695E+06,5,4.5,5620,5800,4700,920,47.6482,-122.412
175000,2,1,1170,8925,1170,0,47.4017,-122.321
353500,4,2.25,1760,9602,1760,0,47.4248,-122.158
500000,4,2.5,2230,26989,1400,830,47.4285,-122.345
386500,3,1.75,1520,7350,1140,380,47.7167,-122.17
210000,2,1,1450,4750,850,600,47.5293,-122.272
439500,3,2.5,1600,6510,940,660,47.7679,-122.308
315000,5,2.5,3220,5751,3220,0,47.3717,-122.104
339000,4,2.5,1830,8601,1830,0,47.3576,-122.016
655000,4,2.25,2200,9163,1430,770,47.5653,-122.146
740000,2,2.5,2170,8678,2170,0,47.7161,-122.014
685000,5,2.5,1900,7843,1900,0,47.6273,-122.123
550000,5,2.5,2960,9877,1480,1480,47.5866,-122.171
405000,2,1.75,1710,4234,1330,380,47.5319,-122.386
765000,4,2.25,2620,17366,1430,1190,47.584,-122.077
625000,3,2,2140,3600,1680,460,47.5846,-122.383
207000,4,2.5,2100,19680,2100,0,47.4787,-122.23
370000,4,2.5,2100,19680,2100,0,47.4787,-122.23
475000,3,2.5,1460,4961,1150,310,47.6955,-122.183
365000,2,1,990,8250,990,0,47.7252,-122.331
411800,4,2.25,2190,6800,1340,850,47.7367,-122.195
668000,5,3.5,3990,42436,2710,1280,47.461,-122
618000,3,2.5,2340,3630,2340,0,47.6059,-122.307
247500,4,2,2460,5921,1230,1230,47.308,-122.209
345000,5,3,2080,6150,1040,1040,47.5707,-122.394
616300,3,2,1700,8400,1700,0,47.6825,-122.19
348000,3,1.5,1330,6768,1330,0,47.7366,-122.319
425000,3,2.5,1630,10762,1630,0,47.7508,-122.175
850000,5,2.75,2920,11880,1660,1260,47.5133,-122.031
820000,5,2.75,2830,6137,2830,0,47.5932,-122.058
832000,4,2.25,3190,52953,3190,0,47.5933,-122.075
835000,3,1.75,1490,3840,1490,0,47.6916,-122.214
350000,3,2.5,1630,3425,1630,0,47.4913,-122.154
349000,4,2.5,2280,4096,2280,0,47.4834,-122.182
1.125E+06,6,3.75,3010,4360,2000,1010,47.6873,-122.333
320000,3,2.5,1590,3480,1590,0,47.4805,-122.178
150000,3,1,1250,7210,1250,0,47.4169,-122.168
340000,3,1,1710,10190,1310,400,47.506,-122.331
785500,4,4,3280,8448,3280,0,47.5818,-121.973
410500,4,2.5,3362,8601,3362,0,47.2592,-122.304
580000,3,2.5,2200,11000,2200,0,47.5916,-122.112
345000,2,1.5,830,920,830,0,47.5998,-122.306
550000,3,2.25,2160,37000,1760,400,47.7297,-122.139
449500,4,3,2580,7299,2580,0,47.4646,-122.15
300000,3,1,2150,7007,2150,0,47.7615,-122.362
915000,4,2.5,3510,28052,3510,0,47.6671,-122.057
1.575E+06,4,3.75,3810,9916,3810,0,47.5739,-122.234
599000,4,2.75,2020,2750,1010,1010,47.6053,-122.291
755000,4,2.5,2120,10202,1620,500,47.5858,-122.17
400000,3,1,1250,7157,1250,0,47.7323,-122.304
133000,3,1,980,9115,980,0,47.3737,-122.312
330000,4,1.5,1250,8400,960,290,47.7505,-122.315
330000,4,1,1100,5000,1100,0,47.4868,-122.204
375000,3,1.75,1330,9417,710,620,47.7231,-122.301
485000,4,2.75,2560,8956,1500,1060,47.7278,-122.177
470000,4,2.5,1850,11250,1210,640,47.6264,-122.062
1.045E+06,4,3,2790,3600,1880,910,47.6362,-122.363
548800,4,1,1660,4704,1260,400,47.6918,-122.32
315000,2,1,1080,2674,720,360,47.5595,-122.317
590000,3,2,3030,9374,2100,930,47.5289,-122.391
439950,4,2.5,2380,12067,2380,0,47.4873,-122.144
325000,3,1.75,2250,26337,2250,0,47.3032,-122.123
400000,2,1,880,5111,880,0,47.6997,-122.314
685000,4,2.5,2770,10051,2770,0,47.6288,-122.043
339950,3,2,1340,10200,1340,0,47.7756,-122.351
315000,3,1.75,1660,8160,1660,0,47.4608,-122.358
411753,3,2.5,1710,3795,1710,0,47.6968,-122.024
577000,2,1.75,1620,4879,1040,580,47.5703,-122.385
500000,3,1.75,1530,8829,1530,0,47.545,-122.171
210000,3,2,1440,10111,1440,0,47.345,-122.283
640000,4,1.75,2020,16120,2020,0,47.3413,-122.048
460000,4,1.75,1870,8663,1870,0,47.7366,-122.35
265000,2,1,620,4760,620,0,47.5286,-122.376
740000,5,5,5774,31675,4490,1284,47.3466,-122.323
230000,3,1,1240,6195,1240,0,47.7681,-122.266
315000,3,1.75,1890,10661,1460,430,47.3583,-122.056
432000,3,1.75,2410,51763,1410,1000,47.7429,-122.056
467000,3,2.5,1530,3984,1530,0,47.569,-122.007
255000,5,3.75,2800,9900,2800,0,47.319,-122.344
316500,3,1.75,1460,6360,1010,450,47.5311,-122.353
190000,4,2,1580,6250,860,720,47.7659,-122.31
490000,3,2,1450,2400,1450,0,47.6726,-122.381
378000,4,1.75,1990,23200,1990,0,47.486,-122.129
598800,6,4,4470,17877,3230,1240,47.4514,-122.273
333800,5,3,1980,3868,1220,760,47.5173,-122.275
690000,4,2.5,2920,9904,2920,0,47.5759,-121.995
320000,4,1.75,1660,6200,830,830,47.56,-122.316
1.249E+06,4,3.5,3190,6000,2410,780,47.5846,-122.29
335000,3,1.5,1560,9600,1560,0,47.6918,-122.163
840000,3,2.5,3050,33920,3050,0,47.7034,-122.072
608250,4,2.75,3030,21780,3030,0,47.4481,-122.338
550000,3,2.5,2260,4165,2260,0,47.5922,-122.008
240000,3,1,1260,7920,1260,0,47.3452,-122.308
998000,3,2.25,3370,11757,3370,0,47.5573,-122.16
275000,3,1.75,1490,8000,1490,0,47.3817,-122.166
284200,3,2.5,1570,9292,1110,460,47.3386,-122.272
1.715E+06,4,3.75,4490,7623,3090,1400,47.6315,-122.29
2.4E+06,4,3.75,4090,24825,3400,690,47.6338,-122.319
930800,5,2.5,4150,96574,4150,0,47.6664,-122.045
930000,4,3,2900,10400,1530,1370,47.5854,-122.114
215000,4,1.5,1430,8775,1030,400,47.3034,-122.383
480000,2,1.5,1008,26487,1008,0,47.3853,-122.479
483945,2,1.75,1480,5120,840,640,47.558,-122.392
347000,3,1.75,1240,8050,1240,0,47.6108,-122.044
232500,3,2,1370,9760,1110,260,47.3009,-122.384
390000,4,2.25,1770,33132,1190,580,47.4413,-122.151
550000,3,2.25,2160,15360,1410,750,47.6232,-122.138
590000,4,2.5,2340,8971,2340,0,47.5679,-122.011
420850,1,1,960,40946,960,0,47.6951,-121.864
345000,4,2.5,2280,8190,1390,890,47.4414,-122.272
429800,3,2,1970,7000,1970,0,47.3744,-122.043
302000,4,1.75,1530,17664,1530,0,47.4549,-122.155
800000,4,1.5,1790,3952,1790,0,47.689,-122.352
250000,3,2.5,1700,6000,1700,0,47.2615,-122.221
605000,3,2,2660,4500,1330,1330,47.6391,-122.403
412000,3,1.75,1950,52256,1950,0,47.3133,-122.078
252000,3,2,1340,5670,1340,0,47.4498,-122.194
375000,3,1,1130,12500,1130,0,47.5491,-122.268
725000,2,1.75,1950,2719,1010,940,47.6513,-122.346
471750,5,3.5,3790,8200,2120,1670,47.4891,-122.19
490000,4,2.25,2020,85813,2020,0,47.483,-122.026
439000,2,1,800,5100,800,0,47.6775,-122.388
355000,4,2,1770,8890,1770,0,47.4589,-122.353
250000,1,0.75,940,87120,940,0,47.7182,-121.956
780000,4,2.25,2260,16188,2260,0,47.5637,-122.112
409000,2,1,890,3271,890,0,47.5631,-122.381
420000,2,1,860,3880,860,0,47.6862,-122.391
200000,1,0.75,680,9600,680,0,47.6964,-122.306
830000,2,1.5,2130,35679,2130,0,47.6638,-122.171
695000,3,2.5,2390,4555,2390,0,47.6199,-122.025
815000,4,2.75,3488,9614,3488,0,47.6055,-122.013
210000,3,1.75,1260,6223,820,440,47.3574,-122.158
635000,3,1.75,2940,6000,1590,1350,47.7235,-122.369
562500,4,2.5,2440,7322,2440,0,47.5357,-122.179
402500,4,2.5,2600,11951,2600,0,47.3053,-122.34
555000,3,2,2080,7020,1040,1040,47.6768,-122.285
310000,3,1,1990,7173,1990,0,47.7116,-122.213
500000,4,2.5,2840,18001,2840,0,47.7359,-121.962
430000,6,3,2630,8800,1610,1020,47.7166,-122.293
1.6E+06,3,4.25,2820,7200,2460,360,47.6298,-122.29
627500,4,1,1560,4080,1560,0,47.6711,-122.331
335000,4,2.5,2330,7050,2330,0,47.5001,-122.231
962000,4,2.25,3320,20100,1810,1510,47.5566,-122.153
299000,3,1.75,1730,14270,1730,0,47.5318,-121.833
399950,4,2.5,3110,5868,3110,0,47.3781,-122.126
322000,3,1,1230,9660,1230,0,47.6829,-122.06
430000,2,1.5,950,4625,950,0,47.6912,-122.34
307000,3,1.75,1890,13860,1890,0,47.4156,-122.149
194000,3,1.5,1010,5000,1010,0,47.4925,-122.278
180000,3,1,1010,8581,1010,0,47.3043,-122.216
465000,4,2.25,2340,13383,1170,1170,47.6211,-122.037
722500,4,2.5,2460,9296,2460,0,47.6125,-122.152
470450,2,1,1010,3400,1010,0,47.6711,-122.329
280000,3,2.5,1650,6000,1650,0,47.36,-122.194
176250,4,2,1440,6702,1440,0,47.3056,-122.217
560000,5,1,1710,9100,1320,390,47.5379,-122.378
830000,3,2.5,2760,11287,2000,760,47.739,-122.264
276900,2,1,1350,10096,1350,0,47.4967,-121.778
625000,3,1.75,1660,4800,1660,0,47.6296,-122.308
1.015E+06,4,2.5,2960,4760,2160,800,47.6367,-122.318
463500,1,1,1090,8750,1090,0,47.54,-122.269
485000,3,2.5,3110,9015,3110,0,47.4369,-122.147
272000,3,2,1380,7476,1380,0,47.3336,-122.272
305000,2,1,1290,3140,1290,0,47.6971,-122.026
760000,3,2.5,1980,13964,1980,0,47.571,-122.227
387500,2,1,870,6126,870,0,47.7024,-122.322
352000,4,2.5,2470,5015,2470,0,47.3457,-122.041
507000,3,1.75,2140,40098,1490,650,47.4296,-122.111
156000,3,1,770,9750,770,0,47.4509,-122.275
580000,3,3.25,1490,857,1220,270,47.6357,-122.324
630000,4,2.5,2510,35020,1610,900,47.5834,-122.003
275000,5,1.5,1950,9000,1130,820,47.4882,-122.339
835000,5,4,3600,14720,1800,1800,47.7022,-122.227
340000,4,2.5,2380,7850,2380,0,47.4356,-122.201
329350,2,1,720,6687,720,0,47.7001,-122.362
1.48E+06,3,3.5,4070,26000,4070,0,47.659,-122.174
475000,3,1,1250,150117,1250,0,47.5956,-122.009
719950,3,2.25,2190,2416,2190,0,47.6758,-122.38
235000,1,1,810,2451,810,0,47.5188,-122.376
875000,3,1.5,2440,5750,1320,1120,47.6991,-122.296
380000,4,1.75,1740,9150,1740,0,47.4498,-122.28
325000,3,2.25,1480,97138,1480,0,47.3317,-121.927
475000,4,2.5,2120,57050,2120,0,47.7611,-122.128
152900,1,1,900,4368,900,0,47.2107,-121.99
210000,2,2,1190,7570,1190,0,47.5113,-122.338
350000,4,1,1010,6000,750,260,47.5518,-122.383
505000,3,2.5,2100,17882,2100,0,47.4754,-122.119
464900,4,2.25,2020,8424,1380,640,47.7262,-122.233
650000,3,2,2520,5980,1790,730,47.5767,-122.383
369950,2,2.75,1370,1140,1080,290,47.7053,-122.342
250000,3,2.5,1530,2890,1530,0,47.5434,-122.293
320000,3,2.5,1530,2890,1530,0,47.5434,-122.293
2.532E+06,4,4.25,5040,16048,3420,1620,47.6702,-122.26
340000,4,2.25,2530,24700,2530,0,47.3939,-122.177
440000,2,1.5,1010,1968,1010,0,47.6757,-122.385
219950,3,1,1200,7727,1200,0,47.2021,-121.999
940000,4,3,2720,11740,2720,0,47.5833,-122.242
399950,4,1.5,1850,6125,1110,740,47.5352,-122.37
1.568E+06,3,2.75,2340,8828,2340,0,47.632,-122.289
528000,4,1.75,1860,9750,1460,400,47.7097,-122.202
545000,4,1.75,1940,8990,1560,380,47.7021,-122.241
575000,2,2,1680,6194,1680,0,47.7136,-122.03
235000,4,2.75,1770,10184,1250,520,47.3074,-122.385
272000,3,2.5,1790,6371,1790,0,47.3291,-122.168
380000,4,1.75,1720,9600,1720,0,47.4764,-122.155
195000,3,1,1280,6967,1280,0,47.7512,-122.329
297000,3,2.5,1690,4988,1690,0,47.3561,-122.015
349000,4,2.5,2190,7294,2190,0,47.2923,-122.357
320000,2,1,710,5200,710,0,47.5376,-122.371
319990,4,1.5,1890,10707,1890,0,47.428,-122.326
439900,2,2,1410,12282,1410,0,47.5242,-121.926
429000,3,3.25,2210,3600,1820,390,47.7031,-122.279
272500,3,2,1540,6250,1540,0,47.3539,-122.025
400000,4,2,1350,7255,1350,0,47.7287,-122.31
462000,5,2,1380,4300,1380,0,47.6647,-122.337
510000,2,1,890,6095,890,0,47.6823,-122.298
550000,3,2.5,1900,3255,1900,0,47.6075,-122.147
150000,3,1,1240,5200,1240,0,47.3701,-122.079
460000,3,2.5,1730,8490,1210,520,47.7187,-122.219
632500,4,2.5,2090,10306,2090,0,47.6304,-122.051
361000,3,1.75,1650,11220,1650,0,47.7567,-122.071
437000,3,2.25,1130,1221,1030,100,47.6799,-122.375
370000,6,2.75,3240,5750,2160,1080,47.3054,-122.221
884250,4,2.5,3840,12151,3840,0,47.5953,-121.986
225000,3,1,1200,9936,1200,0,47.3609,-122.029
235000,2,1,870,5000,870,0,47.5186,-122.375
767500,6,3.5,2410,6000,2220,190,47.54,-122.382
1.2E+06,3,1.75,1560,8078,1560,0,47.5779,-122.246
715000,3,2.5,2410,46609,2410,0,47.6789,-122.048
417000,4,2.25,2300,7700,1380,920,47.7137,-122.322
199000,3,1,1390,12145,1390,0,47.4225,-122.15
875000,5,2.5,2920,5568,2320,600,47.6265,-122.312
545000,4,1.5,1370,3708,1370,0,47.6849,-122.363
192500,2,1,950,7692,950,0,47.4909,-122.298
822500,3,2.5,3090,7708,3090,0,47.6868,-122.108
800000,4,2.5,2390,10000,1590,800,47.5801,-122.229
1.25E+06,3,2.5,2070,4944,2070,0,47.6256,-122.284
3.85E+06,4,4.25,5770,21300,5770,0,47.585,-122.222
295000,3,2.5,1460,7936,1460,0,47.3673,-122.017
419000,2,1.75,1510,4980,1510,0,47.7191,-122.023
1.195E+06,5,3.25,5180,19606,2610,2570,47.555,-122.114
750000,4,2.75,3430,13907,3430,0,47.5879,-121.993
502000,4,1.5,1700,8400,1700,0,47.7677,-122.359
1.025E+06,3,1.75,2640,8000,1320,1320,47.5826,-122.246
398500,3,1,1200,15960,1200,0,47.7163,-122.299
700000,2,1.5,1850,4945,1850,0,47.5742,-122.379
248000,5,1.5,1510,9078,1510,0,47.4852,-122.305
800000,4,2,2130,2800,1070,1060,47.6545,-122.333
383000,4,2.5,2640,8055,2640,0,47.315,-122.193
688000,4,3,3000,4000,1970,1030,47.5744,-122.307
521000,3,2,1870,5455,1060,810,47.7029,-122.297
365000,2,1,990,9223,990,0,47.72,-122.32
491000,3,2,2005,7000,1605,400,47.6039,-122.298
643000,3,2.75,2030,7700,1400,630,47.626,-122.112
279000,3,2.5,1500,7350,1060,440,47.3025,-122.382
583500,4,1,1530,3900,1530,0,47.6748,-122.379
310000,3,2.5,1990,3600,1990,0,47.3841,-122.041
310000,3,1.75,1420,7650,1100,320,47.4892,-122.182
280000,3,1,1400,13975,1400,0,47.4195,-122.33
272000,4,2.5,1870,5692,1870,0,47.4334,-122.148
870000,4,3,3040,36246,2680,360,47.6093,-122.07
307000,3,2,1790,7259,1390,400,47.4643,-122.171
490000,2,1.5,1590,4500,920,670,47.5831,-122.392
399950,3,2,2050,9396,1170,880,47.7447,-122.328
1.635E+06,5,3.5,4220,26784,2110,2110,47.6003,-122.206
989000,5,4.5,4030,13474,4030,0,47.5812,-121.995
264950,4,1.75,1770,9011,1050,720,47.3646,-122.076
491500,4,2.75,2100,7236,1400,700,47.7267,-122.232
345000,3,2.25,2120,15003,2120,0,47.4745,-122.12
339900,4,1.75,2600,18042,2020,580,47.2969,-122.189
852000,3,3,2400,4000,1860,540,47.6288,-122.321
585000,5,3.5,3180,40946,1690,1490,47.5833,-122.073
723000,4,2,2790,8793,1640,1150,47.5509,-122.16
594000,3,2.25,2080,70567,2080,0,47.7221,-122.124
405000,2,1.5,1370,4102,1370,0,47.6943,-122.184
725500,4,2.5,2790,74495,2790,0,47.6628,-122.056
800000,2,1,1740,5719,1740,0,47.6729,-122.335
1.325E+06,3,3.75,6400,76665,3810,2590,47.7313,-122.37
180500,3,2.5,1800,8518,1800,0,47.3643,-122.185
325000,3,2.5,1800,8518,1800,0,47.3643,-122.185
235000,3,1.75,1190,7280,1190,0,47.3151,-122.19
330000,2,1,860,8308,860,0,47.5075,-122.377
678500,3,2,2460,6600,1370,1090,47.5215,-122.383
463000,4,2.5,1980,6660,1980,0,47.7158,-122.167
250000,2,1,670,4640,670,0,47.53,-122.351
655000,3,2,1410,4800,1410,0,47.5597,-122.267
239900,4,2.25,1860,7000,1120,740,47.3127,-122.339
185000,3,1,980,9135,980,0,47.3496,-122.289
1.735E+06,4,2.25,3040,5000,2080,960,47.6565,-122.278
251700,3,2.25,1810,11800,1240,570,47.4997,-122.231
400000,4,2,1560,8250,1320,240,47.7565,-122.358
735000,4,1.75,2100,7960,1340,760,47.6079,-122.195
1.7E+06,5,2,2500,15250,2500,0,47.5883,-122.111
82500,2,1,520,22334,520,0,47.4799,-122.296
765000,4,4,3010,7221,3010,0,47.5833,-121.97
292500,4,1.75,2140,8162,1420,720,47.3096,-122.377
270000,3,2.25,2390,7000,1990,400,47.4568,-122.169
415000,2,1,1510,6807,1090,420,47.711,-122.353
950000,4,1.75,2210,19025,1460,750,47.5927,-122.203
353000,3,2.75,2170,8396,2170,0,47.3812,-122.023
670950,3,2.5,1790,2375,1790,0,47.6726,-122.38
280950,3,1.75,1390,8700,840,550,47.4725,-122.202
585000,3,1.75,1850,7735,1850,0,47.5608,-122.082
525000,2,1.5,1480,43645,1480,0,47.5484,-122.045
605000,3,1.75,1850,8823,1370,480,47.6379,-122.112
1.01E+06,4,3.5,3350,3752,2550,800,47.6782,-122.365
245990,3,1,1040,8410,1040,0,47.453,-122.289
535000,4,2.25,2810,12607,2810,0,47.4585,-122.13
410000,1,1.5,1010,5750,1010,0,47.5411,-122.392
550000,3,2.5,2250,7752,2250,0,47.7489,-122.185
665000,3,1.75,1800,8000,1800,0,47.6357,-122.119
455000,3,1,2400,17239,1890,510,47.75,-122.245
440000,4,1,1780,4000,1780,0,47.6624,-122.354
332000,3,2.25,2120,14915,1720,400,47.3524,-122.285
280000,3,2.5,1860,6607,1860,0,47.2891,-122.351
570000,3,3.5,1460,1021,1150,310,47.6169,-122.309
250000,3,1,1230,10350,1230,0,47.428,-122.199
238000,2,1,1088,8453,1088,0,47.2685,-122.231
265000,3,1,800,5760,700,100,47.7505,-122.317
306000,3,1,1190,10350,1190,0,47.7428,-122.244
345000,5,2.75,1940,4182,1240,700,47.4911,-122.17
765000,4,2.5,3300,10764,1720,1580,47.7119,-122.365
346300,4,2.5,2590,11018,2590,0,47.2634,-122.211
342500,3,2,2080,11375,2080,0,47.214,-121.993
501000,4,2.25,2680,5439,2680,0,47.7534,-122.218
270000,3,2.5,1670,8364,1300,370,47.369,-122.084
638000,3,1,1830,4400,1720,110,47.6052,-122.3
460000,3,1.75,1400,2003,700,700,47.6508,-122.368
760000,4,1.75,2770,8521,1470,1300,47.6255,-122.199
1.085E+06,3,2.5,3630,11019,2150,1480,47.561,-122.226
234000,3,1,1040,8128,1040,0,47.7425,-121.981
1.65E+06,3,2.75,2690,8890,2690,0,47.5487,-122.197
488000,5,2,2020,5000,2020,0,47.6949,-122.37
1.55E+06,5,2.5,2450,20805,2450,0,47.6275,-122.227
499000,4,3,2030,12675,2030,0,47.7689,-122.379
150000,3,1,1450,6776,1450,0,47.5056,-122.244
333000,4,2.5,2400,7270,2400,0,47.2697,-122.312
700000,4,2.75,2870,8625,1860,1010,47.7425,-122.289
275000,4,1,1340,22500,1340,0,47.489,-122.316
330000,3,2.5,1680,11312,1080,600,47.5051,-122.344
360000,4,2,1850,8827,1850,0,47.7406,-122.313
467000,3,1,1220,8040,1220,0,47.7133,-122.308
568000,3,2.5,2320,57063,1790,530,47.6163,-122.056
605000,5,2.25,3220,9603,3220,0,47.6474,-122.11
750000,4,2.75,3190,9023,3190,0,47.5898,-121.989
760000,3,2.75,3530,69834,3530,0,47.6377,-121.995
265000,3,1.75,2050,10519,1240,810,47.4257,-122.146
490000,3,1.75,1720,12540,1720,0,47.5699,-122.177
360000,4,2.5,2850,4650,2850,0,47.3552,-122.026
311750,4,2.25,2270,12000,1290,980,47.3287,-122.353
399000,3,2.25,1880,12473,1420,460,47.7623,-122.256
347000,4,2.5,2770,9751,2770,0,47.3739,-122.126
1.68E+06,4,3.75,4490,34982,4490,0,47.6406,-122.156
585000,4,2.5,3110,6479,3110,0,47.5408,-121.861
340000,4,2.5,2360,7475,2360,0,47.4052,-122.17
612000,3,2.5,2180,5496,2180,0,47.5723,-122.007
230000,2,1.75,1910,3376,1910,0,47.3733,-122.057
604000,4,2.5,2260,7753,2260,0,47.5752,-121.995
250000,3,1.75,1770,8868,1770,0,47.3188,-122.212
258500,3,2,1460,7930,1460,0,47.359,-122.049
783000,4,2.75,2080,5000,1470,610,47.6422,-122.403
1.05E+06,5,2.25,2960,7680,1550,1410,47.6456,-122.389
760000,4,2.5,3220,4031,3220,0,47.688,-122.163
276000,3,1,1140,5000,1140,0,47.5535,-122.362
550000,4,2,1660,12377,1660,0,47.6231,-122.102
398000,4,1,1430,6240,1430,0,47.7272,-122.311
775000,3,3,1820,4300,1620,200,47.6711,-122.364
1.0275E+06,4,3,3540,10202,2720,820,47.5471,-122.155
327000,4,1,1620,6000,1620,0,47.4763,-122.206
564500,4,2.75,3100,14568,3100,0,47.7302,-121.974
782000,4,1.75,1500,6820,1500,0,47.6794,-122.37
398000,4,2.5,2820,5510,2820,0,47.3477,-122.024
257000,3,1.75,1850,10920,1850,0,47.7244,-122.222
235000,4,2,1570,9415,1570,0,47.3168,-122.174
453000,4,2.75,2300,37533,1550,750,47.3714,-122.431
535000,2,1,920,9000,920,0,47.6831,-122.189
275000,3,2.5,1600,7000,1600,0,47.3534,-122.057
665000,3,2.5,2630,10047,2630,0,47.5515,-122.083
670000,4,2.75,3020,13530,1540,1480,47.6299,-122.099
465000,3,1.75,1490,10757,1060,430,47.72,-122.229
210000,3,1.5,1160,5200,1160,0,47.364,-122.094
265000,4,2.5,2040,4443,2040,0,47.3182,-122.189
426000,2,2.5,1550,2657,1550,0,47.7034,-122.188
529219,4,2.25,1990,7610,1290,700,47.6236,-122.103
600000,3,2.25,1900,46609,1440,460,47.7529,-122.116
875000,5,3.5,3840,8279,3840,0,47.6039,-122.059
608000,4,3,2400,7680,1200,1200,47.6466,-122.389
220000,3,1,1660,21514,1660,0,47.2159,-121.964
1.76E+06,4,5,6055,21630,3555,2500,47.5524,-122.112
295450,3,2,2030,17120,1890,140,47.2953,-122.185
315000,2,1,840,5087,840,0,47.5557,-122.278
205000,4,2,1450,8175,1450,0,47.3933,-122.195
310000,3,1.5,1460,9908,1460,0,47.4275,-122.331
1E+06,5,1,2010,5210,1890,120,47.6501,-122.37
525000,4,2.5,2910,7631,2910,0,47.3552,-122.001
284000,4,1.75,1880,8800,1130,750,47.5137,-122.333
510000,3,1.75,2170,26460,1450,720,47.6147,-122.045
405000,2,1,1260,4377,1260,0,47.6988,-122.354
509950,3,2.5,1970,9153,1970,0,47.7698,-122.268
600000,4,2.25,2090,45738,2090,0,47.6876,-122.049
990000,4,3.75,3450,4940,2570,880,47.692,-122.338
280005,3,1.5,1130,7200,1130,0,47.5041,-122.253
700000,3,1.75,2600,7668,1300,1300,47.3402,-122.046
330000,3,1,1030,7620,1030,0,47.5281,-122.375
340000,2,1,1700,6718,1230,470,47.4131,-122.331
468000,2,2.5,1480,2167,1390,90,47.6658,-122.132
1.339E+06,4,2.5,4250,19387,3260,990,47.5578,-122.212
515000,3,1.75,1600,20873,1600,0,47.5632,-122.182
245000,4,2,1870,8750,1870,0,47.1985,-122.001
265000,3,2.5,1440,7741,1000,440,47.4042,-122.194
372400,3,2.5,2720,11937,2720,0,47.4185,-122.212
390000,3,1.5,1240,8410,1240,0,47.753,-122.328
208000,3,1,1020,6120,1020,0,47.278,-122.205
273000,2,0.5,1180,7750,590,590,47.769,-122.316
455000,5,3.5,3080,7759,2310,770,47.7454,-121.977
270000,4,2.5,1750,6397,1750,0,47.3082,-122.358
618000,4,2.25,2530,8736,1210,1320,47.6049,-122.126
213550,3,2.5,1580,8541,1580,0,47.3334,-122.289
210000,5,1.75,2340,9148,2340,0,47.4232,-122.324
2.75E+06,5,4,6300,16065,4360,1940,47.5922,-122.207
403500,4,2.75,2400,3844,1200,1200,47.7027,-122.347
235000,3,1.5,1300,7600,1300,0,47.2083,-122.005
287500,3,2,1760,7147,880,880,47.4799,-122.232
546800,4,1.5,1520,5910,1020,500,47.6904,-122.295
183000,3,1.75,1070,8100,1070,0,47.2853,-122.22
560000,3,2,2560,216777,2560,0,47.295,-122.086
299500,3,1,1280,6726,1280,0,47.5724,-122.301
610000,4,2.25,1660,7350,1660,0,47.6263,-122.124
288350,3,1.5,1860,7963,1200,660,47.4513,-122.268
500000,2,1,950,4500,850,100,47.6562,-122.354
625000,4,2.75,2140,4000,1190,950,47.6792,-122.287
418000,2,1.5,1480,1349,1240,240,47.5439,-122.386
660000,3,3,2260,1825,1660,600,47.6108,-122.308
775000,4,2.5,2300,6158,2300,0,47.6943,-122.299
429500,3,2.75,1650,7272,1230,420,47.7232,-122.174
569000,3,2,1990,3000,1230,760,47.6272,-122.29
250000,4,2,1960,7560,1160,800,47.4081,-122.178
225000,3,1.5,1310,10491,1310,0,47.3682,-122.148
530000,4,2.75,2450,15002,2450,0,47.4268,-122.343
306000,3,1,910,8658,910,0,47.7586,-122.303
517100,3,1.75,1580,9719,1580,0,47.5396,-122.18
354950,3,1.75,1780,9689,1130,650,47.7628,-122.163
348000,3,1.5,1040,1824,1040,0,47.6793,-122.3
522250,4,2.5,2340,41600,1640,700,47.7466,-122.077
275000,3,2.5,1720,8755,1000,720,47.3186,-122.391
390000,3,1.5,1600,10440,1600,0,47.7109,-122.311
260000,3,1.5,1320,9750,1320,0,47.4267,-122.331
585000,5,2.75,2350,4178,1520,830,47.6388,-122.3
605000,5,2.75,2740,5616,1670,1070,47.6866,-122.317
342000,4,2.5,2300,6448,2300,0,47.3813,-122.204
900000,5,3,4350,37169,2950,1400,47.6518,-122.16
252000,3,1.75,1430,7700,980,450,47.3993,-122.183
357000,3,1.75,2400,14012,2400,0,47.3371,-122.325
370000,3,1,940,7910,940,0,47.6181,-122.117
322500,3,1,1020,13504,1020,0,47.5121,-122.17
210000,2,2,1680,5756,1680,0,47.3065,-122.222
290000,2,1,1340,9840,1340,0,47.7202,-122.339
860000,4,3.25,3960,7012,3960,0,47.5854,-122.08
302000,6,2,2650,4621,2650,0,47.5543,-122.275
369160,4,2.25,2120,9680,2120,0,47.3367,-122.332
1.185E+06,4,2.75,2850,3000,2530,320,47.6406,-122.304
993000,4,2,2850,14810,2490,360,47.5892,-122.203
380000,6,2,1870,6969,1870,0,47.5342,-122.036
635000,4,2,2660,8160,1380,1280,47.7229,-122.359
260000,3,1,1190,11120,1190,0,47.5687,-121.898
243000,2,1,1770,5522,960,810,47.4974,-122.231
1.4E+06,4,2.5,2770,8879,2770,0,47.5831,-122.193
665000,4,2.5,2080,8100,1220,860,47.7228,-122.369
898000,5,2.25,2700,9000,2700,0,47.6599,-122.146
583000,4,2.75,2200,9453,1100,1100,47.5744,-122.305
429000,4,1.75,2160,7700,2160,0,47.6976,-122.169
471000,3,2.5,2010,4059,2010,0,47.7317,-122.197
1.81E+06,3,3.5,3780,8295,2430,1350,47.6394,-122.29
739500,3,3.25,4460,51177,4460,0,47.3648,-122.143
450000,3,1.5,1770,17208,1160,610,47.5659,-122.117
552500,3,1,1430,5000,1430,0,47.6895,-122.37
437000,4,1.75,1700,10642,850,850,47.5674,-122.142
270000,4,2,1830,5220,1830,0,47.5331,-122.278
226740,3,1.5,1410,8800,1410,0,47.2927,-122.183
446500,4,2.5,3060,7920,1810,1250,47.7675,-122.261
283000,3,2,1820,15068,1520,300,47.2103,-121.999
445000,4,1.75,2430,13211,2430,0,47.5245,-121.926
250000,2,1,740,6840,740,0,47.5172,-122.375
307000,3,1,770,6552,670,100,47.5133,-122.372
315000,4,2.75,2200,8580,1860,340,47.295,-122.37
555000,3,3,2920,23085,1540,1380,47.5159,-122.395
264900,4,2.5,2040,7000,1250,790,47.4056,-122.176
510000,3,2,1600,4510,990,610,47.6939,-122.34
328000,4,2.5,1990,3980,1990,0,47.4445,-122.17
358000,4,2.5,1830,7308,1830,0,47.3565,-122.015
325000,3,2.5,2540,4260,2540,0,47.3989,-122.164
1.365E+06,2,3.25,2700,3444,2700,0,47.5684,-122.06
230000,4,2,1440,10800,1440,0,47.3417,-122.283
545000,3,2,1550,4000,940,610,47.6379,-122.387
705380,3,2.5,2490,4343,2490,0,47.5493,-121.993
459000,5,2.5,2650,12987,1350,1300,47.7482,-122.244
815000,4,2.25,2000,3800,2000,0,47.6852,-122.311
495000,6,5,3440,4500,3280,160,47.4871,-122.219
520000,3,2.5,2280,58712,2280,0,47.3053,-122
430000,2,1.5,1320,1194,1320,0,47.6704,-122.39
255000,4,2.5,2070,7800,2070,0,47.3487,-122.315
588000,3,2,1860,4777,1860,0,47.6892,-122.311
350000,3,1,940,7811,940,0,47.6195,-122.118
625000,4,2.75,2290,21486,2290,0,47.5515,-122.189
172500,2,2,1510,20685,1250,260,47.481,-122.116
554000,3,2,1830,3500,1290,540,47.573,-122.383
775000,4,2.5,3090,7112,3090,0,47.705,-122.118
1.1875E+06,4,3.5,4340,217800,4340,0,47.6471,-122.013
618000,3,2.75,3200,12682,3200,0,47.7443,-122.26
305000,4,1,1560,8450,1560,0,47.4552,-122.354
232000,3,2,1280,13356,1280,0,47.3715,-122.074
262000,4,2.5,2020,6236,2020,0,47.2796,-122.247
234000,3,1,1040,8122,1040,0,47.3731,-122.312
500000,4,2.75,2260,7209,1330,930,47.7088,-122.302
278000,3,1,860,7632,860,0,47.4623,-122.345
230000,5,1,1920,19040,1160,760,47.4756,-122.294
500000,4,1.75,2290,9215,1270,1020,47.5328,-122.051
366500,4,2.75,2070,9300,1120,950,47.7416,-122.32
665000,6,3,4250,4400,3020,1230,47.5584,-122.283
1.101E+06,3,1.5,2220,4830,1790,430,47.5825,-122.4
575000,2,1.75,1840,4076,1140,700,47.6875,-122.393
674750,4,2.5,2590,9753,2590,0,47.5848,-122.027
719000,5,2,3110,6131,1560,1550,47.5615,-122.279
482000,3,1.75,2600,105587,1300,1300,47.4464,-122.497
254000,2,1,1060,8187,1060,0,47.7508,-122.349
443725,3,1.75,1250,3880,750,500,47.6869,-122.392
575000,4,2.5,2520,35636,2520,0,47.652,-122.031
469000,3,2.25,2070,9957,1440,630,47.7766,-122.277
175000,2,1,1300,44431,1300,0,47.327,-122.267
437000,5,2,2190,8316,1390,800,47.5488,-122.298
550000,4,3,2760,13113,1760,1000,47.7669,-122.268
172040,3,2.25,1710,7134,1130,580,47.3911,-122.191
363000,3,2,1750,7000,1750,0,47.3693,-122.041
282000,3,2.25,1552,3600,1552,0,47.3198,-122.178
400000,6,2,2350,6554,2000,350,47.5115,-122.256
650000,5,3.5,5110,10018,3850,1260,47.7261,-122.17
365000,3,2.5,1720,99916,1720,0,47.3391,-122.093
269950,4,2.5,1960,7230,1960,0,47.2855,-122.36
260000,2,1,1270,19602,1270,0,47.3375,-122.048
193000,3,1.5,1180,7000,1180,0,47.2959,-122.373
340000,4,2.25,2230,6791,2230,0,47.3769,-122.028
900000,4,3.25,4700,38412,3420,1280,47.6445,-122.167
371000,3,2.5,2150,8361,2150,0,47.4627,-122.129
592000,3,2.5,2400,81892,2400,0,47.5028,-121.769
300000,3,2.5,1830,12750,1830,0,47.5003,-122.328
449950,4,3,2800,6977,2800,0,47.3542,-122.014
299500,3,2.5,2090,7163,2090,0,47.2735,-122.295
995000,4,2.25,2340,13406,2340,0,47.5377,-122.221
335000,4,1.75,1670,9472,1100,570,47.5299,-122.357
280000,4,2.25,1990,7350,1180,810,47.3258,-122.328
446000,4,2.25,2270,7800,1290,980,47.7278,-122.192
1.5445E+06,4,2.75,4910,15139,2560,2350,47.6444,-122.22
325000,3,1,950,4500,950,0,47.5273,-122.265
450000,3,1.75,1610,11200,1610,0,47.6641,-122.176
322500,4,2.5,1940,7107,1940,0,47.3843,-122.032
453000,3,1,1210,9473,1210,0,47.5637,-122.139
655000,4,2.5,2570,4412,2570,0,47.7076,-122.232
603000,3,2.25,1700,2800,1150,550,47.6819,-122.311
235000,4,1,1610,24000,1610,0,47.2751,-122.252
968933,4,3.5,4120,7304,3070,1050,47.681,-122.167
1.015E+06,3,3.5,2880,11340,1690,1190,47.6113,-122.058
435000,4,2.25,1990,8548,1990,0,47.667,-122.178
242000,3,2,1260,8092,1260,0,47.3635,-122.054
487000,6,3.25,4750,248600,4750,0,47.1879,-121.973
810000,4,2.75,3010,10450,3010,0,47.6979,-122.112
625000,3,2.5,2410,64073,1820,590,47.7457,-122.141
165000,3,1.5,1280,7742,1280,0,47.3323,-122.276
335000,3,1,2320,6750,1160,1160,47.5327,-122.276
286700,3,1,1220,6600,1220,0,47.5297,-121.827
699000,2,1.5,1400,4050,1400,0,47.6768,-122.269
280000,3,1.75,1590,7280,1140,450,47.4288,-122.153
580000,4,2.5,2220,7064,2220,0,47.5716,-122.022
754800,2,2.5,2770,7781,2770,0,47.7072,-122.017
525000,4,2.5,2303,16801,2303,0,47.7266,-121.966
562000,3,1.75,1600,10530,1600,0,47.7437,-122.291
575000,4,1.75,1280,6060,860,420,47.6805,-122.364
808900,5,2.5,2900,5901,2900,0,47.5396,-121.998
992000,3,2.25,2950,15207,2070,880,47.5571,-122.216
335000,3,2.5,1700,6698,1700,0,47.3826,-122.028
473000,3,2.75,1050,7200,1050,0,47.7163,-122.303
350000,4,2.75,2990,11210,1880,1110,47.3357,-122.336
1.6E+06,5,2.5,3100,5374,3100,0,47.6154,-122.283
305500,3,1,1240,6090,1240,0,47.7542,-122.307
306000,2,1,780,13500,780,0,47.7383,-122.074
233000,2,2.25,850,1656,850,0,47.7064,-122.344
490000,3,1.75,1540,9000,1540,0,47.7152,-122.322
445000,4,2.5,2280,42077,2280,0,47.3424,-122.077
355000,3,2.25,2550,9674,1850,700,47.4856,-122.247
360000,2,2,1770,7607,1770,0,47.4287,-122.163
737500,3,1.75,2320,10900,2320,0,47.6877,-122.283
985000,3,3.5,2600,11920,2600,0,47.582,-122.194
349950,2,3.25,1570,2031,1310,260,47.548,-122.375
520000,4,2.5,3060,7161,2860,200,47.5383,-121.879
355950,4,2.5,1960,8540,1220,740,47.7654,-122.359
485000,5,2.5,3270,6129,3270,0,47.4461,-122.208
143000,3,1,1090,3315,1090,0,47.3159,-122.183
3.278E+06,2,1.75,6840,10000,4350,2490,47.6042,-122.112
355000,3,1,940,8512,940,0,47.7002,-122.191
1.126E+06,5,3.5,3880,13885,2540,1340,47.5696,-122.156
200000,5,1.75,1770,15525,1770,0,47.5025,-122.142
913000,4,2.5,3640,10576,3640,0,47.5899,-121.979
1.6E+06,3,2.5,3160,12824,1820,1340,47.6151,-122.216
409900,2,2.5,1590,1845,1590,0,47.6897,-122.175
265000,4,1,1290,6034,1050,240,47.5223,-122.286
740000,5,3,3655,51836,2174,1481,47.6434,-122.115
306000,4,2.5,2490,8124,2490,0,47.3347,-122.17
381000,3,2.5,1470,3999,1470,0,47.5328,-121.871
1.22E+06,3,3.25,3960,6132,2600,1360,47.6396,-122.409
1.05E+06,3,3.5,3190,29982,2630,560,47.458,-122.368
408000,2,1,810,7440,810,0,47.7346,-122.352
739900,5,2.5,2980,5377,2980,0,47.7074,-122.101
674250,4,2.5,2780,35000,2780,0,47.7386,-122.091
438400,2,1,1340,8100,1340,0,47.7218,-122.37
1.7E+06,5,5,4930,14649,4160,770,47.5829,-122.247
703000,3,2,1360,5980,1360,0,47.5852,-122.388
262000,3,1.75,1320,6530,1320,0,47.2871,-122.354
353000,3,2,1210,14499,1210,0,47.4705,-121.754
500000,4,2.5,1940,7607,1940,0,47.685,-122.158
1.28E+06,4,2.5,3160,4620,2020,1140,47.5875,-122.382
332000,4,2.5,1980,6566,1980,0,47.3809,-122.097
824000,4,2.5,2320,14240,1620,700,47.6269,-122.09
290000,4,2,1660,4788,1660,0,47.5878,-122.312
700000,3,2.5,1660,1545,1400,260,47.6268,-122.353
550000,2,1,1080,3420,780,300,47.6715,-122.393
549000,2,1,1510,11165,1510,0,47.7212,-122.331
1.865E+06,4,2.5,2950,43560,2550,400,47.5988,-122.207
858000,4,2.25,3070,13720,3070,0,47.6133,-122.152
345000,2,1,970,10423,970,0,47.7252,-122.331
340000,4,1.75,2140,11651,2140,0,47.196,-122.006
1.215E+06,4,2.25,2570,9600,2570,0,47.5791,-122.241
275000,3,2.25,1260,1488,1260,0,47.7071,-122.336
405000,3,1,1220,7771,1220,0,47.6326,-122.119
432500,3,2,1720,8145,1720,0,47.7393,-122.325
236500,4,1,2140,4217,1320,820,47.5484,-122.287
679000,4,1.5,1420,4923,1420,0,47.6901,-122.339
543000,4,2.5,2060,8451,2060,0,47.7168,-122.333
294000,3,1,1320,9520,990,330,47.4857,-122.253
340500,3,1.75,1810,10463,1810,0,47.4581,-122.162
1.012E+06,4,2.5,2980,16263,2980,0,47.5457,-122.153
335000,2,2,1350,2560,1350,0,47.6344,-122.107
425000,3,2,1540,8011,1540,0,47.7342,-122.202
353000,3,2.5,2510,9240,2510,0,47.1896,-122.013
540000,3,2.5,1670,5146,1670,0,47.5707,-121.999
640000,5,3.5,3690,11928,2540,1150,47.6108,-122.06
339950,3,1,1320,11457,1320,0,47.7738,-122.261
195000,3,1.75,1510,8400,980,530,47.4476,-121.771
322000,3,1.75,1510,8400,980,530,47.4476,-121.771
660000,4,1.75,1870,10450,1620,250,47.5938,-122.154
280000,6,3,2400,9373,2400,0,47.3262,-122.214
300000,6,3,2400,9373,2400,0,47.3262,-122.214
207500,3,1,1170,8816,1170,0,47.3059,-122.368
195000,3,1.5,1190,8726,1190,0,47.4887,-122.343
700000,3,2,2080,3880,1160,920,47.686,-122.391
560000,4,1.75,2150,8555,1460,690,47.5344,-122.345
260000,3,1.75,1580,7344,1580,0,47.5256,-122.38
575000,3,1.75,1580,7344,1580,0,47.5256,-122.38
475000,3,2.5,2370,3239,1950,420,47.7515,-122.174
285000,3,1.75,1840,8601,920,920,47.5359,-122.276
753888,4,2.5,2660,5500,2660,0,47.5439,-121.996
650000,3,2.5,2190,3600,2190,0,47.5506,-121.993
620000,3,2.25,1660,3478,1100,560,47.6773,-122.372
526000,3,1.75,1780,37801,1300,480,47.5858,-122.015
155000,2,1,700,5200,700,0,47.4924,-122.175
342000,4,2,1570,11200,1120,450,47.7573,-122.217
390000,3,1.75,1220,216332,1220,0,47.7224,-121.926
685000,3,2.75,3150,219978,3000,150,47.553,-121.946
608000,4,2.5,2690,4736,2690,0,47.6869,-122.036
179900,2,1,680,6400,680,0,47.5136,-122.316
1.245E+06,6,3.25,3750,14150,2750,1000,47.6999,-122.393
166000,3,1,1010,11675,1010,0,47.4849,-122.301
462000,3,1.5,1710,4500,1410,300,47.5366,-122.268
545000,4,2.5,2090,6023,2090,0,47.5713,-121.997
415000,3,1,1560,4500,1560,0,47.6118,-122.306
269000,3,2.5,1560,4200,1560,0,47.3838,-122.026
356500,4,2.5,2570,11473,2570,0,47.2809,-122.296
225000,3,1,1010,7633,1010,0,47.3781,-122.314
175000,2,1,1020,5130,1020,0,47.301,-122.226
549000,5,2.5,1710,9720,1710,0,47.5903,-122.157
535000,3,2.75,2300,12197,2300,0,47.4369,-122.338
627000,4,2.25,1990,7712,1210,780,47.5688,-122.087
565000,3,2,2730,15677,2730,0,47.4612,-122.365
392450,4,2,2195,2681,1060,1135,47.6965,-122.342
509000,2,2,1560,4675,1560,0,47.7086,-122.019
340000,3,2.5,1400,4800,1200,200,47.6865,-122.379
537000,3,2.5,1400,4800,1200,200,47.6865,-122.379
865000,4,3,3690,9892,3690,0,47.5937,-121.982
358000,2,1,1140,8340,1140,0,47.7448,-122.3
595000,4,2.25,1920,3225,1300,620,47.5848,-122.384
661000,4,2.5,2496,8058,2496,0,47.6791,-122.149
419950,3,2.25,2280,8500,1680,600,47.7211,-122.166
490000,4,3.5,3200,6420,3200,0,47.3545,-122.001
525000,2,1,880,4000,880,0,47.6847,-122.387
350000,3,2,1320,1298,1320,0,47.6959,-122.376
552500,3,2.5,2450,3582,2450,0,47.7749,-122.159
210000,3,1,1040,8970,1040,0,47.3283,-122.337
390000,3,2.5,2480,53250,2480,0,47.3323,-122.079
336800,5,1.75,1830,16650,1610,220,47.7734,-122.315
465000,3,2.5,1440,4473,1440,0,47.6825,-122.036
299900,4,2.5,1580,3632,1580,0,47.3672,-122.019
715000,3,3.25,3230,5000,3230,0,47.5558,-122.002
235000,4,2.5,1810,39639,1230,580,47.3472,-122.11
276000,3,2.5,2495,4400,2495,0,47.2877,-122.283
265000,4,1.5,1740,12728,1180,560,47.2808,-122.3
425000,3,1.75,1680,3000,840,840,47.686,-122.346
313000,4,2.5,2460,10320,2460,0,47.2599,-122.215
715000,3,2.5,3050,6000,1720,1330,47.7701,-122.389
265000,3,2.25,1630,10969,1630,0,47.3305,-122.285
646000,3,2.75,2460,6413,2460,0,47.7497,-122.245
175000,3,1,1030,6600,1030,0,47.4941,-122.34
649000,3,2.5,3410,13809,2450,960,47.3424,-122.326
785000,3,2.75,2310,5200,1520,790,47.6357,-122.397
890000,4,2.75,2610,4400,1260,1350,47.6158,-122.293
612000,3,3,2330,10327,2330,0,47.7239,-122.164
330000,4,2.5,2980,5674,2980,0,47.277,-122.347
493000,3,2.25,1790,11393,1790,0,47.6297,-122.099
1.6E+06,4,2.25,2940,5735,1470,1470,47.6381,-122.304
1.62E+06,4,3,3900,9750,2520,1380,47.5605,-122.158
1.65E+06,4,3,3900,9750,2520,1380,47.5605,-122.158
499000,3,2.5,1750,2150,1230,520,47.6037,-122.311
603500,6,2.75,2660,8400,1550,1110,47.549,-122.173
530000,2,1.5,1580,3680,1280,300,47.5762,-122.377
895000,5,2.5,2350,14197,1220,1130,47.6005,-122.204
267345,4,2.25,2510,8165,1610,900,47.3092,-122.372
275000,3,2.5,1480,15639,1480,0,47.4723,-121.746
439950,3,1.75,1720,223377,1240,480,47.7329,-121.92
455000,3,2.25,1470,4653,1470,0,47.5667,-122.018
630000,3,1.75,1540,6930,1250,290,47.6782,-122.278
690000,3,2.5,2820,5001,2820,0,47.5533,-121.992
212000,4,1.75,1250,12705,1250,0,47.302,-122.382
231500,4,2.25,2080,7526,1280,800,47.3762,-122.183
1.2375E+06,4,3.25,5180,49936,5180,0,47.6676,-122.069
378500,3,2.5,2860,43821,2860,0,47.3163,-122.142
482000,4,2.5,2710,35868,2710,0,47.375,-122.022
695000,2,1,1140,3990,1140,0,47.6554,-122.333
965000,4,2.5,4070,57587,4070,0,47.6908,-122.052
675000,3,1.75,1710,5913,1120,590,47.6481,-122.406
387000,3,1.5,1340,6500,1340,0,47.7168,-122.192
347500,4,2.75,2290,7000,2290,0,47.4442,-122.129
385000,3,2,1860,7400,930,930,47.4598,-122.352
265000,3,1,1080,4930,1080,0,47.5209,-122.374
406000,3,1,960,5264,960,0,47.6805,-122.301
134000,2,1.5,980,5000,980,0,47.7076,-121.359
415000,3,1,1500,3399,1300,200,47.6838,-122.352
375000,3,1.75,1440,8775,1440,0,47.7231,-122.17
620000,4,2.5,2580,7465,2580,0,47.6319,-122.022
337500,5,2.5,2070,4698,2070,0,47.3539,-122.024
565000,3,2.5,1880,12368,1260,620,47.5901,-122.167
399500,3,1.75,2420,12676,2420,0,47.4943,-121.789
1.065E+06,2,1.75,1890,9466,1890,0,47.6144,-122.211
352500,3,2,1920,33630,1920,0,47.4983,-122.167
259000,3,2,1870,5909,1270,600,47.3665,-122.183
320000,2,1,900,7620,900,0,47.5268,-122.343
733000,3,2.5,2160,9888,2160,0,47.6712,-122.142
381500,2,1,900,2910,900,0,47.6859,-122.322
343000,2,1,1180,9261,940,240,47.5492,-122.274
205500,2,1,900,6400,900,0,47.2113,-121.992
525000,3,2,1600,16530,1600,0,47.5821,-122.016
300000,3,1.75,1500,8352,750,750,47.4883,-122.191
299000,2,1,1070,189486,1070,0,47.7199,-122.085
561000,4,2.5,2570,5250,2570,0,47.5763,-122
450000,3,1,1210,4000,1090,120,47.5934,-122.308
540000,4,2.5,1850,7850,1850,0,47.6914,-122.103
379000,3,2.5,1740,30886,1740,0,47.46,-121.707
230000,3,1,1300,14000,1300,0,47.4213,-122.322
399950,3,2.5,2000,30605,2000,0,47.3442,-122.062
355000,5,2.5,3220,5806,3220,0,47.3714,-122.103
580000,4,2.25,2160,9593,2160,0,47.5883,-122.112
700000,3,2,2130,4299,1680,450,47.5779,-122.294
279900,3,1.75,1580,8151,1100,480,47.3672,-122.312
210000,3,1,1200,7500,1200,0,47.4921,-122.275
1.165E+06,3,3,3790,5001,2810,980,47.6035,-122.285
290300,2,1,860,3874,860,0,47.4836,-122.204
1.59995E+06,5,4.5,5130,43123,5130,0,47.544,-122.126
490000,3,1,1600,6380,1400,200,47.7015,-122.317
606000,4,2.5,2110,13850,2110,0,47.5497,-122.077
359950,3,1,1400,4980,950,450,47.7041,-122.34
677100,3,2,2110,9199,2110,0,47.6496,-122.083
465000,3,2,1430,7125,1430,0,47.6256,-122.059
4.5E+06,5,5.5,6640,40014,6350,290,47.7493,-122.28
500000,3,2,3040,41072,1520,1520,47.3944,-121.972
455000,2,1,980,5000,980,0,47.7518,-122.279
705000,6,2,2570,4240,1970,600,47.6754,-122.307
420000,3,2.5,2060,7020,1460,600,47.7575,-122.364
169575,3,1,1300,8284,1300,0,47.3327,-122.306
250000,3,1,1300,8284,1300,0,47.3327,-122.306
530000,3,2.25,1680,7262,1180,500,47.713,-122.225
590000,5,3.25,4020,40341,2170,1850,47.4952,-122.068
257500,3,1.75,1530,14087,1070,460,47.3146,-122.043
415000,3,1,1170,6700,1170,0,47.7122,-122.29
536000,3,1.75,1580,3764,1280,300,47.672,-122.397
246500,3,1.5,1270,11600,1270,0,47.4075,-122.196
395000,3,1.75,1480,7700,1480,0,47.7225,-122.202
739000,3,2.25,2220,10530,1700,520,47.6383,-122.098
1.272E+06,4,2.75,3200,13729,3200,0,47.6402,-122.171
190000,3,1,910,10575,910,0,47.2741,-122.301
305000,3,1.5,1480,9086,1480,0,47.4717,-122.323
925000,4,4.25,3770,13058,3770,0,47.7517,-122.225
895000,4,3,3500,13444,2360,1140,47.5468,-122.231
656000,3,1.75,1480,7475,1480,0,47.6732,-122.272
560000,4,1,1660,4690,1260,400,47.6829,-122.378
610000,5,2.25,2520,11700,2520,0,47.6322,-122.053
645000,4,2.5,2850,37522,2850,0,47.5852,-121.992
259000,3,2.5,2153,4400,2153,0,47.2872,-122.283
980000,4,2.5,3780,10962,3780,0,47.6533,-122.183
872000,4,4,3770,9750,1940,1830,47.7159,-122.367
1E+06,6,2.75,3600,9675,1940,1660,47.5726,-122.213
900000,3,2.75,2980,12600,1590,1390,47.674,-122.196
475000,4,1.5,2320,5534,1540,780,47.6944,-122.355
350000,5,2.75,2980,13482,1730,1250,47.3774,-122.16
840000,4,1.75,2930,11562,1670,1260,47.6765,-122.404
500000,4,2.5,2040,8400,1420,620,47.5512,-122.17
202500,3,1.5,1510,9898,1110,400,47.4303,-122.334
523000,4,2.5,2660,65340,2660,0,47.4969,-122.06
225000,3,2.5,1740,10050,1740,0,47.2671,-122.236
418200,3,2.25,2240,9542,1190,1050,47.3995,-122.318
356500,4,1.75,1570,9670,1170,400,47.7432,-122.248
670000,4,3,2500,5000,1460,1040,47.6895,-122.331
456150,3,2.25,1750,12408,1150,600,47.7509,-122.3
471000,4,2.5,3030,9687,2020,1010,47.485,-121.799
558000,3,2.5,1680,934,1680,0,47.5891,-122.387
1.38E+06,6,4.5,5740,10312,3610,2130,47.5533,-122.11
161500,3,1,1220,6000,1220,0,47.2811,-122.214
311000,3,1,1310,8370,1310,0,47.7284,-122.241
470000,6,1.75,2490,8732,2490,0,47.7252,-122.187
569000,3,3.25,2220,8227,1770,450,47.5665,-122.316
689000,4,2.5,2240,7350,2240,0,47.5652,-122.013
271900,3,1.75,1890,11875,1230,660,47.4472,-121.774
278000,4,2.5,1850,6037,1850,0,47.359,-122.191
820000,2,2.5,2210,4440,1440,770,47.6305,-122.3
399500,3,1.75,1410,7700,1410,0,47.5375,-122.176
462000,3,2.75,1890,2614,1890,0,47.6102,-122.114
347500,3,1,1830,12036,1550,280,47.3126,-122.043
562100,2,0.75,1440,3700,1200,240,47.6707,-122.364
230000,2,1,950,7560,950,0,47.4499,-122.176
687000,4,2.5,2370,10083,2370,0,47.6715,-122.166
725786,4,2.5,3070,5762,3070,0,47.5847,-122.08
315500,3,1,1300,12600,1300,0,47.7422,-122.1
312000,4,2,1300,7054,1300,0,47.5071,-122.369
343000,3,3.25,1210,1173,1000,210,47.7114,-122.356
385195,1,1,710,6000,710,0,47.5756,-122.316
415000,4,2.25,2240,12650,1730,510,47.4777,-122.142
461000,3,1.75,3600,8666,2400,1200,47.6893,-122.167
369990,4,2.5,1960,7133,1960,0,47.4941,-122.19
349950,4,2.5,1820,3134,1820,0,47.7351,-121.985
285750,3,2.25,1960,17126,1400,560,47.4436,-122.21
542500,4,2.25,1750,10160,1320,430,47.5909,-122.158
830000,5,3.5,3700,5400,2890,810,47.7085,-122.117
705000,4,2.5,2910,20946,2350,560,47.7085,-122.24
615000,2,1,1270,5000,1090,180,47.6828,-122.393
184500,2,1,720,5880,720,0,47.5056,-122.27
412000,2,1,1040,5120,1040,0,47.6048,-122.312
250000,3,1.5,2210,11111,2210,0,47.492,-122.309
580000,5,2,2060,6000,2060,0,47.6685,-122.305
220000,2,1,780,6000,780,0,47.4759,-122.208
675000,4,2.75,2240,8937,1460,780,47.6495,-122.194
373500,2,1,800,3330,800,0,47.6566,-122.358
662700,2,1.5,2440,6900,1590,850,47.5568,-122.271
239950,5,1,1460,6032,1460,0,47.487,-122.282
383000,3,1,1150,10196,1150,0,47.6788,-122.162
485000,3,2.75,2650,12350,1470,1180,47.7669,-122.268
610000,4,2.75,2600,36583,1580,1020,47.593,-122.054
545000,6,1.75,1820,6250,1130,690,47.579,-122.39
780000,2,2.5,2560,2500,1690,870,47.6233,-122.3
305000,3,2.5,1714,3240,1714,0,47.4288,-122.19
405000,3,1,1330,15678,900,430,47.6355,-122.037
1.11E+06,5,3.5,7350,12231,4750,2600,47.5373,-121.865
273000,3,1.75,2050,9045,2050,0,47.4572,-122.18
326500,3,1,1810,12375,1810,0,47.7427,-122.172
365000,3,1.75,1380,9134,880,500,47.5087,-122.193
1.00075E+06,3,2.75,3070,10739,2440,630,47.6444,-122.191
422500,2,1,800,4046,800,0,47.6895,-122.382
354450,4,2.75,2140,9920,2140,0,47.3529,-122.274
320000,3,1,1330,9540,1330,0,47.758,-122.075
223000,3,1,1030,9120,1030,0,47.3607,-122.291
410000,3,2.5,1740,4948,1740,0,47.6966,-122.025
438000,3,1,1200,4000,1200,0,47.5881,-122.299
390000,3,3,1490,2944,960,530,47.6506,-122.384
298500,4,2.5,1890,5954,1890,0,47.3293,-122.194
749999,5,2.25,3060,13630,3060,0,47.5585,-122.117
779000,6,2.5,3250,12000,1800,1450,47.6935,-122.28
570000,3,2.75,2730,11936,1530,1200,47.6987,-122.231
385000,3,1,810,4600,810,0,47.5712,-122.316
649000,4,2,2240,11040,1120,1120,47.693,-122.168
283000,3,1,1740,5247,1270,470,47.5049,-122.329
699900,4,2.25,2380,16236,1540,840,47.6126,-122.12
278500,4,1,1540,8400,770,770,47.4278,-122.152
700000,4,1.75,2340,9100,1610,730,47.6401,-122.108
535000,4,2.75,2710,45963,2710,0,47.4745,-121.724
234500,3,1.75,1310,18400,870,440,47.5035,-122.302
374150,3,1.75,1390,9585,1390,0,47.752,-122.35
397000,4,2.5,2201,9542,2201,0,47.4002,-122.317
613000,3,2.25,1960,10385,1960,0,47.5736,-122.109
1.15E+06,3,2.5,2850,10474,1730,1120,47.6218,-122.209
595000,4,1.75,1880,4080,940,940,47.6754,-122.327
340000,5,2.75,2440,6858,2440,0,47.3655,-122.174
388000,4,2.5,2560,5800,2560,0,47.3474,-122.025
404000,3,1.75,1410,15210,1410,0,47.4181,-122.339
810000,3,2,2870,6360,1790,1080,47.6813,-122.275
405000,4,2.5,2620,9359,2620,0,47.438,-122.152
726000,5,3,2970,10335,2970,0,47.598,-122.019
266000,3,2.5,1780,7214,1400,380,47.3667,-122.182
722500,5,2.25,3700,7207,1850,1850,47.7736,-122.371
352000,4,2.5,1252,25002,992,260,47.3216,-122.291
265000,4,1.5,1240,8158,1110,130,47.3716,-122.31
856000,3,2.5,2160,3920,2160,0,47.5762,-122.415
346950,3,2.5,2040,4348,2040,0,47.3517,-121.999
866059,5,3.5,3130,4797,2570,560,47.5664,-122.129
410000,3,2.5,2350,4456,2350,0,47.5314,-121.854
370000,3,1.75,1570,16817,1570,0,47.4716,-121.756
230000,3,1,1530,389126,1530,0,47.1776,-122.011
400000,2,2,1520,5010,1520,0,47.6948,-122.364
172000,3,1,1350,9680,820,530,47.3274,-122.346
615000,3,1.75,1950,8480,1250,700,47.5893,-122.15
860000,4,3.5,3950,9600,3950,0,47.5945,-121.981
555000,3,1.75,2040,6000,1120,920,47.5688,-122.397
579000,3,2.5,1990,4040,1390,600,47.6867,-122.354
385000,3,1.75,1300,7030,1300,0,47.721,-122.179
420000,4,2.25,2030,12000,2030,0,47.7699,-122.168
645000,3,1.75,2340,6750,1620,720,47.6956,-122.335
549950,3,2.5,2160,6288,2160,0,47.7655,-122.35
678000,3,2.75,2770,10000,1640,1130,47.7011,-122.206
199000,4,2,2030,8120,2030,0,47.4994,-122.261
604000,3,1,1440,13824,1440,0,47.5872,-122.241
268000,5,1.75,1730,10368,1010,720,47.5008,-122.162
960000,5,3.5,4510,16305,2820,1690,47.6346,-122.011
509250,3,2.5,2100,7600,1450,650,47.6968,-122.127
416000,3,2.5,1800,5372,1800,0,47.7188,-122.177
190000,3,1,1090,8520,1090,0,47.3364,-122.307
212000,3,1.5,1010,10000,1010,0,47.2881,-122.294
325900,3,2.5,2040,9765,2040,0,47.309,-122.349
560000,3,3.5,2270,4088,1880,390,47.5356,-122.384
275000,3,2.5,1730,5799,1730,0,47.3499,-122.177
665000,4,2.5,2480,15411,2480,0,47.5379,-122.16
1.505E+06,4,3.5,3480,7232,2580,900,47.5859,-122.291
375000,4,2,1720,2410,970,750,47.5252,-122.361
359950,3,1.75,1570,6975,1040,530,47.5137,-122.37
340000,4,2.75,3527,7200,3527,0,47.3823,-122.3
401000,2,1,840,8100,840,0,47.7019,-122.366
669000,2,1.75,1950,10766,1160,790,47.4504,-122.377
638500,4,2.5,1980,6568,1980,0,47.704,-122.101
545000,2,1.5,1620,3760,1170,450,47.6012,-122.291
524000,4,1,1980,7015,1260,720,47.7204,-122.18
1.61E+06,5,3.75,3530,13260,3530,0,47.5761,-122.205
280000,2,1,1260,4800,1100,160,47.5196,-122.376
828000,4,2.5,2120,10841,1500,620,47.556,-122.156
223000,3,1.75,1360,10573,1360,0,47.2983,-122.374
1.289E+06,4,3.5,3100,2261,2250,850,47.6512,-122.202
750000,2,2,2370,155130,2370,0,47.7388,-121.972
430000,2,1,1460,9207,1210,250,47.7195,-122.287
711000,4,1.75,1980,10800,990,990,47.5768,-122.222
310000,4,2.5,1930,7014,1930,0,47.3921,-122.163
415000,5,1.75,3700,9140,1850,1850,47.5086,-122.258
274900,4,2.5,1970,6600,1970,0,47.3491,-122.168
525000,3,3,2470,36445,2470,0,47.4661,-121.997
179500,3,1,1180,32214,1180,0,47.3313,-122.198
478000,3,1,1280,2580,1280,0,47.6727,-122.32
195000,3,1.75,1380,7350,990,390,47.369,-122.093
385000,4,3,2740,10925,1670,1070,47.4538,-122.125
401000,3,2.75,2020,9505,1260,760,47.7399,-122.197
522000,4,2.5,2835,6598,2835,0,47.3878,-122.034
330000,4,1.75,1520,14417,1520,0,47.526,-121.809
503000,3,2.5,2190,4882,2190,0,47.7641,-122.306
175000,5,1.75,1680,8400,1680,0,47.3035,-122.307
963990,4,3.5,3915,6364,3915,0,47.6844,-122.016
845000,5,2,1720,9972,1720,0,47.6368,-122.218
157500,2,1,670,4500,670,0,47.5271,-122.326
450000,2,3,1790,1709,1400,390,47.5926,-122.296
925000,4,1.75,2440,11793,1420,1020,47.6807,-122.267
600000,2,1,920,5029,920,0,47.6726,-122.265
709000,4,1,1680,4087,1680,0,47.6667,-122.337
1.385E+06,5,3.75,3290,6480,2190,1100,47.653,-122.415
248000,3,2.5,2120,6840,1220,900,47.278,-122.145
245000,3,1,910,6630,910,0,47.6947,-122.346
332000,2,1,1000,4776,1000,0,47.5619,-122.315
459950,3,2.5,2340,4273,2340,0,47.5362,-121.878
425000,3,2,1180,1800,1180,0,47.6168,-122.301
460000,3,2.25,2080,50965,1590,490,47.7506,-122.063
838300,6,2.5,3760,12978,2360,1400,47.6976,-122.381
256000,3,2.5,1480,7200,1480,0,47.3126,-122.023
864000,3,2.75,3060,13554,3060,0,47.5609,-122.106
900000,4,3.5,3070,4440,2030,1040,47.5732,-122.411
145600,3,1,1170,7560,1170,0,47.4514,-122.178
865000,5,3,2900,6730,1830,1070,47.6784,-122.285
250250,3,2.25,2210,8000,2210,0,47.3085,-122.381
162000,4,2,1440,7641,1440,0,47.508,-122.183
450000,4,1.75,1980,7350,1430,550,47.7088,-122.202
675500,4,2.75,2060,21344,1460,600,47.5934,-122.154
697000,3,2.25,2420,5304,1640,780,47.6765,-122.285
1.32405E+06,3,3.25,3440,4080,2560,880,47.6644,-122.28
490000,3,1.75,1600,16510,1600,0,47.6601,-122.135
590000,3,2.25,2210,5742,1460,750,47.6891,-122.318
280000,4,1.75,2250,16000,1450,800,47.3303,-122.351
515000,2,1,1680,6500,1140,540,47.55,-122.388
576000,3,1,1140,5395,1010,130,47.6782,-122.306
375000,3,1.75,1430,10574,1430,0,47.7668,-122.218
478000,3,1,1440,7107,1000,440,47.6968,-122.124
282000,3,1,1670,5200,1030,640,47.3659,-122.092
1.4E+06,4,4.5,3080,10550,1940,1140,47.5806,-122.244
593500,5,3.25,4300,50405,3220,1080,47.4615,-122
724950,4,3.5,3010,174240,3010,0,47.4775,-121.691
306000,3,1.75,1560,7500,1560,0,47.489,-122.18
341000,4,1.75,1920,7665,1500,420,47.4476,-122.128
399950,3,2.5,1400,4400,1400,0,47.553,-122.365
534000,5,2,2280,3600,2280,0,47.6056,-122.305
635000,6,2.5,3880,5700,3880,0,47.6816,-122.038
350000,2,1,1350,3880,950,400,47.6842,-122.344
856000,3,1.5,1480,2700,1480,0,47.623,-122.304
582000,4,3,1670,1189,1427,243,47.6182,-122.302
799000,4,2.5,3400,6742,3400,0,47.7067,-122.129
423700,3,2.5,2070,3986,2070,0,47.5348,-121.877
1.835E+06,4,3.5,4870,39190,4870,0,47.5447,-122.124
322000,3,2,1760,43575,1160,600,47.3565,-121.94
929000,4,3.25,4030,57499,4030,0,47.6617,-122.026
443000,2,1,1130,5413,880,250,47.6971,-122.315
441500,3,1.75,1510,7700,1510,0,47.7283,-122.194
875000,4,3.5,3110,108464,3110,0,47.592,-122.018
3.6E+06,3,3.25,5020,12431,3420,1600,47.5925,-122.287
450000,2,1,740,5100,740,0,47.6787,-122.301
425000,3,2.25,1630,10500,1100,530,47.7176,-122.236
660000,4,1.75,2780,9900,2780,0,47.6348,-122.06
763101,3,1.75,1990,5560,1100,890,47.664,-122.287
499000,4,2.75,2250,14149,2250,0,47.7353,-121.962
521000,3,1.75,1720,37363,1350,370,47.6608,-122.035
302000,2,1,900,423838,900,0,47.228,-122.088
293000,4,2.25,2360,6260,2360,0,47.3882,-122.053
335000,3,2.25,1530,4580,1530,0,47.7342,-121.968
499000,2,1,1450,3090,1450,0,47.6853,-122.356
600000,3,1.75,2040,5000,1780,260,47.6756,-122.299
720000,4,1.75,2620,11041,2620,0,47.5975,-122.174
195000,2,2,1180,2553,1180,0,47.3501,-122.02
249000,3,1,1110,8423,1110,0,47.4718,-122.342
334000,3,2.25,1840,9781,1840,0,47.7347,-121.976
599950,4,1.75,2720,7810,1510,1210,47.6788,-122.283
149900,2,1.75,1090,1950,1090,0,47.3782,-122.319
700000,4,1.75,1730,6500,1250,480,47.6982,-122.282
525000,4,1.5,1170,6240,1170,0,47.5495,-122.232
1.049E+06,4,3.75,4740,126759,4740,0,47.4449,-121.979
402000,3,2.5,1960,8000,1290,670,47.7249,-122.178
450000,3,2,1430,3480,980,450,47.6874,-122.336
520000,3,2.25,2510,43995,2510,0,47.4545,-121.988
205000,3,1.75,1420,6980,820,600,47.2873,-122.367
635000,3,2.25,2680,175982,2680,0,47.4487,-122.033
210500,3,1,1220,9600,1220,0,47.2622,-122.282
406650,2,1,1070,6100,1070,0,47.5698,-122.377
350000,3,1.75,1580,19998,1580,0,47.3299,-122.046
425000,4,1.75,1820,6000,930,890,47.6872,-122.296
798000,3,3.5,3590,6402,3590,0,47.6336,-122.063
180000,3,1,1960,9583,1960,0,47.505,-122.171
1.25E+06,5,3.25,3160,13238,3160,0,47.5373,-122.224
435000,4,2,2030,4033,1630,400,47.7056,-122.342
355000,3,1.5,1240,15867,1240,0,47.7167,-122.202
3E+06,5,3.25,5370,14091,3850,1520,47.6499,-122.216
685000,5,2.5,2670,14455,2670,0,47.7565,-122.284
311000,3,1,1640,12060,1640,0,47.4941,-122.151
305000,4,2.25,2130,9600,2130,0,47.4119,-122.211
675000,3,2.5,2550,4954,1850,700,47.5758,-122.287
769000,4,2.75,3630,15405,1850,1780,47.566,-122.225
430000,3,1.5,1690,9708,1690,0,47.5732,-122.136
516250,6,2,2390,8660,2390,0,47.7589,-122.216
760000,3,3.5,2350,10739,1340,1010,47.7288,-122.284
579950,3,3.5,1420,1217,1180,240,47.6827,-122.324
476000,3,2.25,1570,7187,1170,400,47.7604,-122.356
510000,3,1.75,1600,19200,1600,0,47.7202,-122.249
205000,2,1,720,5040,720,0,47.5267,-122.36
240000,3,1,1470,7350,1470,0,47.3616,-122.286
738000,5,3.5,2790,16952,1970,820,47.4384,-122.347
420000,3,1.75,1720,8102,860,860,47.7336,-122.29
455000,3,1.75,1300,9600,1300,0,47.6388,-122.103
765000,4,1,2520,5500,1820,700,47.5785,-122.292
372000,4,1.5,1780,7914,1780,0,47.5142,-122.163
160000,3,1,1200,8360,1200,0,47.5414,-122.281
772000,4,2.5,2990,9643,2990,0,47.6292,-122.024
1.125E+06,5,1.75,1910,5640,1910,0,47.6249,-122.311
479000,3,1,1370,3000,1370,0,47.6619,-122.351
570000,3,2.5,1910,4941,1910,0,47.5989,-122.016
350000,4,1,1170,8147,1170,0,47.7281,-122.289
353000,3,2.5,1250,864,1250,0,47.6978,-122.318
699000,5,2.5,3340,24755,3340,0,47.4565,-122.066
265000,3,2,1380,8536,1380,0,47.4374,-122.335
167000,1,1,780,10235,780,0,47.713,-121.315
500000,4,2.25,2080,8000,1390,690,47.6264,-122.113
700000,3,1,1410,7200,1410,0,47.5924,-122.302
295000,1,1,520,5600,520,0,47.5579,-122.395
1.01E+06,4,3.5,3500,4080,2590,910,47.6834,-122.292
209000,2,1,840,5265,840,0,47.3644,-122.082
276000,3,1.75,2240,9200,1440,800,47.2635,-122.284
380000,4,2.5,2100,5857,2100,0,47.4956,-122.163
315000,3,1.5,1750,12500,1150,600,47.5666,-121.902
685530,4,2.5,3130,60467,3130,0,47.6618,-121.962
254600,3,2,1470,20000,1470,0,47.2973,-122.08
230000,3,2,1440,5600,720,720,47.4947,-122.185
335000,3,3,1430,1249,1430,0,47.6971,-122.34
550000,4,2.5,2170,9600,1460,710,47.6789,-122.116
123300,3,1,1150,8050,1150,0,47.374,-122.296
275436,4,2.75,2170,9658,2170,0,47.3741,-122.189
325000,4,3.5,2630,3435,1640,990,47.4355,-122.272
635000,4,2.5,2490,40608,2490,0,47.6507,-122.004
513000,3,1.75,1710,5000,1110,600,47.6689,-122.37
580000,4,2.5,2130,35752,1490,640,47.5748,-122.031
225000,3,1,940,9272,940,0,47.4353,-122.335
265000,3,1,1400,9460,1060,340,47.5119,-122.321
313000,4,1.75,1630,3000,930,700,47.5961,-122.305
296000,2,1,1370,8400,1370,0,47.7344,-122.336
655500,4,2.75,2380,15800,1680,700,47.5929,-122.133
250750,5,1.75,2140,12058,2140,0,47.3167,-122.214
438000,4,2.5,1970,8545,1970,0,47.4893,-122.138
590000,3,2.75,2550,54014,1980,570,47.7596,-122.117
329500,3,1,1080,5250,1080,0,47.7309,-122.336
1.195E+06,3,2.25,3070,9645,2110,960,47.5522,-122.144
415000,2,1,1470,6000,900,570,47.6527,-122.386
900000,4,2.5,3620,42580,3620,0,47.7204,-122.115
378000,3,1.5,1050,57499,1050,0,47.5602,-121.86
474000,2,1,1050,403365,1050,0,47.2221,-122.059
464000,3,1,1320,3625,1320,0,47.6049,-122.288
310000,3,1,1210,7649,1210,0,47.7693,-122.32
580000,3,1.5,1860,7190,1860,0,47.7716,-122.392
999000,3,2.75,2830,505166,1830,1000,47.3782,-122.514
510000,2,1,810,6480,810,0,47.6493,-122.398
650000,3,1.5,1630,7475,1160,470,47.6725,-122.272
196000,3,1,880,19600,880,0,47.2707,-122.34
220000,4,1.75,1660,11664,1010,650,47.4943,-122.331
855000,3,2.25,3440,10628,3440,0,47.5647,-122.108
483000,3,1.75,2110,10454,1440,670,47.7344,-122.246
400000,3,1,1060,12000,1060,0,47.7703,-122.35
435000,3,2.5,1900,7984,1900,0,47.7433,-122.194
219500,1,1,820,1060,760,60,47.5473,-122.371
2.95E+06,4,3.5,4860,23885,4860,0,47.6172,-122.23
427000,3,2.5,2050,3218,2050,0,47.7612,-122.344
430000,2,1.5,1090,4013,1090,0,47.6652,-122.338
685000,2,1.5,1090,4013,1090,0,47.6652,-122.338
495000,2,1.5,1920,6250,1060,860,47.6497,-122.393
299950,3,2.5,1870,7942,1870,0,47.342,-122.279
390000,4,1.75,2690,46609,2690,0,47.4951,-122.352
385000,3,1.75,2160,5863,1260,900,47.5729,-122.315
740000,4,2.5,3000,10392,3000,0,47.535,-122.049
991700,4,3,2290,2350,1610,680,47.574,-122.415
765000,3,2.75,2250,9600,1830,420,47.6033,-122.287
802000,4,2.25,2130,8734,2130,0,47.5672,-122.161
950000,4,2.75,2500,20000,1700,800,47.5901,-122.198
392000,4,2.5,2300,41167,2300,0,47.3412,-122.108
590000,3,2.5,3360,218235,3360,0,47.6601,-121.946
425000,4,2.5,1920,9000,1920,0,47.5153,-122.37
765000,5,1.75,2440,15143,1740,700,47.4948,-122.37
313500,3,2.25,1440,3488,1440,0,47.7257,-122.162
320000,3,1,1780,6840,1780,0,47.727,-122.3
604000,4,1.75,1490,4485,1350,140,47.6388,-122.399
570000,3,2,1400,1657,1060,340,47.6196,-122.298
639000,4,2.5,2150,12028,2150,0,47.7224,-122.101
335000,4,2,1910,10200,1910,0,47.4804,-122.133
896000,4,1.75,2660,3520,2080,580,47.6743,-122.308
259500,3,1.75,1650,12349,1650,0,47.442,-122.282
637000,3,2,1980,6000,1380,600,47.6921,-122.283
307450,4,2.75,2690,8874,1370,1320,47.3078,-122.383
535000,3,1.75,1380,3561,860,520,47.6822,-122.399
669500,4,2.25,2500,4046,1520,980,47.6882,-122.382
259000,3,1.75,1590,7148,1590,0,47.4713,-122.344
441000,4,1.5,1100,3300,1100,0,47.6033,-122.295
228800,4,2.5,1470,1612,980,490,47.5275,-122.271
530000,2,2,1680,4950,1680,0,47.7194,-122.022
524000,2,2,1450,2272,750,700,47.633,-122.282
430000,4,2.25,2020,4840,1200,820,47.5576,-122.376
1.325E+06,4,3.25,2470,4760,1890,580,47.6331,-122.31
210000,3,1,1230,12201,1230,0,47.3285,-122.134
449000,4,2.5,1850,5040,1230,620,47.5386,-122.373
945000,2,2.5,2540,7089,2540,0,47.5747,-122.414
200450,3,1,970,9130,970,0,47.4369,-122.272
219950,3,1.5,1070,6601,1070,0,47.3115,-122.209
659500,4,3,2620,18362,1870,750,47.5646,-122.184
746000,4,2.75,2110,8190,2110,0,47.6269,-122.1
540000,3,1.75,2110,7129,1280,830,47.7219,-122.102
485000,5,2,1910,5508,1020,890,47.7074,-122.349
202000,2,1,670,7844,670,0,47.5165,-122.372
2.525E+06,4,5.5,6930,45100,4310,2620,47.5547,-122.144
502000,3,2.75,2010,11200,1360,650,47.7728,-122.253
279000,2,2.75,1770,10534,1210,560,47.2773,-122.276
409500,3,1,1340,4120,1040,300,47.6916,-122.352
453000,3,2,1660,15050,1260,400,47.7203,-122.194
367000,4,1,1820,5500,1820,0,47.5185,-122.363
550000,3,2.5,2510,5400,2510,0,47.5204,-122.206
273500,3,1.5,1560,8314,1560,0,47.4117,-122.209
505000,4,3,2280,7400,1340,940,47.711,-122.306
770000,3,2.5,2650,40705,2650,0,47.668,-122.063
565000,4,2.25,2470,7447,2470,0,47.7514,-122.286
316000,3,0.75,1270,10092,1270,0,47.7567,-122.073
160000,4,1,1520,7298,1520,0,47.3706,-122.31
170000,3,1,1310,9529,1310,0,47.4105,-122.295
235000,3,1,1310,9529,1310,0,47.4105,-122.295
1.799E+06,4,3.5,3930,39098,3930,0,47.6399,-122.158
310000,3,1,990,7050,990,0,47.7274,-122.202
285000,4,1.75,2080,13629,1040,1040,47.4866,-122.232
280000,2,1,960,4920,960,0,47.6946,-122.362
2.298E+06,4,4.25,4070,13860,4070,0,47.59,-122.229
763776,4,2.5,2750,16139,2750,0,47.5843,-122.06
530000,5,2.75,3230,13572,1880,1350,47.4393,-122.347
362000,1,1,890,211576,890,0,47.7216,-121.883
430000,2,1,990,4920,990,0,47.6939,-122.368
456500,3,1,1290,3880,1290,0,47.6879,-122.392
445000,4,2.5,2170,5257,2170,0,47.6999,-122.305
386900,3,1,1330,10500,960,370,47.7204,-122.196
479000,3,1,1340,13750,1340,0,47.5771,-122.151
525000,3,2.5,2200,4544,2200,0,47.5319,-121.867
272000,4,1.75,2520,10890,1260,1260,47.3224,-122.343
517000,4,1,1180,13500,1180,0,47.7165,-122.308
615000,3,1.75,2660,7800,1330,1330,47.6993,-122.378
439000,3,1.75,1250,7030,1250,0,47.6285,-122.118
716000,3,2.5,2270,7866,2270,0,47.5622,-122.022
308000,2,1,1080,6250,1080,0,47.5128,-122.251
800000,3,2.25,1620,4500,1620,0,47.643,-122.361
575000,3,2,940,5000,880,60,47.6771,-122.398
219950,3,1.5,1620,9310,1620,0,47.3665,-122.107
770000,4,2.5,2350,8001,2350,0,47.5478,-122.153
424950,3,1.75,2090,7505,2090,0,47.7326,-122.194
387000,3,2.25,1760,45133,1760,0,47.5124,-121.866
790000,4,1.75,2050,10920,1450,600,47.7431,-122.286
156000,2,1,600,4000,600,0,47.5065,-122.339
580000,2,1,2540,7000,1320,1220,47.5259,-122.261
490000,4,2.25,2090,10869,2090,0,47.6715,-122.164
950000,5,3.25,2700,3650,2070,630,47.5959,-122.291
400000,2,2.5,1410,1281,1090,320,47.5659,-122.37
325000,2,2.5,1170,1638,1170,0,47.7041,-122.351
365000,4,2.5,2540,6688,2540,0,47.3314,-122.18
255000,3,1.75,2190,6000,2190,0,47.3063,-122.223
985000,5,3.5,3890,13261,2870,1020,47.7246,-122.284
595000,4,2.5,2030,10722,1100,930,47.6955,-122.301
427500,3,1,1350,7085,1350,0,47.7318,-122.305
728000,3,1.5,1940,4000,1310,630,47.6205,-122.291
549950,2,1,1260,4000,1000,260,47.6898,-122.384
650000,3,2,2800,10501,1400,1400,47.7055,-122.315
1.125E+06,5,3.25,3080,13394,2230,850,47.6651,-122.19
203000,3,1,840,6500,840,0,47.3637,-122.083
311000,2,1,860,3300,860,0,47.5496,-122.279
387500,6,2,2400,7684,1200,1200,47.7705,-122.269
370000,4,2,1640,7200,1640,0,47.7471,-122.324
228000,2,1,1060,6100,1060,0,47.7317,-122.296
740000,2,1.75,2080,4800,1080,1000,47.6896,-122.362
200000,4,2,2090,6630,1070,1020,47.5077,-122.268
660000,3,1,1240,3500,1240,0,47.6835,-122.347
275000,4,2,2030,8426,2030,0,47.4806,-122.287
708000,2,1,1120,5250,950,170,47.6496,-122.392
280000,3,2.5,1270,9675,1270,0,47.4639,-121.744
325000,4,2.5,2260,5702,2260,0,47.3488,-122.151
495000,3,2.5,1780,47480,1780,0,47.4723,-121.707
691000,2,2,1780,3810,980,800,47.6474,-122.362
2.288E+06,4,2.5,4080,18362,4080,0,47.6344,-122.214
329500,3,2.5,2120,22482,1360,760,47.341,-122.265
348000,3,2.5,2060,7458,2060,0,47.3045,-122.351
425000,2,1,1670,6212,1670,0,47.7152,-122.282
210000,3,1,1080,21043,1080,0,47.5515,-122.357
285000,2,1,1210,4895,710,500,47.5202,-122.373
222000,3,1,990,8840,990,0,47.3074,-122.371
200000,4,2.5,1720,9600,1120,600,47.2917,-122.188
247500,3,2,1530,8749,1530,0,47.2974,-122.372
1.5E+06,4,5.5,6550,217374,5400,1150,47.4302,-122.095
190000,3,1.75,1100,9452,1100,0,47.4864,-122.337
975000,4,2.5,3020,4950,2020,1000,47.6467,-122.304
1.13E+06,4,3,3180,4649,2070,1110,47.6583,-122.273
283200,4,1.75,1830,12540,1130,700,47.3348,-122.324
650000,3,2.5,2540,8073,1880,660,47.7176,-122.36
449500,3,2,1770,6610,960,810,47.7703,-122.343
400000,3,1.75,1470,6682,1470,0,47.7315,-122.226
89950,1,1,570,4080,570,0,47.5098,-122.334
158800,3,1,960,8291,960,0,47.5006,-122.334
870000,4,3,2940,7108,2220,720,47.5437,-122.395
196000,3,1.5,1000,18568,1000,0,47.2976,-122.271
850000,3,1.75,2450,8603,1340,1110,47.6536,-122.414
775000,4,2.5,3310,5101,3310,0,47.6649,-122.08
483500,3,2.5,1670,4308,1670,0,47.5307,-122.047
387000,3,1.5,1620,21929,1620,0,47.767,-121.903
900000,3,3,2990,30869,2990,0,47.7602,-122.278
336000,3,1.5,1240,5000,1240,0,47.5659,-122.36
415000,2,1,670,6000,670,0,47.561,-122.275
380000,0,0,1470,979,1470,0,47.7145,-122.356
350000,3,1.5,1320,4400,1320,0,47.6231,-122.292
1.32E+06,4,5.25,6110,10369,6110,0,47.5285,-122.135
765000,3,1.75,2440,5800,1320,1120,47.6474,-122.412
527000,4,2.5,2900,6736,2900,0,47.4954,-122.152
524000,4,2.75,2310,5000,1480,830,47.5502,-122.268
448000,2,1,1110,5413,890,220,47.6925,-122.32
775000,4,3.25,4100,241322,2500,1600,47.7302,-122.096
176500,3,1,930,9900,930,0,47.3745,-122.231
750000,4,2.25,2420,11120,1620,800,47.4954,-122.366
1.265E+06,4,2.25,2870,6000,1730,1140,47.6362,-122.282
250000,3,1,1480,6750,1480,0,47.505,-122.366
759000,3,2.75,1960,6390,1960,0,47.6032,-122.285
640000,3,2,1470,4640,1470,0,47.6398,-122.393
990000,3,3.25,2460,4182,2100,360,47.6782,-122.311
395000,4,1.75,1960,7945,980,980,47.7326,-122.291
275000,2,1.5,1160,1103,890,270,47.7677,-122.315
390000,3,2.5,1910,4755,1910,0,47.4956,-122.162
752500,5,2.75,2720,4680,1710,1010,47.6612,-122.363
450000,2,1,1020,5000,1020,0,47.6725,-122.396
473000,2,1,900,5100,900,0,47.6804,-122.378
178500,3,1.75,1120,10450,1120,0,47.4418,-121.772
485000,3,2.5,2340,59058,2340,0,47.4052,-122.028
215000,3,1.5,1410,8415,780,630,47.2914,-122.368
589000,4,1.75,1920,4862,1060,860,47.5747,-122.384
325000,4,1.75,1370,9993,1370,0,47.7572,-122.228
580000,3,2.5,1590,1937,1590,0,47.5903,-122.388
181100,4,1.75,1850,7500,1850,0,47.4217,-122.333
345000,3,2,1430,4200,830,600,47.6462,-122.384
781000,3,1.75,1940,8729,1460,480,47.7027,-122.282
402500,4,1,1270,3630,1270,0,47.6135,-122.307
426000,3,1.5,1380,7200,1080,300,47.5292,-122.348
389000,3,2.5,1720,4515,1720,0,47.5426,-121.879
670000,6,3,4050,36171,2620,1430,47.4708,-122.015
1.506E+06,4,3.25,3660,5800,3360,300,47.6283,-122.312
288400,3,2.25,1870,3230,1870,0,47.4915,-122.167
700000,4,2,2230,4635,1510,720,47.682,-122.349
830000,4,3,2020,6000,1220,800,47.6563,-122.401
1.899E+06,2,2.75,3690,32044,3690,0,47.4485,-122.369
350500,2,1,1450,6380,1450,0,47.6924,-122.321
431000,3,1.75,1630,9000,1630,0,47.4521,-122.36
485000,3,2.5,1840,8250,1340,500,47.7767,-122.378
780000,3,1.5,1620,7500,1620,0,47.7014,-122.381
720000,2,1.5,1840,9000,1340,500,47.5281,-122.388
415000,3,1,1360,73616,1360,0,47.7528,-122.119
480000,4,1,2080,5500,1040,1040,47.6838,-122.386
452250,4,2.25,2550,10000,1560,990,47.77,-122.259
316000,3,2.5,2550,8170,2550,0,47.311,-122.345
700000,2,1,1160,17635,1160,0,47.5117,-122.248
285000,4,2,1760,5500,780,980,47.5183,-122.265
575000,3,1.75,1720,4050,860,860,47.6782,-122.314
590000,3,2.25,2300,12430,1580,720,47.435,-122.347
587500,4,1.75,2500,20868,1600,900,47.431,-122.338
364000,4,2.25,1750,10270,1750,0,47.7612,-122.31
490000,3,2.5,1890,10190,1890,0,47.6478,-122.061
410000,3,2.25,1800,36704,1360,440,47.4688,-122.013
520000,3,2.5,2160,4297,2160,0,47.5476,-122.012
389000,3,1,1380,6591,1380,0,47.7164,-122.351
450000,2,1,1180,6000,1180,0,47.6531,-122.373
325000,3,2.5,2550,4240,2550,0,47.3986,-122.169
660000,2,1,1070,5000,1070,0,47.6631,-122.337
850000,3,2.25,2870,8170,2250,620,47.5363,-122.385
285000,3,2.5,1940,9874,1940,0,47.3794,-122.113
395000,2,1,870,3121,870,0,47.6659,-122.369
440000,3,2,1550,2401,1550,0,47.6545,-122.348
249000,3,1.75,1400,5648,1400,0,47.5133,-122.196
635000,3,1.75,1210,4400,1210,0,47.6621,-122.288
515000,3,2.5,3430,48993,3430,0,47.2609,-122.27
1.4E+06,3,3.25,3020,6073,3020,0,47.6332,-122.29
200000,2,1,950,8100,950,0,47.4572,-122.351
1.135E+06,4,2.75,3370,8103,1970,1400,47.5232,-122.383
445000,4,1,1460,4600,780,680,47.566,-122.38
555000,3,1.5,1740,4200,1640,100,47.6782,-122.361
537000,4,2,1720,6413,860,860,47.5734,-122.395
315000,3,1.75,1480,7500,1480,0,47.4629,-122.187
805000,5,2.5,3320,7266,3320,0,47.5862,-122.054
414000,4,2.5,3490,9030,3490,0,47.3198,-122.386
375000,2,1.5,1160,1648,1160,0,47.5916,-122.293
401000,4,1.75,3010,12523,1780,1230,47.707,-122.316
210000,3,1,1030,4583,1030,0,47.4231,-122.329
365000,2,1,980,5110,780,200,47.7002,-122.314
178000,5,1.5,1990,18200,1990,0,47.4938,-122.262
710000,2,1,1790,4000,1040,750,47.6405,-122.301
255000,2,1,810,7980,810,0,47.489,-122.337
528000,5,2.25,2940,38009,1700,1240,47.7653,-122.077
537000,4,4.25,4883,26040,3859,1024,47.263,-122.216
442000,4,1.5,1360,6110,1010,350,47.5755,-122.396
375000,3,1.75,1370,19550,1370,0,47.7002,-121.912
637250,4,2.5,2120,3220,2120,0,47.6662,-122.083
427500,3,1.75,1240,7200,1240,0,47.5142,-122.389
700000,4,2.5,2770,89298,2770,0,47.6624,-122.01
680000,3,1.75,1660,5750,1080,580,47.5843,-122.385
393820,2,2,1170,8251,1170,0,47.6873,-122.291
525000,4,2.75,2470,7200,1350,1120,47.5631,-122.317
505000,2,1.75,1310,3816,1110,200,47.679,-122.368
555565,3,2,1670,11337,1670,0,47.6602,-122.188
650000,3,1.75,1660,10819,1240,420,47.7045,-122.379
632500,5,3.25,3500,7254,2760,740,47.5444,-121.881
269000,3,2.5,1440,3800,1440,0,47.3606,-122.039
405000,4,2.75,2360,7716,1390,970,47.7301,-122.223
845000,3,3.5,3460,15745,3460,0,47.7262,-122.06
234000,3,1,1750,8820,1750,0,47.3608,-122.29
638000,4,1.75,1470,4236,1470,0,47.6692,-122.399
290000,3,1.75,1710,10950,1060,650,47.4678,-121.745
262000,1,0.75,520,12981,520,0,47.2082,-121.995
270000,4,2.5,2350,5835,2350,0,47.3494,-122.153
875000,4,2.25,2380,4876,2240,140,47.6822,-122.4
299000,3,2.25,1920,7840,1920,0,47.3631,-122.276
551000,3,1,1580,6000,1580,0,47.5286,-122.032
350000,3,2.75,3070,5280,2360,710,47.4486,-122.353
1.901E+06,3,2.5,2660,13367,2660,0,47.6501,-122.217
511718,2,1.75,1700,5000,850,850,47.6787,-122.363
965000,4,3.25,5010,49222,3710,1300,47.5489,-122.092
475000,4,2.25,2680,4673,2680,0,47.7539,-122.219
1.062E+06,4,2.75,2720,4000,1840,880,47.6797,-122.359
252000,2,1,940,15450,940,0,47.4408,-122.461
580000,6,2.5,3596,13700,1798,1798,47.4388,-122.339
374950,2,2.25,1240,1172,1000,240,47.5877,-122.316
739000,5,4,4660,9900,2600,2060,47.5135,-122.2
271000,4,1.75,1710,7200,910,800,47.3967,-122.174
230000,2,1,930,7550,930,0,47.4866,-122.303
210000,3,2.25,1430,9150,1070,360,47.3239,-122.35
350000,3,2.75,1650,5700,1650,0,47.4563,-122.348
491500,3,2.25,1560,12000,1110,450,47.7256,-122.166
325000,3,2.5,1870,9825,1250,620,47.4639,-121.744
190000,3,2,1320,7625,1320,0,47.3635,-122.045
658600,4,2,1400,4690,1400,0,47.6826,-122.378
299950,3,1.5,1940,8951,1300,640,47.473,-122.328
464000,5,2,2000,3000,1200,800,47.6028,-122.298
308000,3,1,1640,18144,1640,0,47.5027,-122.33
625000,3,1,1020,7650,1020,0,47.6795,-122.202
240000,3,1.75,1630,9450,1080,550,47.3729,-122.295
530000,4,2.5,2940,35996,2940,0,47.3401,-122.067
1E+06,5,4.5,2120,8944,2120,0,47.5488,-122.197
439000,1,1,790,2400,790,0,47.6178,-122.299
575000,4,1.75,2020,6200,1010,1010,47.7013,-122.35
418000,3,1.75,1530,7238,1530,0,47.7629,-122.315
1.208E+06,4,3.75,3250,10949,2940,310,47.639,-122.219
1.1E+06,4,3.75,2930,3200,2130,800,47.643,-122.359
1.9E+06,3,3.75,3150,8550,3150,0,47.6387,-122.284
580000,3,2.5,2180,40278,2180,0,47.733,-122.09
380000,2,1,1040,7372,840,200,47.5285,-122.378
256000,3,1,880,5375,880,0,47.4858,-122.202
349950,3,1,1400,7066,1400,0,47.7127,-122.325
691500,4,2.5,2600,7200,2600,0,47.6944,-122.274
556000,3,1.75,1590,2500,1190,400,47.6668,-122.299
218000,3,2.25,1610,7084,1280,330,47.3146,-122.384
425000,4,2,1390,4500,1390,0,47.5552,-122.311
935000,3,3.25,3710,38509,3710,0,47.693,-121.868
732000,4,1.75,2360,11300,2360,0,47.5728,-122.163
805500,3,1,1440,10330,1440,0,47.6245,-122.193
507250,3,1.75,1400,5750,1100,300,47.5659,-122.38
800000,4,2.5,4600,67369,4600,0,47.6417,-121.992
600000,3,2.25,2100,8276,2100,0,47.6068,-122.112
627800,4,1.75,2010,12044,2010,0,47.6446,-122.068
660000,2,2.25,2550,6000,1860,690,47.6739,-122.323
153503,2,2.5,1240,3649,1240,0,47.3241,-122.322
456500,3,2.25,2090,9163,1460,630,47.7334,-122.167
1.306E+06,5,2.5,2770,8100,2770,0,47.6341,-122.208
843500,3,2.5,3560,11448,3560,0,47.7126,-122.104
625000,3,1,1240,4080,1240,0,47.667,-122.333
527000,2,1.75,1640,4080,840,800,47.6645,-122.326
1.965E+06,5,3.75,3940,13738,3940,0,47.6203,-122.212
1.003E+06,5,2.5,3150,50094,3150,0,47.6387,-122.177
855000,4,3,2550,5300,1720,830,47.6786,-122.367
725000,4,3.25,3940,27591,3440,500,47.5157,-122.116
315000,1,1,580,7200,580,0,47.5249,-122.373
180000,3,1.75,1330,16000,1330,0,47.28,-122.257
700000,2,1,930,5000,930,0,47.5333,-122.388
476500,3,1,1060,8625,1060,0,47.6615,-122.179
193000,3,1.5,1180,9048,1180,0,47.4327,-122.328
295000,4,2.5,1850,6663,1850,0,47.3618,-122.195
363000,2,1,820,4880,820,0,47.5483,-122.394
875000,4,2.5,3600,21794,3600,0,47.7121,-122.072
257200,3,2,1850,8250,1150,700,47.3066,-122.209
555000,3,2,2240,11250,2240,0,47.6371,-122.119
380000,3,2.25,1860,15559,1860,0,47.1559,-121.646
282000,4,2.75,2390,7330,2390,0,47.3061,-122.359
545000,4,2.5,2040,6034,2040,0,47.6952,-122.323
550000,3,1.5,1900,5000,1640,260,47.6779,-122.294
921500,3,1.5,1900,5000,1640,260,47.6779,-122.294
885000,3,1.5,2200,2880,1440,760,47.6308,-122.312
820000,4,2.25,2280,6660,1960,320,47.6503,-122.368
289000,3,1,1090,7315,1090,0,47.494,-122.165
334000,1,1,670,5750,670,0,47.5624,-122.394
206000,3,1,1050,5233,1050,0,47.3106,-121.999
491950,3,2.25,2090,10733,1440,650,47.6971,-122.281
430000,3,2.5,2030,7770,2030,0,47.5253,-121.93
208000,3,2,1250,7995,1250,0,47.3684,-122.092
245000,4,2.25,2600,6390,1390,1210,47.3174,-122.366
426000,2,1,640,2500,640,0,47.6776,-122.361
400000,3,2.5,2120,3742,2120,0,47.4787,-122.129
553000,3,1,1330,5100,900,430,47.6837,-122.291
296000,2,1,750,4680,750,0,47.6919,-122.371
428000,3,2.5,2230,32660,2230,0,47.3321,-122.105
325000,4,2.5,1890,6156,980,910,47.551,-122.356
294000,2,1,820,6366,820,0,47.7512,-122.34
410000,3,1.75,1880,8424,1380,500,47.5116,-122.161
590000,4,4.25,2360,57514,2360,0,47.2843,-122.294
445000,3,2.25,1850,4050,1850,0,47.5669,-122.017
921000,4,2.5,2310,5362,2010,300,47.6044,-122.284
496000,3,1.5,2520,37616,2520,0,47.4777,-121.763
95000,2,1,800,8550,800,0,47.4075,-122.294
359000,4,1.75,1580,6396,790,790,47.5378,-122.369
452500,3,2.5,2430,88426,1570,860,47.4828,-121.718
555000,4,1.75,2350,6200,1410,940,47.559,-122.397
549900,5,3,3800,42316,3800,0,47.3488,-122.095
569000,5,3,3670,10583,2060,1610,47.7589,-122.277
318500,4,2,1780,7350,900,880,47.4562,-122.158
487028,2,1.5,1295,1093,1105,190,47.6192,-122.299
240000,3,1,1350,7560,950,400,47.3784,-122.303
253000,3,2.25,1440,9806,1440,0,47.3857,-122.212
380000,5,1.75,1320,38125,1120,200,47.3937,-122.323
250000,2,0.75,700,16828,700,0,47.3009,-122.125
368500,2,1.75,2510,19141,2510,0,47.3103,-122.199
340000,3,1,3180,27586,1400,1780,47.1986,-121.967
400000,2,1,910,4000,910,0,47.5427,-122.388
835000,3,2,1570,4625,1570,0,47.68,-122.399
299000,3,2.5,2450,7062,2450,0,47.3061,-122.36
1.675E+06,6,2.25,4910,6600,3580,1330,47.6458,-122.32
265000,3,2,1570,5706,1570,0,47.3156,-122.188
437500,4,2.5,2680,7513,2680,0,47.4956,-122.161
865000,3,1.75,2090,4725,1610,480,47.657,-122.394
626000,3,2,2150,7200,2150,0,47.5709,-122.018
247300,2,2,1140,1118,1040,100,47.596,-122.311
2.075E+06,4,3.5,4230,20377,4230,0,47.5954,-122.206
425000,3,1,1790,6000,1790,0,47.5448,-122.32
905000,5,3.5,3100,10200,1660,1440,47.6134,-122.112
641250,3,2.5,2220,2550,2220,0,47.6963,-122.393
675000,4,2.5,2370,9679,2370,0,47.5631,-122.085
845000,4,2.75,4070,115434,4070,0,47.4843,-121.752
401500,4,1,1790,8400,1260,530,47.7627,-122.353
395000,3,2.5,1610,3755,1610,0,47.6825,-122.097
1.1E+06,5,2.75,2830,18050,1630,1200,47.5773,-122.226
145000,3,1,1010,5490,1010,0,47.4762,-122.293
900000,3,1,1560,3825,1390,170,47.6803,-122.387
374500,3,1.5,1330,8636,1330,0,47.7289,-122.203
850000,4,2.25,2330,10451,2330,0,47.6044,-122.168
490000,3,1,960,5750,960,0,47.5689,-122.393
304000,3,2.5,1710,6773,1710,0,47.2635,-122.312
400000,4,2.25,2230,7200,1300,930,47.7648,-122.33
454000,3,2,1700,10000,1700,0,47.7661,-122.205
160000,2,2,1040,4750,850,190,47.5293,-122.272
542000,3,1.75,1070,8030,1070,0,47.67,-122.155
403500,5,2.5,3600,17300,2410,1190,47.4468,-122.341
418000,4,2.5,2750,8471,2750,0,47.3671,-122.029
406000,4,1.5,1920,6000,1920,0,47.4029,-122.321
242500,3,2.25,1770,10000,1340,430,47.3814,-122.322
425000,4,2.5,2460,5440,2460,0,47.448,-122.121
613000,4,2,1550,4815,1550,0,47.667,-122.336
189000,3,2,1460,11481,1170,290,47.4493,-121.777
700000,4,2.25,2440,9450,2440,0,47.7061,-122.307
750000,3,1,1640,6516,1440,200,47.6693,-122.339
494000,2,1,1290,4650,1290,0,47.6877,-122.325
700000,4,3,3150,7778,3150,0,47.5972,-122.018
705000,2,2.5,2305,5580,2305,0,47.7203,-122.024
356000,2,1.75,1060,16470,1060,0,47.7409,-122.089
625000,3,1.75,2060,12558,1350,710,47.6659,-122.144
144975,2,1,900,7500,900,0,47.4177,-122.319
970000,4,4.5,3890,5906,3060,830,47.5426,-121.995
415000,3,1.75,1910,12596,1340,570,47.7399,-122.099
485000,4,3,2340,7048,1340,1000,47.7306,-122.227
799950,3,3,2900,11769,2900,0,47.6993,-122.118
783350,4,2.5,3290,35001,3290,0,47.7231,-122.038
430000,1,1,630,1362,630,0,47.6342,-122.342
2.54475E+06,5,4.75,5410,13431,5050,360,47.6306,-122.288
975000,4,2.5,4270,43386,2680,1590,47.6915,-122.053
950000,3,1.5,1700,8050,1130,570,47.6304,-122.218
350000,2,1,1430,8157,1150,280,47.7256,-122.361
637000,4,2.75,2850,7510,2850,0,47.7097,-122.305
895000,3,2,2160,105415,2160,0,47.4806,-122.152
579000,2,2,1760,7200,880,880,47.5658,-122.276
314900,4,1.75,2700,27072,1380,1320,47.2877,-122.293
122000,2,1,860,6000,860,0,47.2109,-121.985
405000,2,1,880,3000,880,0,47.6868,-122.349
553650,2,2.5,1360,1349,1050,310,47.6254,-122.292
369900,2,2.5,1770,1853,1770,0,47.5472,-122.371
225000,3,2,2030,24829,1220,810,47.2718,-122.291
160000,2,1,1180,9350,1180,0,47.4889,-122.259
449500,4,2,2430,199940,1310,1120,47.4116,-122.029
650000,3,1,1300,8266,1300,0,47.6337,-122.199
542126,4,2.5,2360,43088,2360,0,47.7661,-122.071
309950,3,1.5,1200,15606,1200,0,47.4752,-121.755
115000,2,1,1000,16524,1000,0,47.2841,-122.255
221700,2,1.5,1556,20000,1556,0,47.3891,-122.282
726000,3,2.5,1890,3880,1460,430,47.6642,-122.362
515000,3,1.75,1810,5733,1010,800,47.5709,-122.388
756000,4,2.5,2730,10753,2730,0,47.5414,-122.133
1.57E+06,4,3.75,3070,5850,2400,670,47.633,-122.283
442000,4,2.25,2080,12007,1220,860,47.6259,-122.051
260000,4,2,1620,7992,1620,0,47.395,-122.176
390000,2,1.75,1150,2723,770,380,47.6357,-122.322
459500,2,1,1250,3825,850,400,47.6805,-122.38
330000,3,1.5,1430,8000,1430,0,47.772,-122.322
189000,2,1,790,7128,790,0,47.4873,-122.324
280000,3,1,1200,9322,1200,0,47.3749,-122.225
400000,2,1.75,2110,9519,2110,0,47.7504,-122.306
368000,4,2,3160,11193,2410,750,47.4937,-122.184
390000,4,1.75,2700,7875,2700,0,47.454,-122.144
245000,2,1,820,7475,820,0,47.7321,-122.341
375000,4,2.5,1800,8432,1200,600,47.7463,-122.336
465000,5,1.5,1750,12491,1390,360,47.6995,-122.174
445000,3,2,1540,67953,1540,0,47.5018,-122.126
250000,3,1,1130,7800,1130,0,47.5239,-122.288
475500,3,1,1500,9416,1500,0,47.7135,-122.332
672324,2,1.75,1600,5795,1600,0,47.6709,-122.276
420000,3,2,1200,5029,880,320,47.6936,-122.294
515000,3,2,1690,5100,1690,0,47.6801,-122.38
732350,4,2.5,2270,7665,2270,0,47.6612,-122.148
297500,4,2.5,1910,5000,1910,0,47.3608,-122.036
475000,3,1.5,1640,2720,1640,0,47.6869,-122.317
414000,4,2.5,2120,6497,2120,0,47.7241,-121.957
357250,3,1.5,1400,8840,1400,0,47.7273,-122.309
289950,2,1,760,6000,760,0,47.7168,-122.34
550000,3,1,1070,3713,1070,0,47.5683,-122.285
446000,3,1.75,1460,9998,960,500,47.7434,-122.242
279000,3,1.5,1280,16738,1280,0,47.3895,-122.023
370000,3,2.25,1650,4859,1650,0,47.7729,-122.172
216000,3,2,1260,4125,1260,0,47.4401,-122.279
1.1E+06,3,2.5,2200,20000,1400,800,47.5809,-122.191
1.2806E+06,4,2.5,3560,15450,2060,1500,47.5657,-122.23
355000,2,1.5,1140,2500,630,510,47.5707,-122.359
699000,4,2.5,2550,7312,2550,0,47.6441,-122.113
412000,3,2.5,1553,1991,1553,0,47.7049,-122.34
276000,2,1,1140,7200,1140,0,47.5265,-121.823
100000,2,1,790,6426,790,0,47.4933,-122.245
955500,4,1.75,2130,5080,2130,0,47.6427,-122.363
199000,3,1,1390,21262,1390,0,47.4454,-122.185
762000,4,3.5,4000,15253,4000,0,47.5433,-121.887
425000,4,2,1520,7983,1520,0,47.7357,-122.193
546000,2,1,1657,5031,1657,0,47.5699,-122.389
419600,3,1.75,1680,8460,1180,500,47.7554,-122.353
735000,4,2.25,2270,5102,1340,930,47.6528,-122.408
1.23457E+06,2,2.5,2470,609,1910,560,47.6182,-122.312
445000,2,2,1240,2500,1240,0,47.6793,-122.395
665000,3,2,1740,41275,1740,0,47.4914,-121.763
1.29E+06,5,3.5,4090,290980,2920,1170,47.7161,-122.219
508500,4,2.75,2520,12500,1720,800,47.6225,-122.064
345950,5,1,1340,11198,1340,0,47.736,-122.295
207500,3,1,1640,9750,1640,0,47.3256,-122.141
1.075E+06,4,2.5,3000,10920,1550,1450,47.5347,-122.227
640000,3,1,1210,3720,1210,0,47.6317,-122.301
329500,3,1,1810,13068,1360,450,47.4482,-122.462
460000,4,2.75,2200,9676,1500,700,47.7713,-122.259
1.23E+06,3,1.75,2200,14630,2200,0,47.6074,-122.213
805000,5,3,2350,6480,1650,700,47.558,-122.266
200000,3,1.5,1090,10454,1090,0,47.3425,-122.082
749700,3,1.75,2280,77972,1460,820,47.4804,-122.151
288000,0,1.5,1430,1650,1430,0,47.7222,-122.29
535000,2,1,1520,3360,830,690,47.6815,-122.382
330000,3,2.25,1620,7150,1280,340,47.5048,-122.241
479200,3,2,1510,3750,1510,0,47.5737,-122.383
373000,5,2.5,3001,5710,3001,0,47.3727,-122.177
355000,4,1.5,2020,6000,1010,1010,47.5019,-122.235
275000,3,2,1380,4500,1380,0,47.3661,-122.021
380000,3,1.5,1520,4288,1020,500,47.5284,-122.387
417000,2,1.75,1090,4590,790,300,47.6677,-122.324
1.165E+06,5,3.75,4220,15959,4220,0,47.5869,-121.967
598500,3,2.25,2520,12000,2520,0,47.6381,-122.062
629000,3,2,1760,5000,960,800,47.6408,-122.403
226950,2,1,930,6600,930,0,47.4868,-122.33
1.225E+06,4,2.5,2600,11542,2200,400,47.7076,-122.377
415000,3,2.25,2180,11100,1700,480,47.5162,-122.176
595000,3,2.5,1910,3075,1910,0,47.5491,-122.005
209950,3,1.75,1100,5525,1100,0,47.3625,-122.084
568000,3,1.75,1760,235224,1760,0,47.6735,-122.041
119900,2,1,700,3180,480,220,47.4976,-122.262
207000,3,1,1080,10200,1080,0,47.3215,-122.351
195000,3,1,1070,22489,1070,0,47.3278,-122.262
324950,3,1.5,1460,8710,1460,0,47.4561,-122.357
210000,1,1,1050,7583,1050,0,47.7294,-122.341
1.078E+06,4,2.75,3160,42733,3160,0,47.6367,-121.958
325088,4,1,1400,6739,1000,400,47.5402,-122.298
790000,4,3,3120,157875,3120,0,47.444,-122.187
150000,2,1,720,212137,720,0,47.422,-122.066
790000,3,3,2840,206910,2840,0,47.469,-122.063
255000,2,1,1220,2500,770,450,47.5727,-122.372
697000,4,3,2820,2850,1860,960,47.6813,-122.367
457500,2,1,840,5000,840,0,47.6803,-122.371
690000,3,2,1610,5100,1610,0,47.6825,-122.307
967000,4,3.25,1860,4356,1860,0,47.6785,-122.351
980000,4,1.75,2260,17711,2260,0,47.5498,-122.214
619420,4,2.75,2450,14803,2450,0,47.5261,-122.162
389000,2,1,850,3276,850,0,47.6742,-122.35
500000,3,1,1800,7200,1020,780,47.5616,-122.275
569000,4,1.75,1230,7890,1090,140,47.5808,-122.189
425000,4,2.25,2060,8540,1540,520,47.734,-122.19
635000,4,2.25,2750,6180,1500,1250,47.5691,-122.284
256500,2,1,1120,9912,1120,0,47.3735,-122.43
695000,4,2.5,3010,11393,3010,0,47.7389,-122.221
535000,4,1.5,1580,5000,1390,190,47.6735,-122.393
454200,4,2.5,2630,5379,2630,0,47.4977,-122.163
418500,2,1,790,5800,790,0,47.6973,-122.36
749950,4,2.75,3110,35235,3110,0,47.7355,-122.095
338500,3,1.75,2130,5489,1370,760,47.4489,-122.456
1.25E+06,4,3.75,4520,9240,3270,1250,47.5897,-122.229
299950,3,2.5,1600,9830,1600,0,47.339,-122.266
325000,4,1.75,1950,12500,1330,620,47.4999,-122.327
434000,4,3,2010,8171,2010,0,47.7688,-122.218
328950,4,1.75,2550,8976,1300,1250,47.4286,-122.179
2.095E+06,5,3.75,5340,10655,3740,1600,47.5795,-122.285
570000,4,2,2000,46902,2000,0,47.5851,-122.072
802000,3,2.25,2170,5001,2170,0,47.6937,-122.338
525000,3,1,1550,6840,1550,0,47.6572,-122.335
700000,6,3,2790,4550,2790,0,47.627,-122.361
350000,3,1.75,1980,273556,1040,940,47.4012,-122.11
277500,2,1.5,1190,1236,1190,0,47.7274,-122.357
1.575E+06,5,2.75,3650,20150,2360,1290,47.6215,-122.224
195000,3,1,1510,4350,1510,0,47.2052,-121.987
222000,3,2,1200,6074,1200,0,47.325,-122.205
865000,5,3,2830,8854,1500,1330,47.5743,-122.209
445000,4,2,1650,6000,1000,650,47.5834,-122.307
495800,4,1.5,1710,4600,1710,0,47.6847,-122.318
548500,3,1,1740,4400,1740,0,47.6059,-122.3
310000,3,1.75,1840,10723,1220,620,47.429,-122.154
205000,3,1.5,1820,8585,1820,0,47.4479,-122.213
470000,5,3.75,3860,6901,3860,0,47.3694,-122.032
430000,3,1.5,1810,349351,1810,0,47.3392,-121.897
310000,2,2,1030,2271,1030,0,47.7263,-122.314
355000,4,1,1410,7693,1410,0,47.7604,-122.331
621500,5,2.5,2140,15950,1370,770,47.4797,-122.358
175000,6,1.5,1930,8400,1030,900,47.4869,-122.34
326000,6,1.5,1930,8400,1030,900,47.4869,-122.34
690000,4,3.5,1930,5400,1930,0,47.5679,-122.409
335000,4,2.5,2210,7214,2210,0,47.3554,-122.298
197000,4,1,1360,11175,1360,0,47.4551,-122.272
312500,3,1.75,1830,7969,930,900,47.4667,-122.214
436000,3,2.25,2120,6710,1420,700,47.7461,-122.324
1.015E+06,4,2.5,2700,4590,2700,0,47.6734,-122.329
805000,4,2.5,3160,35225,2250,910,47.5672,-122.111
652427,4,2.25,2770,13129,2770,0,47.6268,-122.05
1.008E+06,3,2.5,2240,41339,2240,0,47.6483,-122.163
355000,4,2.5,2570,6466,2570,0,47.3324,-122.17
334550,2,1,880,12000,880,0,47.7436,-122.356
557500,3,2.25,1820,9670,1820,0,47.6382,-122.11
277500,4,2.25,1660,7184,1110,550,47.4678,-122.294
300000,4,3,2200,10800,2200,0,47.4476,-122.169
325000,4,1,1640,3844,1460,180,47.7017,-122.354
402500,4,2,1650,3504,760,890,47.5803,-122.294
461000,3,1.75,1420,5170,1420,0,47.6151,-122.145
540000,3,1,1270,3840,1270,0,47.6896,-122.357
385000,3,1,1070,4000,1070,0,47.5529,-122.305
480000,2,1,1060,3040,860,200,47.6725,-122.329
539950,3,2.25,2190,7149,1240,950,47.5243,-122.204
529000,3,2.25,1940,217800,1940,0,47.5636,-121.932
417000,3,2.5,1300,877,1060,240,47.6591,-122.392
405000,3,1.5,1330,12500,1330,0,47.5263,-122.051
299000,3,2.25,1940,9100,1630,310,47.3133,-122.364
299000,3,1.75,2100,15480,2100,0,47.2924,-122.271
372220,3,1,1290,5500,980,310,47.5266,-122.392
494400,2,1.75,1560,1750,780,780,47.6347,-122.355
280000,3,1.75,2630,6500,1330,1300,47.4878,-122.221
277950,3,2.5,2100,6021,2100,0,47.2917,-122.375
770000,3,2.75,2070,54557,2070,0,47.4659,-122.116
760000,4,2.5,2960,28005,2960,0,47.7477,-122.117
230000,2,2,1300,3608,1300,0,47.3623,-122.309
525000,4,2.5,2520,7731,2520,0,47.7709,-122.297
307000,3,1,1150,6000,1150,0,47.4963,-121.787
253779,4,2,2030,9600,1430,600,47.4459,-122.272
405000,3,1.5,1880,7400,1480,400,47.7743,-122.27
360000,2,1,2320,11250,2320,0,47.504,-122.362
521000,2,1,1050,7500,1050,0,47.5577,-122.399
680000,4,2.5,3030,13068,3030,0,47.6313,-122.172
355000,1,0.75,530,33278,530,0,47.6412,-122.079
200000,3,1.5,1090,9600,1090,0,47.3639,-122.109
330000,3,2.25,2220,4060,1330,890,47.5188,-122.265
221000,3,2.25,1430,5999,1430,0,47.3116,-122.358
1.59889E+06,4,4.5,3780,6000,2770,1010,47.5922,-122.388
310000,2,1,1560,4920,780,780,47.7248,-122.325
862000,4,2.25,2220,4200,1310,910,47.6418,-122.394
200000,3,1.5,1140,8340,1140,0,47.4773,-122.28
630000,4,2.5,2540,11100,2540,0,47.6317,-122.124
432250,3,2.25,1440,6232,1440,0,47.5658,-122.018
478000,3,2.25,1570,9500,1070,500,47.6843,-122.185
249000,4,2.25,1860,9576,1400,460,47.3612,-122.284
495000,5,3,2440,4750,1450,990,47.5485,-122.302
630000,4,2.5,2100,8800,1240,860,47.6146,-122.114
550000,4,2.5,2150,27540,2150,0,47.637,-121.969
350000,3,2.5,2440,18674,2440,0,47.3672,-122.126
270000,5,1.5,1930,7480,1930,0,47.4503,-122.157
488250,4,2,1830,9610,1830,0,47.695,-122.176
248000,4,3.5,1850,6519,1130,720,47.3087,-122.354
889000,4,3.5,3210,5000,3210,0,47.5203,-122.393
375000,1,1,1090,5250,980,110,47.6999,-122.391
933000,3,1.5,1870,3300,1870,0,47.6221,-122.325
625000,3,2.25,1920,8412,1460,460,47.5578,-122.132
328000,2,1,700,4350,700,0,47.5577,-122.391
470000,4,2.25,3380,9900,1690,1690,47.4438,-122.34
502500,5,2.5,2430,6168,2430,0,47.5237,-122.199
484000,3,1.75,1950,17400,1210,740,47.7424,-122.091
252500,2,1,900,7500,900,0,47.6481,-121.916
610000,3,2.5,2060,8893,2060,0,47.5615,-122.165
419000,4,2,2180,10447,1280,900,47.7675,-122.279
322500,4,2.25,2140,9377,2140,0,47.2649,-122.218
563000,6,1,1730,2760,1250,480,47.6342,-122.353
464000,4,2.5,3140,12591,3140,0,47.3826,-122.146
870000,4,4.25,3010,4887,1940,1070,47.6933,-122.272
280000,2,1.5,800,1196,800,0,47.6972,-122.341
850000,3,2.5,3300,11570,3300,0,47.5599,-122.121
458950,2,1,1530,4370,1130,400,47.6888,-122.308
122000,2,1,760,5280,760,0,47.483,-122.33
525000,5,3,2450,4591,2450,0,47.6828,-122.388
286300,2,1,1000,31838,1000,0,47.4789,-121.779
218450,2,1,840,7425,840,0,47.4749,-122.339
525000,3,1.5,1380,4290,1080,300,47.674,-122.379
650000,3,1.5,1380,4290,1080,300,47.674,-122.379
356000,4,2,2020,48693,2020,0,47.4646,-121.759
436500,2,1,1260,5000,1040,220,47.6782,-122.397
410000,3,1.75,1440,7112,1180,260,47.7304,-122.227
512500,4,1.75,1540,8311,1540,0,47.7046,-122.293
510000,4,1,1060,7200,880,180,47.5591,-122.268
566000,4,1.75,1900,10297,1900,0,47.5944,-122.155
525000,3,1.75,2870,26500,2870,0,47.4485,-122.355
435000,3,1,1050,5500,930,120,47.5402,-122.38
406500,3,2.75,1840,68479,1340,500,47.6802,-121.908
550000,5,2.75,3000,9473,1500,1500,47.6567,-122.13
251000,3,2,1200,10212,1200,0,47.206,-121.998
830000,3,1.5,1840,10125,1220,620,47.5607,-122.217
803000,4,2.5,2790,7673,2790,0,47.6692,-122.136
206000,3,1,970,9360,970,0,47.2808,-122.225
200000,4,1,1070,7467,1070,0,47.4942,-122.235
219000,2,1,900,5160,900,0,47.525,-122.356
777000,4,4,2680,6000,1380,1300,47.6557,-122.388
593700,3,2.5,2000,22000,2000,0,47.59,-122.081
712500,3,1.5,1660,8797,1660,0,47.5892,-122.202
600000,4,1.5,1770,6014,1240,530,47.5773,-122.393
554663,3,2,1230,6802,1230,0,47.6712,-122.279
267000,3,1,1740,10875,1020,720,47.4682,-122.283
390000,3,2,1710,8910,1710,0,47.7719,-122.338
335000,6,2,2020,7071,1010,1010,47.5329,-122.294
938000,4,2.5,2410,9886,1990,420,47.5351,-122.223
370000,4,2.75,2310,14745,1410,900,47.377,-122.31
335000,5,2.5,2400,4548,2400,0,47.371,-122.127
695000,5,2,3160,3990,1870,1290,47.654,-122.337
387500,3,1,1560,14333,1560,0,47.432,-122.348
245000,3,2.5,1770,6187,1770,0,47.4034,-122.189
308550,3,2,1600,13200,1600,0,47.4656,-121.756
225000,3,1.75,1330,13102,1330,0,47.3172,-122.322
715000,4,2.5,2970,29163,2970,0,47.6717,-122.025
335000,3,1,1020,10200,1020,0,47.7503,-122.348
634000,3,2.5,2490,4904,2490,0,47.5451,-122.014
337500,5,2,1700,7314,1000,700,47.549,-122.305
440000,1,1,850,6567,850,0,47.327,-122.039
350000,3,1.75,1250,13775,1250,0,47.4981,-121.772
400000,2,1,610,4560,610,0,47.5498,-122.383
1.288E+06,4,3.5,3700,13175,3700,0,47.5471,-122.133
435000,3,1,950,10080,950,0,47.572,-122.139
681000,4,2.5,3860,5130,2930,930,47.5387,-121.879
397000,3,3.5,1360,1275,1240,120,47.5904,-122.315
775000,4,2.5,3890,34513,3890,0,47.7749,-122.048
480000,3,2.25,1680,9090,1130,550,47.6068,-122.13
158000,3,2.5,1520,7200,1520,0,47.3679,-122.182
590000,3,2,2420,208652,2420,0,47.3666,-121.978
772500,5,2.75,3890,9130,3890,0,47.5407,-121.86
464500,5,1.5,2940,13425,1470,1470,47.7632,-122.29
281000,3,1.75,1350,8737,1350,0,47.4378,-122.279
620000,3,2.25,2190,45738,2190,0,47.7108,-122.12
475000,3,2.25,2280,5750,1150,1130,47.5641,-122.393
245000,2,2,1070,4500,910,160,47.4896,-122.204
660000,5,2.25,2540,3750,1510,1030,47.6729,-122.299
527500,4,2.25,2270,8480,1310,960,47.5448,-122.174
135000,2,1,1220,7250,1220,0,47.3585,-121.975
275000,3,1.75,1890,5000,1890,0,47.3357,-122.175
430000,4,2,1990,4740,1080,910,47.6112,-122.303
213500,3,1,1220,6000,1220,0,47.3245,-122.209
535000,3,3,2640,5978,2640,0,47.4759,-121.735
641000,3,1.75,1480,9603,1480,0,47.5915,-122.202
436300,3,2,2320,9420,2320,0,47.5133,-122.196
1.44E+06,4,1.75,2410,6000,2410,0,47.6369,-122.355
830000,4,2.75,2090,13500,2090,0,47.573,-122.225
380000,3,1,920,3532,920,0,47.5539,-122.268
132500,3,0.75,850,8573,600,250,47.503,-122.356
179950,3,1,1130,9907,1130,0,47.4362,-122.286
188200,3,1,1260,7265,1260,0,47.2979,-122.224
659000,4,2,2090,10800,2090,0,47.5759,-122.223
317000,3,2,2020,7260,1180,840,47.5496,-122.311
625000,3,2.25,1970,4564,1470,500,47.6703,-122.41
350000,3,1.75,1820,9545,1230,590,47.7772,-122.296
750000,3,1.5,1840,5000,1340,500,47.6652,-122.362
457000,4,1.75,2100,10358,1280,820,47.7478,-122.338
632500,4,2,1770,5000,1770,0,47.6748,-122.386
223000,3,2,1110,7231,1110,0,47.4036,-122.191
610000,4,2.75,2090,8400,1240,850,47.6872,-122.123
385000,4,1.75,2080,8215,2080,0,47.737,-122.305
367500,3,3.25,1400,1343,1160,240,47.5483,-122.277
385100,3,1,1060,8040,1060,0,47.7121,-122.287
230000,2,1,720,5913,720,0,47.5447,-122.27
286000,3,2.75,1100,750,780,320,47.5601,-122.363
201700,3,1,1010,9576,1010,0,47.2956,-122.272
1.35E+06,4,4.75,5230,89298,5230,0,47.4097,-122.063
525000,4,1.75,2420,7672,1480,940,47.5637,-122.085
361000,3,1.5,1200,7236,1200,0,47.739,-122.194
530000,3,1.5,1950,1963,1950,0,47.6904,-122.397
455000,3,2.25,1870,7403,1870,0,47.7171,-122.32
421000,4,2.25,1310,8400,1310,0,47.7317,-122.181
640000,4,2,1520,6200,1520,0,47.678,-122.269
240000,3,1,1270,12733,1270,0,47.445,-122.276
360000,2,1,840,7414,840,0,47.6771,-122.172
157340,2,1,900,23000,900,0,47.3576,-122.156
1.24E+06,4,3,3010,6139,2560,450,47.6799,-122.268
250000,3,1,1050,6874,1050,0,47.762,-122.355
735000,6,2.75,3360,84506,2040,1320,47.715,-122.121
884900,7,4.75,5370,10800,5370,0,47.538,-122.223
775000,3,3.5,2690,104544,2690,0,47.7717,-122.112
463000,3,1.75,1710,7320,1710,0,47.7512,-122.281
579000,3,2.5,1640,1269,1640,0,47.6197,-122.3
570000,6,3.75,4000,6015,3080,920,47.453,-122.118
1.06E+06,5,4.5,4140,7924,4140,0,47.6102,-121.993
375000,4,2.75,3140,24800,2080,1060,47.3782,-122.161
422000,2,1.75,1320,2609,920,400,47.6878,-122.366
866500,4,3.5,3080,4945,2010,1070,47.5662,-122.379
705000,3,2.5,2500,10359,2500,0,47.6286,-122.051
470000,4,2.5,2520,9684,2520,0,47.4848,-121.801
360000,3,1.25,2350,6200,1320,1030,47.5979,-122.135
795000,4,2.5,2570,13450,1510,1060,47.7429,-122.285
800000,4,2.5,3100,7807,3100,0,47.7151,-122.227
2.4535E+06,4,3.5,4730,13586,4270,460,47.6319,-122.288
277284,3,1.75,1030,4800,930,100,47.566,-122.373
460000,2,1,1020,4002,1020,0,47.5828,-122.395
898888,3,2.5,2080,3729,2080,0,47.6731,-122.199
211000,3,1,1410,47916,1410,0,47.7149,-121.96
222000,2,2,1360,3300,1360,0,47.3489,-122.022
672000,3,2.5,2620,21587,2620,0,47.6384,-121.959
778000,3,2.25,2260,33080,1690,570,47.6386,-122.183
312500,3,1.75,1490,9493,1490,0,47.4514,-122.134
650000,4,2.5,2530,6500,1720,810,47.6737,-122.284
740000,6,2.25,3140,10250,1570,1570,47.6116,-122.169
320000,3,2,1820,17600,1820,0,47.4703,-122.112
455000,4,2.5,1770,13168,1770,0,47.7306,-121.966
2.45E+06,5,4,4430,9000,4430,0,47.6168,-122.216
500000,3,3.25,1490,902,1220,270,47.6357,-122.324
325000,3,1.75,1790,27427,1130,660,47.532,-121.761
416000,3,2.5,1710,1296,1510,200,47.6963,-122.342
495000,4,2.25,2070,20280,2070,0,47.774,-122.134
549000,2,1,1140,5400,1140,0,47.6205,-122.294
589000,5,2,3930,10150,3070,860,47.6317,-122.114
194820,3,1.5,1100,32700,1100,0,47.3186,-122.289
405000,3,2.5,2260,5500,1280,980,47.681,-122.388
625000,3,2.5,2260,5500,1280,980,47.681,-122.388
205000,3,1,1130,7014,1130,0,47.4743,-122.274
345100,3,3.75,1950,8625,1360,590,47.505,-122.258
200000,3,1,960,7500,960,0,47.4966,-122.255
1.905E+06,4,3.5,4210,18564,4210,0,47.6206,-122.225
524500,3,1.5,3430,264844,2230,1200,47.4476,-121.723
598600,4,2.75,3470,212639,2070,1400,47.7066,-121.968
367777,5,3,2140,5937,1280,860,47.5459,-122.27
750000,3,2.75,2520,5401,1360,1160,47.6452,-122.373
575000,5,2.25,3550,7992,3550,0,47.7285,-122.179
84000,2,1,700,20130,700,0,47.4752,-122.271
255000,2,1,740,5000,740,0,47.5298,-122.273
1.74E+06,4,3.75,3300,4545,2600,700,47.6561,-122.274
415000,3,2.25,1640,5880,1240,400,47.5323,-122.351
449900,3,2.5,2780,8225,2780,0,47.3509,-122.323
220000,5,1.5,1830,94960,1830,0,47.4218,-122.218
899000,4,2.5,3540,9349,3540,0,47.7046,-122.107
430000,3,2.5,1440,7320,1440,0,47.7179,-122.316
472500,4,2.5,2960,223462,2960,0,47.3646,-122.211
680000,6,2.5,3180,9375,1590,1590,47.5707,-122.129
1.65E+06,5,4,3310,8400,3310,0,47.6914,-122.214
810000,3,2,2390,8025,2390,0,47.6707,-122.288
605000,3,2.5,2460,138085,2460,0,47.4572,-122.007
522000,3,1.75,1630,15600,1630,0,47.68,-122.165
759000,5,2.75,3490,8230,3490,0,47.5825,-121.97
411000,4,2.75,2500,5257,2500,0,47.5293,-122.287
286950,4,2.5,2080,9846,1240,840,47.3338,-122.268
440000,3,1.5,1290,1286,1290,0,47.6617,-122.349
149000,3,1,1700,8645,1700,0,47.4899,-122.337
284700,3,1,1700,8645,1700,0,47.4899,-122.337
374950,3,2.5,2540,11562,1290,1250,47.7614,-122.229
816000,3,1.5,1180,8545,1180,0,47.624,-122.2
533250,4,1.75,1520,15398,1370,150,47.5265,-122.05
689800,3,2.75,2390,9313,1390,1000,47.7209,-122.331
775000,4,2.75,2740,6200,1820,920,47.7084,-122.277
702000,3,2.5,2190,8528,1760,430,47.6943,-122.209
160000,3,1,1350,8700,1350,0,47.4497,-122.289
255500,3,1,1350,8700,1350,0,47.4497,-122.289
949000,4,2.75,2980,42253,1860,1120,47.6392,-122.163
169500,2,1,790,7450,790,0,47.4743,-122.17
586000,4,2.25,2130,9000,2130,0,47.5716,-122.159
680000,4,2.5,2700,37431,1600,1100,47.7258,-122.117
851500,3,2,3200,18184,2000,1200,47.6034,-122.172
582500,2,1.5,1159,4800,1159,0,47.6592,-122.399
637000,4,3.5,3080,118918,3080,0,47.7721,-121.924
225000,3,1,1000,9295,1000,0,47.484,-122.346
795000,3,3.25,2260,3727,1880,380,47.6422,-122.361
304999,4,2.25,2270,9600,1290,980,47.3261,-122.355
95000,1,0.75,760,5746,760,0,47.3046,-122.215
240000,4,1.75,1420,5382,1040,380,47.4946,-122.187
772000,4,2.5,2500,8680,1250,1250,47.6073,-122.192
245000,2,1.5,1450,6258,1450,0,47.3785,-122.322
430000,5,3,2500,5750,1430,1070,47.551,-122.369
799000,3,1.5,2210,6300,2210,0,47.5892,-122.29
880000,5,2.75,3020,9187,3020,0,47.6806,-122.167
750000,4,2.5,3290,7538,3290,0,47.598,-121.972
2.89E+06,4,4,5780,7173,4130,1650,47.6374,-122.288
532000,3,2.5,1820,4910,1820,0,47.5703,-121.996
525000,4,2.75,2500,10330,1380,1120,47.7743,-122.286
239000,2,1,1210,9375,1210,0,47.3865,-122.322
460000,2,1.5,1090,4000,970,120,47.5798,-122.393
540000,4,2.25,1330,8400,1330,0,47.6078,-122.169
475000,2,1,890,4590,890,0,47.6901,-122.362
445000,3,1.75,1360,4998,1360,0,47.547,-122.302
1.575E+06,5,3.75,4220,9240,3420,800,47.5895,-122.229
549950,4,2.5,3780,6800,3780,0,47.3526,-122.012
294950,4,2,2610,14321,1690,920,47.4672,-122.296
736000,3,2.5,1980,2975,1980,0,47.6294,-122.344
214946,3,1.75,1290,8688,1290,0,47.3655,-122.08
856000,5,3.25,3620,5500,3620,0,47.5442,-121.996
775000,2,2.5,2680,7392,2680,0,47.717,-122.026
205000,3,1.75,1200,8631,1200,0,47.3864,-122.308
429592,2,2.75,1992,10946,1288,704,47.3551,-122.475
414250,4,1.75,1640,13566,1120,520,47.7423,-122.099
399950,4,2.75,1920,4400,960,960,47.5532,-122.365
319990,3,2.25,1840,7326,1370,470,47.3958,-122.168
524000,3,1.5,1310,9471,1310,0,47.6644,-122.148
349950,2,1,1050,6317,1050,0,47.7364,-121.981
889000,4,2.5,2570,4480,1580,990,47.6701,-122.291
300000,3,1,930,5160,930,0,47.5256,-122.357
395000,1,1,730,3000,730,0,47.6741,-122.396
348000,2,2.5,1270,1242,1270,0,47.701,-122.362
830000,2,1,1150,6000,710,440,47.6841,-122.213
173000,2,1,820,10450,820,0,47.4261,-122.199
585000,4,1.75,3000,42200,1500,1500,47.5265,-122.202
576750,3,2,2220,5000,1110,1110,47.5807,-122.394
495000,5,3.25,2500,7620,1250,1250,47.5298,-122.344
216650,3,3.5,1540,1427,1360,180,47.542,-122.322
615000,4,2.75,2750,15450,1800,950,47.7749,-122.283
675000,4,2.5,3130,12463,1620,1510,47.569,-122.127
510000,3,2,1430,9250,990,440,47.6952,-122.096
630000,3,2.5,2680,327135,2680,0,47.3783,-122.003
359950,4,2.5,3010,5701,3010,0,47.3492,-122.152
265000,3,1.5,1530,7500,1530,0,47.3639,-122.055
210000,3,1,1240,4842,1240,0,47.5166,-122.269
367000,3,2.5,2260,93218,2260,0,47.2582,-121.935
1.075E+06,4,2.25,2820,5000,1800,1020,47.6097,-122.287
756000,3,2.5,3560,8297,1650,1910,47.6473,-122.407
203000,3,2.25,1630,9145,1630,0,47.5,-122.347
535000,4,2.5,2880,23994,2880,0,47.2124,-122.005
525000,3,3.25,2200,7440,1710,490,47.5409,-122.268
347500,3,1.75,1620,7500,1220,400,47.4815,-122.162
620000,3,1.75,1480,2185,1480,0,47.6945,-122.17
645000,4,2.5,2250,10696,2250,0,47.5715,-122.128
2.2E+06,4,3,3540,11098,3000,540,47.634,-122.288
280000,3,2,1790,42399,1790,0,47.3143,-122.134
432000,3,2,1400,6380,700,700,47.7015,-122.316
790000,3,1.5,2390,4452,1790,600,47.5826,-122.378
635000,4,1.75,2400,10050,2400,0,47.6339,-122.124
442000,3,1.5,2050,6384,1350,700,47.5325,-122.378
490000,4,3,2640,5267,2640,0,47.5298,-121.88
250000,5,1.75,2320,7700,1290,1030,47.3426,-122.285
1.325E+06,4,2.5,2440,3600,2440,0,47.6298,-122.362
120000,3,1,1260,7500,1260,0,47.4191,-122.33
2.95E+06,5,4.75,6240,47480,4610,1630,47.5317,-122.233
325000,4,2.5,1930,8458,1930,0,47.3645,-122.039
210000,4,1.75,1200,7680,1200,0,47.3138,-122.192
215000,1,1,970,7639,570,400,47.4655,-122.346
387000,3,1.75,1810,10800,1210,600,47.5236,-122.184
408000,3,1,1380,7015,1380,0,47.6987,-122.36
410000,3,1,1470,6500,1470,0,47.473,-122.362
216000,3,1,1010,7920,1010,0,47.5249,-122.37
390000,3,1,1010,7920,1010,0,47.5249,-122.37
357000,3,1.5,1340,11744,1340,0,47.4947,-122.36
215000,3,1,970,7275,970,0,47.4006,-122.188
265000,3,1,1122,6554,1122,0,47.5135,-122.257
589950,3,2.75,1670,1350,1350,320,47.5763,-122.408
440000,3,1.75,2840,16851,1600,1240,47.7458,-122.287
248000,2,1,770,8600,770,0,47.5325,-122.031
730000,3,2.25,2040,130680,2040,0,47.7584,-122.136
425000,4,2.5,3052,12145,3052,0,47.2598,-122.304
680000,3,2.5,2620,14248,1830,790,47.6281,-122.194
341500,5,2.25,3120,10400,3120,0,47.3097,-122.34
395000,2,1,1100,3975,900,200,47.6701,-122.286
1.225E+06,4,2.75,3410,95396,3410,0,47.6547,-122.158
695500,5,2.75,2510,9180,1600,910,47.6389,-122.098
308000,3,1.75,1680,8629,1200,480,47.3662,-122.319
422500,3,2,1960,6450,1000,960,47.3972,-122.029
418000,2,1,1040,6900,1040,0,47.5411,-122.391
385000,5,1.5,1750,9780,1750,0,47.7755,-122.235
876650,3,3.25,2170,12508,1650,520,47.5665,-122.229
450000,3,2.5,1639,2710,1479,160,47.5924,-122.294
418800,4,2.25,2100,9984,1290,810,47.7365,-122.242
330000,2,1,880,1753,880,0,47.6475,-122.397
550000,3,1.75,1940,8376,1290,650,47.5586,-122.173
270000,4,2.5,2490,11650,1390,1100,47.4416,-122.332
978500,3,2.25,2060,7080,1800,260,47.6455,-122.409
975000,4,2.5,2720,10455,2500,220,47.5564,-122.158
455000,3,2.25,2180,6850,1750,430,47.7246,-122.217
1.415E+06,4,3.25,3600,38016,3310,290,47.7124,-122.253
220000,2,1,840,9000,840,0,47.5033,-122.329
490000,3,2,2370,12196,2370,0,47.6734,-122.176
420000,4,2.25,2270,9100,2270,0,47.7242,-122.17
408500,4,2.5,2720,7043,2720,0,47.3315,-122.169
716000,3,1.5,1140,4800,1140,0,47.6368,-122.354
965000,4,2.5,2460,5000,1620,840,47.6282,-122.293
357823,3,1.5,1240,9196,1240,0,47.7562,-122.094
7.0625E+06,5,4.5,10040,37325,7680,2360,47.65,-122.214
425000,3,2.25,1670,9500,1170,500,47.7253,-122.309
711777,4,1.75,2220,6731,1110,1110,47.5691,-122.391
335000,3,1,980,9903,980,0,47.7746,-122.239
825000,4,1.5,1890,6938,1890,0,47.5896,-122.389
210000,2,1,1100,6000,1100,0,47.5275,-122.323
575000,2,1.75,2770,19700,1780,990,47.7581,-122.365
1.208E+06,4,2.75,4250,10925,4250,0,47.5297,-122.14
431500,2,2,1370,4866,1370,0,47.704,-122.012
475000,3,1.5,1480,13457,1480,0,47.5914,-122.136
1.495E+06,4,3.75,3770,4000,2890,880,47.6157,-122.287
540000,6,3,2870,206474,2330,540,47.401,-122.095
775000,3,2.5,3820,35016,3820,0,47.6496,-122.041
635000,3,2.5,1530,2978,1210,320,47.6796,-122.39
1.3E+06,3,2.75,4120,16365,4120,0,47.5265,-122.148
405000,3,2.25,1590,7267,1100,490,47.7457,-122.332
210000,3,1,1520,8600,1040,480,47.5134,-122.335
880000,4,2.5,2350,4675,2150,200,47.6344,-122.305
239000,4,2,1370,8837,1370,0,47.4386,-122.285
515000,3,2.5,1540,6100,770,770,47.5696,-122.378
1.3799E+06,3,3.25,3786,38038,1934,1852,47.3907,-122.448
215000,4,2.25,1500,5393,1500,0,47.3378,-122.262
315000,6,2,1750,17685,1750,0,47.5096,-122.178
442500,3,1.5,1800,8303,1200,600,47.7693,-122.357
311000,2,1.75,1180,55321,1180,0,47.3329,-122.091
425000,2,1,830,6030,830,0,47.6994,-122.347
433500,3,1.75,1540,9450,1040,500,47.6985,-122.348
450000,3,2.25,1610,8296,1610,0,47.7,-122.297
675000,3,2.25,1990,10260,1990,0,47.6801,-122.115
535000,3,2.5,2070,4132,2070,0,47.6036,-122.015
577000,3,1.75,1760,12874,1230,530,47.5906,-122.167
480000,3,1.75,1740,8528,1290,450,47.7097,-122.303
400000,3,1.5,1950,4473,1530,420,47.7094,-122.228
304000,3,1,1280,8184,1280,0,47.7467,-122.319
355000,3,1.75,1460,7203,1460,0,47.5049,-122.189
998000,4,3.25,3770,982998,3770,0,47.414,-122.087
550000,4,1.75,2410,8447,2060,350,47.6499,-122.088
550000,4,1.75,2410,8447,2060,350,47.6499,-122.088
210000,3,1.75,1400,7300,1400,0,47.4999,-122.268
317000,3,2.5,2100,7587,2100,0,47.3072,-122.391
700000,4,3.5,5360,25800,3270,2090,47.6099,-122.054
265000,3,1,1000,9150,1000,0,47.4829,-122.124
700000,4,3.5,3150,6175,3150,0,47.5966,-122.017
1.02E+06,5,3.5,4180,17841,3160,1020,47.5618,-122.037
1.145E+06,4,2.25,2840,20242,2240,600,47.639,-122.216
460000,4,2.5,2110,35091,1290,820,47.467,-122.014
410000,2,1.5,1660,4000,1000,660,47.6832,-122.304
665000,4,3,2160,4400,1320,840,47.6163,-122.293
600000,4,2.5,2420,7744,2420,0,47.534,-122.18
502000,4,1.75,1920,3844,1170,750,47.7041,-122.353
364950,4,2.5,2310,8030,2310,0,47.7433,-121.982
680000,3,2.25,2330,4000,1520,810,47.6732,-122.29
235500,5,2.5,2340,13713,1670,670,47.3307,-122.324
576000,4,2.5,2590,5756,2590,0,47.5356,-121.875
405000,2,3,1410,1240,1140,270,47.5221,-122.39
335000,3,2.75,2850,8039,1540,1310,47.4141,-122.204
122000,2,1,730,6728,730,0,47.4275,-122.324
432000,3,1.75,1470,6250,1070,400,47.7394,-122.288
375000,4,2.25,2330,11400,2330,0,47.4495,-122.148
276000,4,2.25,2460,11250,2460,0,47.3182,-122.212
450000,3,2.25,2080,111513,1680,400,47.7403,-122.112
210000,2,1,990,8140,990,0,47.5828,-122.382
279000,3,2.5,1450,4106,1450,0,47.3655,-122.019
635000,3,1.75,1340,3900,1340,0,47.6711,-122.379
350000,3,2.5,2730,7372,2730,0,47.2831,-122.346
218000,3,1,1140,7560,1140,0,47.4624,-122.185
750000,4,1.5,1950,6300,1650,300,47.6819,-122.271
310597,4,1.75,2000,25700,1150,850,47.32,-122.362
355000,3,1,900,37800,700,200,47.7146,-122.234
735000,5,2.75,3390,5211,3390,0,47.5977,-121.981
155000,1,1,720,6000,720,0,47.5266,-122.316
354000,3,1,940,10368,940,0,47.6608,-122.133
415000,3,1.75,1770,10513,1400,370,47.7726,-122.266
202000,1,1,590,833,590,0,47.6082,-122.299
580000,3,2.5,1980,1873,1470,510,47.6659,-122.369
1.495E+06,4,3.25,3070,10375,2180,890,47.5862,-122.198
790000,4,2.5,3500,7519,3500,0,47.6799,-122.024
499900,3,2.5,2100,5112,2100,0,47.5338,-121.867
525000,4,2.25,2620,98881,1820,800,47.4662,-122.453
810000,4,2.5,2810,10613,2810,0,47.5424,-122.141
425000,4,1.5,2290,8773,1330,960,47.7173,-122.33
241250,3,1.75,1350,7588,1350,0,47.3123,-122.023
318700,4,2.5,2770,19116,1600,1170,47.3386,-122.319
720000,4,1.75,2530,5000,2070,460,47.6624,-122.348
291000,3,1,1280,10500,1280,0,47.566,-121.894
420000,3,1.75,1060,38644,1060,0,47.7442,-122.072
210000,2,1.75,1000,3554,1000,0,47.3811,-122.32
645000,3,3.25,3870,11000,2970,900,47.5545,-122.354
762000,5,2,3370,5000,2140,1230,47.6373,-122.35
247500,4,1.75,2290,7765,2290,0,47.4997,-122.353
282500,3,2.25,1670,7150,1670,0,47.3603,-122.088
395000,3,1.75,1460,22651,1460,0,47.4861,-122.03
295000,3,1.75,1770,8235,1030,740,47.4323,-122.328
235000,2,1,820,5100,820,0,47.5175,-122.205
770000,3,1.75,1900,6334,1450,450,47.6675,-122.276
559950,2,2,1870,4950,1870,0,47.7195,-122.022
639000,4,2,1840,5419,920,920,47.6483,-122.404
314950,3,1,1590,8470,1140,450,47.4473,-122.159
525000,3,1,1640,6180,1640,0,47.5682,-122.284
2.4E+06,3,2.25,3000,11665,3000,0,47.5884,-122.086
820000,3,1.75,2160,6272,1390,770,47.6777,-122.306
1.385E+06,3,3,2490,3600,1790,700,47.6313,-122.369
521450,3,2,1290,5700,1290,0,47.5713,-122.397
760750,3,2.5,3190,49137,3190,0,47.6027,-122.043
759600,4,1,1540,115434,1540,0,47.4163,-122.22
346150,3,2,2140,7200,1480,660,47.5084,-122.185
390000,2,1,980,3800,980,0,47.6903,-122.34
359950,5,2.25,2450,9432,2450,0,47.4519,-122.13
430000,3,2,1360,5120,910,450,47.5587,-122.393
960000,4,3.5,4610,11676,4610,0,47.6011,-121.983
800000,7,6.75,7480,41664,5080,2400,47.4643,-122.368
1.01E+06,3,2.5,2860,5805,2860,0,47.6218,-122.16
290000,3,2,1810,11456,1810,0,47.4648,-121.756
1.35E+06,4,2,2240,10296,2240,0,47.6177,-122.217
777000,3,3.25,3610,59677,2440,1170,47.5464,-122.088
526000,2,1,1450,4500,1450,0,47.6739,-122.396
550000,3,3.5,1450,1091,1200,250,47.6475,-122.359
276000,3,1.5,1820,8750,1200,620,47.4213,-122.322
2.5E+06,5,3.25,5620,12672,4140,1480,47.5786,-122.287
325000,3,1.75,2080,6554,1040,1040,47.5135,-122.257
365000,3,2.5,1780,1754,1780,0,47.548,-122.373
2.15E+06,8,6,4340,9415,4340,0,47.6316,-122.202
825050,4,3.25,2860,3680,1980,880,47.6752,-122.3
690000,3,1.5,2540,9520,1500,1040,47.6834,-122.306
390000,4,1,1140,6250,1140,0,47.5433,-122.375
385000,3,2,1320,1297,1320,0,47.6959,-122.376
619000,3,2.5,2040,7503,2040,0,47.5718,-122.021
494000,4,2.25,1790,42000,1170,620,47.4819,-121.744
412450,3,2,1910,13505,1910,0,47.7114,-122.23
580000,3,1.75,1460,2800,1460,0,47.6779,-122.371
269900,3,1.5,1420,22100,1420,0,47.4193,-122.149
704300,4,1.5,1790,4080,1790,0,47.5749,-122.291
267000,3,2,1390,6005,1390,0,47.2117,-121.99
310000,4,1.75,1880,12150,1280,600,47.3272,-122.363
227064,3,1.5,1570,10824,1570,0,47.54,-122.275
925000,3,2.5,2690,7000,1840,850,47.6784,-122.277
245000,3,1.75,1670,11452,1670,0,47.1913,-122.015
339888,3,1,1040,7490,1040,0,47.7137,-122.213
439000,4,2,1560,7500,1560,0,47.7281,-122.181
400000,2,1,1470,6120,1470,0,47.6914,-122.287
560000,3,2.25,2070,15002,2070,0,47.7635,-122.274
703011,2,1,1370,5922,1130,240,47.6473,-122.406
363000,2,1,1120,4800,770,350,47.5669,-122.372
650000,4,2.75,2640,6240,2640,0,47.5788,-122.059
299950,3,1,1030,9916,1030,0,47.7218,-122.176
228950,3,1,1120,6625,1120,0,47.4879,-122.332
465000,4,1.75,1730,11700,880,850,47.6031,-122.13
725000,3,2.5,2090,9847,2090,0,47.5651,-122.114
212500,3,1,920,14400,920,0,47.2816,-122.269
526000,4,2.25,2970,54450,2970,0,47.4338,-122.146
383000,3,2.5,1720,10031,1720,0,47.7688,-122.238
244000,3,1.75,1460,4692,1460,0,47.472,-122.192
565000,3,1.5,1540,3570,1490,50,47.6692,-122.325
373000,8,3,2850,12714,2850,0,47.4859,-122.205
300000,3,2,1310,9855,1310,0,47.7296,-122.241
405000,5,2.5,2430,4781,2430,0,47.4487,-122.117
979000,3,1.5,1700,14133,1700,0,47.6166,-122.22
324888,4,1.75,2160,28750,2160,0,47.3212,-122.118
445000,3,1.5,860,3200,860,0,47.6791,-122.362
761000,3,3.5,2050,2020,1520,530,47.6235,-122.306
435000,4,2,1650,4745,1130,520,47.7359,-122.18
252000,3,2.25,1570,8410,1180,390,47.1942,-121.99
350000,3,1.75,1660,10150,1660,0,47.7512,-122.342
875000,3,1,1220,8119,1220,0,47.6328,-122.236
940000,3,1,1220,8119,1220,0,47.6328,-122.236
280000,3,2,1780,11342,1780,0,47.4617,-122.327
450000,3,2.5,2180,4226,2180,0,47.7733,-122.226
905000,3,2.5,3520,237402,3520,0,47.2687,-122.056
382450,3,2.5,2220,20531,2220,0,47.2864,-122.264
246700,3,2,1610,13309,1610,0,47.3398,-122.133
220000,3,1.5,1070,9331,1070,0,47.7633,-122.313
555750,3,1,1060,4880,910,150,47.5545,-122.288
262500,3,1.5,1160,8906,1160,0,47.5362,-122.29
515000,2,1,910,4725,910,0,47.676,-122.281
499500,3,2.5,2970,21907,2970,0,47.4741,-122.099
135000,1,1,790,13062,790,0,47.4919,-122.311
462500,2,2,1540,7290,1540,0,47.551,-122.395
937500,4,2.5,3130,21100,2530,600,47.7598,-122.372
458000,3,1.5,1470,9570,1280,190,47.7032,-122.306
845000,4,2.75,3160,7143,2100,1060,47.6513,-122.406
660000,3,2.25,2675,40910,2675,0,47.5916,-122.055
265000,3,2,1340,6783,1340,0,47.3504,-122.177
599999,9,4.5,3830,6988,2450,1380,47.6927,-122.338
280000,3,2.5,1800,8697,1800,0,47.3115,-122.4
1.055E+06,3,3.25,2990,189852,2990,0,47.746,-122.138
875000,4,3,3720,14125,1930,1790,47.5911,-122.177
125000,3,1,920,7276,920,0,47.285,-122.211
634800,4,3,3280,4904,3280,0,47.6802,-122.033
269950,4,1,1440,9600,1440,0,47.3168,-122.264
359950,3,2.25,1940,11612,1100,840,47.5018,-122.23
417000,3,1.75,1590,11454,1590,0,47.5049,-122.186
389000,2,2,1340,4122,1340,0,47.7182,-122.022
1.038E+06,4,2.5,3770,10893,3770,0,47.5646,-122.129
698000,6,2.5,2680,11250,1340,1340,47.6553,-122.19
685000,4,2.5,2820,10125,2820,0,47.7494,-122.304
198500,3,1.75,1520,7137,1520,0,47.4924,-122.311
350000,4,2.5,2560,5428,2560,0,47.3835,-122.095
649950,3,2.5,3310,387684,2160,1150,47.4167,-121.936
441000,3,1.5,1540,7200,1540,0,47.7357,-122.195
462600,3,1.75,1430,11761,1430,0,47.6686,-122.157
365070,4,2.5,2506,6232,2506,0,47.3734,-122.182
550000,4,2,2250,7500,1200,1050,47.5877,-122.157
470000,5,1.75,2740,9600,1370,1370,47.5738,-122.315
340000,3,1.75,1540,10400,1540,0,47.5651,-121.89
910000,4,2.75,4190,38912,2040,2150,47.6472,-122.157
405000,4,1.75,1690,8392,1190,500,47.773,-122.256
661000,4,2.25,1990,4600,1420,570,47.5638,-122.38
635000,4,2.5,2410,7069,2410,0,47.7094,-122.234
282000,2,1,1150,6098,950,200,47.7259,-122.328
235000,4,1.75,1720,10137,1720,0,47.4424,-122.276
277500,3,2,1260,22100,1260,0,47.2772,-122.354
346500,5,2.5,2020,8250,1430,590,47.4432,-122.135
480000,5,2.25,2240,5500,1490,750,47.5305,-122.391
360000,4,2.25,1930,6508,1930,0,47.7458,-121.977
245000,3,2.5,1820,6785,1420,400,47.3201,-122.177
625000,3,3.5,1560,1490,1240,320,47.6248,-122.319
750500,5,3,2170,2440,1450,720,47.6724,-122.317
525000,3,1.75,1600,9579,1180,420,47.7662,-122.159
740000,4,3.5,3760,57063,2950,810,47.6328,-121.964
523000,3,1.5,1240,7735,1240,0,47.601,-122.122
292000,3,1.75,1090,4500,1090,0,47.5157,-122.256
625000,4,2.5,2740,9599,1820,920,47.7728,-122.385
700000,3,2.5,3110,11727,3110,0,47.5445,-121.871
399950,3,2.5,1610,1320,1280,330,47.6,-122.298
545000,4,3.5,1880,1341,1650,230,47.6053,-122.306
339999,4,2,1740,6369,870,870,47.7461,-122.332
1.21E+06,4,2.25,3270,6000,2180,1090,47.6101,-122.286
545000,3,2.5,1990,5149,1990,0,47.5895,-122.019
260000,4,1.75,1960,8400,1960,0,47.3111,-122.379
526000,3,1.75,1680,3420,960,720,47.6854,-122.291
701000,4,3,2910,8540,2910,0,47.5223,-122.156
290000,3,2.25,1500,7482,1210,290,47.4619,-122.187
330600,1,1,580,1799,580,0,47.6829,-122.375
550500,3,1.75,2540,8280,1270,1270,47.7219,-122.358
430000,2,1,950,6426,950,0,47.5653,-122.37
4E+06,4,5.5,7080,16573,5760,1320,47.6151,-122.224
260600,2,1,810,4560,810,0,47.5425,-122.376
825000,5,3,4080,7500,2720,1360,47.6722,-122.349
378950,4,2,1820,8400,1300,520,47.7615,-122.329
435000,4,2.5,2650,9065,2650,0,47.7258,-121.959
631000,3,2.25,1670,1396,1250,420,47.6814,-122.288
415000,3,2.5,2480,8342,2480,0,47.4381,-122.134
222000,3,1.75,1240,7560,1070,170,47.333,-122.3
245000,3,2,1390,8250,1390,0,47.3707,-122.094
720000,3,2.5,2880,10126,2880,0,47.6319,-122.037
215000,3,1,1060,9954,1060,0,47.3801,-122.289
579100,2,1,1070,2754,830,240,47.6755,-122.331
522500,4,1.75,1640,9299,870,770,47.5334,-122.168
489000,3,2,1510,3000,910,600,47.6804,-122.319
240000,3,1,1230,2353,1230,0,47.5177,-122.354
420250,3,2,1510,3657,1510,0,47.7225,-122.029
523000,4,2.5,3180,20870,2120,1060,47.7176,-122.241
628000,4,2,2260,6000,1430,830,47.6876,-122.298
320000,4,2.5,1920,7277,1920,0,47.4058,-122.192
359950,3,2.5,1980,7800,1980,0,47.4492,-122.199
232000,2,1,1200,8063,1200,0,47.4204,-122.324
810000,4,2.25,2020,5600,1210,810,47.6821,-122.267
245000,4,1.5,2010,7561,1890,120,47.311,-122.227
273000,3,2.25,1930,8192,1470,460,47.2624,-122.299
1.191E+06,5,2.5,2710,14989,1720,990,47.6411,-122.207
438000,5,1,1950,6250,1450,500,47.5511,-122.386
400000,3,1.75,2110,19600,2110,0,47.4742,-122.198
340000,3,1,1250,4800,1250,0,47.5517,-122.381
552000,2,2.5,1380,951,1380,0,47.6654,-122.355
790000,3,1.75,2050,4080,2050,0,47.6698,-122.325
360000,3,1.5,1800,22000,1800,0,47.4889,-122.286
235000,3,1,1310,15022,1310,0,47.5008,-122.332
775000,2,1,1010,3600,1010,0,47.6641,-122.357
489200,3,2.75,1850,9600,1850,0,47.7259,-122.226
341000,3,2.25,1750,8900,1750,0,47.4451,-122.136
335000,4,2.5,2154,6050,2154,0,47.3513,-122.174
393500,3,1.75,1230,1441,1010,220,47.5626,-122.382
360000,3,2,1960,8846,980,980,47.5101,-122.246
400800,4,1,1070,5750,870,200,47.564,-122.379
585000,3,1,1450,5378,1190,260,47.6436,-122.405
1.6E+06,4,2.75,3680,5000,2480,1200,47.6599,-122.269
2.8805E+06,4,2.5,5760,32033,4390,1370,47.7288,-122.37
300000,3,1,1220,13000,1220,0,47.7608,-122.353
1.045E+06,4,2.75,2950,4560,1810,1140,47.6525,-122.333
360000,3,1.5,1340,1110,1040,300,47.698,-122.366
665900,4,2.25,2870,5453,2220,650,47.5129,-122.388
470000,4,1,2590,18224,2000,590,47.5318,-122.286
581000,4,1.75,2090,8164,1070,1020,47.6715,-122.155
527000,6,3.5,3000,8401,1500,1500,47.7226,-122.299
423000,4,1.75,1730,7245,880,850,47.5995,-122.144
875000,4,3.5,2850,4416,2040,810,47.6835,-122.342
410000,3,1,1020,6903,1020,0,47.571,-122.392
606000,3,2.5,2200,6005,2200,0,47.7408,-122.169
654000,3,2.5,3240,60840,3240,0,47.5192,-121.764
150000,3,0.75,490,38500,490,0,47.7112,-121.315
373000,3,2.5,2990,6771,1550,1440,47.5237,-122.353
550000,5,2,2450,9488,1240,1210,47.7056,-122.34
512500,3,2.5,1900,7604,1900,0,47.7002,-122.188
360000,4,2.5,2640,7388,2640,0,47.3505,-122.027
369000,3,2,1340,1480,1340,0,47.6904,-122.393
825000,4,2.5,3220,5262,3220,0,47.6878,-122.162
255000,3,2,930,11475,930,0,47.4644,-121.745
1.285E+06,4,2.5,3240,10800,2260,980,47.6709,-122.262
270000,5,2.5,2630,8470,2630,0,47.2863,-122.196
480680,3,2.5,1730,4924,1730,0,47.5672,-122.005
525000,4,1.75,2120,7725,1220,900,47.6003,-122.144
291500,3,1,880,9238,880,0,47.7494,-122.319
305000,4,2,1800,13551,1800,0,47.4721,-122.128
285000,3,1.75,1600,7500,1600,0,47.2831,-122.199
1.875E+06,3,2.5,3280,29111,3280,0,47.6699,-122.416
329500,5,1.75,3290,8000,1790,1500,47.3733,-122.214
1.57E+06,4,2.25,2890,18226,2890,0,47.5169,-122.209
379260,3,2.5,1730,7202,1330,400,47.4099,-122.329
356000,3,2.5,1590,3411,1590,0,47.5303,-121.878
571900,4,1.75,1710,8947,1710,0,47.5947,-122.135
271500,3,1.75,1995,18360,1995,0,47.4129,-122.322
390000,3,1.75,1300,10030,1300,0,47.7359,-122.192
550000,3,2.5,2720,62310,2040,680,47.4168,-122.074
755000,2,2.5,1360,2070,1360,0,47.6423,-122.329
509500,2,2.5,1590,1485,1300,290,47.6375,-122.387
486700,2,1,1200,6278,1080,120,47.7001,-122.351
527500,2,1,1170,3000,1170,0,47.6697,-122.338
475000,5,2.5,2010,3600,1510,500,47.6522,-122.366
268000,3,2.75,1880,1793,1810,70,47.5405,-122.293
562000,3,2,3250,50529,3250,0,47.5849,-122.016
780000,4,2.5,2270,13449,1310,960,47.5416,-122.232
700000,9,3,3680,4400,2830,850,47.6374,-122.324
710000,3,2,1880,3000,1040,840,47.6418,-122.351
445000,3,1,1050,5664,910,140,47.6897,-122.285
729000,3,3.25,2250,60548,2250,0,47.4246,-122.014
384400,3,3.25,1689,1388,1689,0,47.7174,-122.317
815000,6,3,2860,17853,1430,1430,47.546,-122.175
865000,4,2.5,2710,4069,2710,0,47.604,-122.288
514000,3,2,1770,7200,1770,0,47.6642,-122.173
615000,4,2.75,2820,13193,1860,960,47.5579,-122.174
865000,4,3.25,3400,99170,2000,1400,47.7293,-122.099
755000,4,2.5,3110,6930,3110,0,47.7011,-122.112
425000,4,1,1480,8321,1080,400,47.7629,-122.318
375000,2,1,940,9839,940,0,47.5379,-122.386
750000,4,2.5,2680,4548,2680,0,47.7073,-122.114
722000,4,2.75,3190,5408,3190,0,47.5903,-121.988
1.011E+06,3,2.5,1920,4480,1920,0,47.6472,-122.373
725000,3,2.5,2610,7510,2610,0,47.6648,-122.137
170000,3,0.75,1040,42180,1040,0,47.4518,-122.199
845000,4,3.25,2880,35315,2270,610,47.6587,-122.163
271900,3,2,1450,8771,1450,0,47.1947,-121.989
1.3E+06,6,4.5,3902,3880,2782,1120,47.5837,-122.399
261500,4,2.5,2460,7800,1500,960,47.3081,-122.384
619500,3,2.5,2170,5000,2170,0,47.5458,-121.996
435000,5,2.25,1970,15247,1450,520,47.5669,-121.905
210000,3,1,1000,5454,1000,0,47.7339,-122.337
489950,3,2,1580,4010,790,790,47.6769,-122.371
260000,4,1.5,2130,8800,1100,1030,47.383,-122.288
300000,4,1,1370,8499,1370,0,47.736,-122.301
530000,4,2,2150,14161,1330,820,47.3376,-122.323
235000,3,1.75,1370,14030,1370,0,47.2969,-122.163
593500,3,1,1370,4000,1370,0,47.6711,-122.324
562000,3,3,3290,80471,2330,960,47.504,-122.464
585000,3,2,3190,207346,3190,0,47.2737,-122.015
2.4E+06,4,3.25,4140,20734,3300,840,47.6344,-122.215
199500,3,1.75,1690,8901,1690,0,47.3546,-122.176
544500,5,1,1690,3240,1690,0,47.6746,-122.325
394900,3,1,1430,13370,1430,0,47.7317,-122.241
912000,4,3.75,1980,4095,1980,0,47.6901,-122.356
260000,3,2.5,1490,8102,1490,0,47.3712,-122.092
858000,5,3,3620,12778,1900,1720,47.5512,-122.191
1.275E+06,4,2.5,2720,16454,1870,850,47.5489,-122.216
242150,4,1.75,1490,8544,1490,0,47.3894,-122.166
220000,3,1.75,1230,7200,1230,0,47.2881,-122.363
235000,3,2,1900,7980,1340,560,47.305,-122.373
370000,3,1.75,1530,10300,1530,0,47.7767,-122.356
450000,3,1.75,2290,44866,1390,900,47.7398,-122.041
534950,5,1.5,2240,6337,1280,960,47.7046,-122.316
730000,4,2.5,3470,14271,3470,0,47.5423,-121.877
465000,4,2.5,3050,32450,1550,1500,47.3626,-122.209
178000,3,1,1100,5734,1100,0,47.3632,-122.174
215000,3,1,1610,7140,1080,530,47.3943,-122.189
300000,3,2.75,1910,15508,1210,700,47.3128,-122.345
430000,3,2,1510,7066,1230,280,47.7053,-122.303
183000,3,1.5,1280,4366,1280,0,47.335,-122.215
585000,3,2.5,1910,1501,1530,380,47.6441,-122.385
192950,3,1,1170,3330,1170,0,47.3155,-122.182
599000,2,1,1550,7713,1550,0,47.7005,-122.358
326500,3,1,1060,7920,1060,0,47.5649,-122.358
358803,2,1,1040,5765,1040,0,47.7024,-122.346
537000,3,2.5,1550,12920,1550,0,47.6973,-122.194
1.155E+06,3,2.5,2490,24691,1580,910,47.488,-122.364
156000,2,1,920,5889,920,0,47.3012,-122.218
219000,3,1,1250,8276,1250,0,47.2092,-121.997
1.19E+06,3,1.5,2540,2700,1630,910,47.637,-122.361
248000,5,1.75,2190,16788,1380,810,47.3764,-122.176
340000,3,1.75,1340,196020,1340,0,47.2931,-121.992
899100,5,2.5,2410,15300,1400,1010,47.5416,-122.231
346950,3,1.75,1830,10954,1830,0,47.7554,-122.306
330000,3,1,1850,5775,1740,110,47.5446,-122.296
325000,3,1,1410,8250,1410,0,47.7621,-122.36
315000,3,1.75,1460,7884,1460,0,47.4457,-122.128
649950,3,2.5,1500,1375,1200,300,47.6451,-122.375
316000,3,1,1130,7200,1130,0,47.7298,-122.355
386000,2,2.5,1620,3196,1620,0,47.5167,-121.878
535000,2,1.75,2330,7280,1450,880,47.4282,-122.28
600000,3,3,1520,1800,1520,0,47.6822,-122.326
339000,4,2.5,2840,8746,2840,0,47.19,-122.013
167000,3,2,1520,7456,1520,0,47.4745,-122.343
430000,3,1,1740,4800,1740,0,47.5596,-122.27
688000,4,4,4000,9309,4000,0,47.5421,-121.888
834500,3,2.25,2780,6000,1670,1110,47.6442,-122.406
1.075E+06,4,4.25,3500,8750,2140,1360,47.7222,-122.367
250000,3,1,1060,52272,1060,0,47.36,-122.178
402500,3,1,1290,4000,1290,0,47.5462,-122.277
432500,3,2.5,2390,6435,1600,790,47.726,-122.194
485000,5,1.75,2460,14100,1380,1080,47.7452,-122.224
560000,4,2.75,2930,22000,1580,1350,47.3227,-122.384
410000,4,2.25,2200,8292,2200,0,47.7456,-122.315
455000,3,2.5,1870,7344,1470,400,47.7265,-122.206
459500,4,2.5,2060,8968,1190,870,47.7686,-122.317
371000,4,1.75,1610,11305,1610,0,47.727,-122.176
289500,3,2.25,2120,3400,2120,0,47.3364,-122.17
395000,3,3.5,1450,1263,1160,290,47.6508,-122.383
496752,2,1,1980,5000,1090,890,47.586,-122.295
227000,2,1,860,6800,860,0,47.7274,-122.337
330000,3,1.75,1460,9261,1460,0,47.5155,-122.189
480000,5,2,2590,8610,1340,1250,47.6112,-122.126
290000,2,1,1120,217800,1120,0,47.7378,-121.912
281000,3,1,1340,21336,1340,0,47.4023,-122.273
705000,4,1.5,1780,3120,1780,0,47.5589,-122.264
1.4E+06,4,2.5,2920,4000,1910,1010,47.6578,-122.28
485000,4,3.25,2820,6611,1410,1410,47.7473,-122.285
622000,3,2.25,1550,1919,1550,0,47.6729,-122.379
380000,3,2.25,1600,39848,1600,0,47.1991,-122.013
2.125E+06,4,2.75,3190,19513,3190,0,47.6991,-122.235
561500,3,1.75,1960,6380,980,980,47.6975,-122.316
242000,3,1,970,9600,970,0,47.4451,-121.768
348500,3,1.5,1360,10726,1360,0,47.4948,-122.134
370000,3,1.5,1360,10726,1360,0,47.4948,-122.134
752000,6,3.75,3810,6663,3810,0,47.6938,-122.34
230000,3,1.75,1340,8250,1100,240,47.3668,-122.09
715000,3,2.25,1990,4977,1990,0,47.5404,-122.268
240415,3,1.75,1120,10187,1120,0,47.3694,-122.311
562000,4,1.75,2060,4080,1460,600,47.6698,-122.325
360000,3,1.5,1170,4080,1170,0,47.5338,-122.381
659950,3,2.5,1610,1246,1080,530,47.6423,-122.375
458500,3,2,1890,1599,1430,460,47.5438,-122.385
259950,2,2,1070,649,720,350,47.5213,-122.357
366000,3,1.75,1680,6108,1680,0,47.4501,-122.208
978000,4,2.75,2890,7821,2890,0,47.554,-122.189
525000,2,1,1360,6120,1060,300,47.6841,-122.291
926300,3,1.5,1660,4800,1660,0,47.6352,-122.358
750000,2,1,1620,6120,1620,0,47.6731,-122.326
660000,2,1,960,6263,960,0,47.6646,-122.202
305000,4,1.75,1000,7200,1000,0,47.742,-122.324
800000,2,2.5,2395,6143,2395,0,47.7114,-122.029
600000,4,1.75,3050,9440,1800,1250,47.7228,-122.183
435000,2,1,1120,88327,1120,0,47.3205,-121.867
1.135E+06,4,3.25,2960,4296,2190,770,47.6526,-122.372
318000,3,2.25,1250,1017,1250,0,47.7099,-122.333
639000,4,2,1940,5000,980,960,47.6719,-122.369
453000,3,2.5,1750,3900,1750,0,47.6638,-122.129
800000,4,1.75,2150,9148,2150,0,47.5828,-122.197
437000,2,1.75,1500,6800,910,590,47.7004,-122.371
1.15E+06,3,2.75,3230,75889,3230,0,47.3344,-122.37
490000,4,2.5,3000,8645,3000,0,47.7315,-122.224
499950,4,1.75,1520,7700,1520,0,47.7356,-122.191
160134,3,1.5,1190,10116,1190,0,47.385,-122.085
191000,3,1,990,8255,990,0,47.425,-122.331
221000,3,1,1250,7280,1250,0,47.3414,-122.286
352800,4,2,2080,6360,1330,750,47.5392,-122.278
350000,3,2.5,1640,10424,1640,0,47.7345,-121.977
458000,4,1.5,1550,3000,1350,200,47.6604,-122.324
359950,3,1,1290,189486,1290,0,47.3356,-122.157
1.05E+06,3,3,3250,5093,3250,0,47.5123,-122.39
353000,3,1.75,1260,11775,1260,0,47.5501,-122.296
717550,3,3.5,2840,4468,2840,0,47.7069,-122.117
450000,3,2.25,1960,6500,1960,0,47.6642,-122.129
167500,3,1,760,3090,760,0,47.5513,-122.275
550000,3,1.75,2240,78225,2240,0,47.4638,-122.484
939000,4,2.25,2240,9684,2240,0,47.5489,-122.225
700000,3,1.75,1820,15570,1820,0,47.5068,-122.386
480000,4,3.5,3370,435600,3370,0,47.4398,-121.738
501000,3,1,1160,4360,1160,0,47.6718,-122.291
580000,3,2.25,1640,8625,1320,320,47.6772,-122.153
527550,1,0.75,820,59677,820,0,47.5316,-121.764
399000,4,2.5,2800,4687,2800,0,47.3594,-122.04
240000,3,1.75,1780,5000,1080,700,47.5105,-122.36
353000,4,2.75,2200,268329,1410,790,47.3224,-122.122
335000,4,2,1480,3132,740,740,47.55,-122.312
475000,3,3,2010,2554,1860,150,47.5525,-122.269
660000,3,2,2880,5100,2080,800,47.6805,-122.385
551000,3,1,940,1948,940,0,47.6733,-122.383
249950,4,1.75,1620,10530,1620,0,47.3808,-122.211
1.15E+06,4,3.25,4400,262666,4400,0,47.5927,-122.064
575000,3,1.75,1530,6743,1410,120,47.5745,-122.396
1.08889E+06,4,2.75,3460,11350,1780,1680,47.568,-122.153
515000,4,2.5,2890,7306,2890,0,47.5447,-121.883
235000,3,1.5,1980,11214,1980,0,47.4696,-122.298
796000,3,1,1980,3243,1980,0,47.6429,-122.327
450000,2,1.5,1450,2550,820,630,47.6911,-122.348
2.05E+06,4,3,4280,18834,2180,2100,47.5811,-122.4
270000,4,2.5,1810,6509,1810,0,47.3531,-122.143
1.705E+06,3,3,2490,27702,2490,0,47.5596,-122.403
565000,3,1,1610,4108,1610,0,47.5704,-122.376
680000,1,2.5,1820,3008,1090,730,47.6529,-122.339
5.57E+06,5,5.75,9200,35069,6200,3000,47.6289,-122.233
864500,4,2.5,3520,35991,3520,0,47.7437,-122.035
1.15E+06,4,2.25,3740,18000,1870,1870,47.7027,-122.378
335000,3,2.25,2150,30476,2150,0,47.4605,-122.277
911000,4,3.25,3526,15958,3526,0,47.567,-122.033
425000,2,1,1070,6625,830,240,47.5736,-122.393
299950,3,1,1410,81021,1410,0,47.4303,-122.067
864000,4,2.5,3190,49658,3190,0,47.6216,-122.015
425000,2,1,1270,6000,1270,0,47.6482,-122.393
374950,4,1.5,1970,14490,1970,0,47.4612,-122.069
247000,3,2.25,1640,7630,1180,460,47.3739,-122.29
475000,3,1,1600,7161,1600,0,47.5507,-122.261
275000,3,2.5,3020,5868,3020,0,47.3361,-122.175
355000,2,1,1350,368517,1350,0,47.7617,-122.061
285000,4,1.75,1870,22072,1070,800,47.3775,-122.165
1.33875E+06,3,2.75,2730,38869,1940,790,47.4857,-122.361
325000,2,1,1100,17817,620,480,47.7728,-121.9
1.67E+06,5,3.5,4320,40816,4320,0,47.644,-122.185
402000,3,2.5,2700,9994,1350,1350,47.397,-122.321
1.1E+06,3,3,3700,16857,2170,1530,47.6956,-122.392
375000,4,1.75,2190,9225,1250,940,47.7396,-122.256
396000,5,2.75,2840,12253,1420,1420,47.7618,-122.253
320000,4,2.75,2610,9077,1310,1300,47.4612,-122.147
610000,3,2.5,2630,5827,2630,0,47.688,-122.038
249950,3,1.5,1090,7698,1090,0,47.4553,-122.174
675000,4,3.5,3090,100835,3090,0,47.3087,-122.088
448000,2,2,1670,7772,860,810,47.5461,-122.377
819000,3,1,1300,3600,1300,0,47.6345,-122.366
1.25E+06,3,2.5,3670,18505,2530,1140,47.7588,-122.376
225000,4,2.5,1700,6031,1700,0,47.3582,-122.191
790000,2,3,2560,982278,2560,0,47.6955,-121.861
685000,4,2.5,2770,6000,2400,370,47.5536,-122.383
812000,3,3.25,3240,8338,3240,0,47.6321,-122.064
705000,2,2.5,2300,6400,2300,0,47.7196,-122.02
360000,4,3,2483,6870,2483,0,47.3627,-122.199
344000,1,1.5,760,779,760,0,47.6715,-122.382
825000,4,1.5,2040,6900,2040,0,47.6188,-122.285
476500,3,1,1200,6120,950,250,47.6929,-122.287
379500,2,1,960,5096,960,0,47.5314,-122.378
620000,3,1.75,2410,35236,2410,0,47.7651,-122.166
477590,3,3.25,2260,7701,1760,500,47.5053,-122.377
490000,3,1,1910,8190,1010,900,47.697,-122.365
470000,3,1.5,1500,5000,1140,360,47.679,-122.373
500000,3,2.25,1360,1236,1140,220,47.6198,-122.299
370000,3,1,1320,7341,1320,0,47.7367,-122.295
790000,2,1.5,1940,4400,970,970,47.6371,-122.279
725000,4,2.5,2650,18295,2650,0,47.6075,-122.154
840000,4,2.75,3040,2800,2100,940,47.6245,-122.327
390000,3,1,1240,11108,1240,0,47.4465,-122.354
507000,3,2.25,2210,11585,1510,700,47.7574,-122.279
263500,3,1.75,1540,6273,770,770,47.5305,-122.277
369000,3,2.5,1320,1683,1270,50,47.5357,-122.365
500000,3,2.5,3040,5326,3040,0,47.4472,-122.207
570000,2,1,910,4301,910,0,47.6814,-122.399
284000,4,3,2040,7145,1490,550,47.3275,-122.171
415000,2,1,980,4108,980,0,47.687,-122.381
197500,3,1,980,3090,980,0,47.5525,-122.277
925000,4,3.75,4420,9492,3420,1000,47.7211,-122.283
468000,3,2,1570,6300,820,750,47.5565,-122.275
355000,3,1,1600,5001,1080,520,47.7232,-122.289
639000,4,1.75,1830,6000,930,900,47.6536,-122.41
720000,3,2.5,2820,14250,2820,0,47.6396,-122.054
381000,3,1.75,1800,6000,900,900,47.7505,-122.317
1.05E+06,3,4,4380,42769,4380,0,47.7167,-122.109
670000,3,3,2980,3730,2980,0,47.5533,-121.995
400000,3,1,1690,6658,1690,0,47.7099,-122.35
910000,4,3.5,4040,50479,4040,0,47.7196,-122.048
294000,3,1,1250,9427,1250,0,47.7254,-122.175
315001,3,1.75,1500,10230,1500,0,47.4349,-122.168
360000,3,2,1630,10723,1630,0,47.4898,-122.133
520000,3,2,1410,2700,1410,0,47.6029,-122.302
474000,3,1,1140,4560,770,370,47.6889,-122.362
702000,4,2.5,3280,5876,3280,0,47.6802,-122.034
728000,4,3.5,3490,87497,3490,0,47.4028,-122.002
308000,4,2.5,2020,7277,2020,0,47.4318,-122.19
2E+06,5,4,4580,4443,4580,0,47.5682,-122.059
340000,3,2.5,2270,7917,2270,0,47.2643,-122.22
306500,2,1.75,1310,10200,1310,0,47.5231,-121.82
716000,3,2,1420,3600,1420,0,47.6367,-122.364
950000,4,3,2980,44431,2640,340,47.7154,-122.161
673200,5,3,4180,8561,4180,0,47.6833,-122.04
564500,4,2.25,1950,6000,1350,600,47.6909,-122.301
393000,4,1.75,1790,11801,1790,0,47.5172,-122.17
425000,5,1.75,1400,5071,1400,0,47.6499,-121.908
150000,3,1,1320,24684,1320,0,47.4771,-122.322
327000,4,2.25,1620,106722,1200,420,47.3394,-122.091
444900,4,2.5,3120,7448,3120,0,47.3645,-122.126
305000,4,2.5,2100,14773,2100,0,47.3045,-122.391
469000,3,3.25,1370,1194,1370,0,47.6718,-122.388
525000,3,1.75,1520,7875,1520,0,47.5569,-122.176
330000,3,2.5,2410,17424,1630,780,47.3741,-122.218
618000,4,1,1260,4080,1260,0,47.6644,-122.324
295500,4,2.5,2830,7350,1690,1140,47.3088,-122.341
567035,3,2,2064,46173,2064,0,47.4469,-122.455
518000,4,2.25,2640,34870,1770,870,47.4688,-122.009
303000,2,1,1020,9200,1020,0,47.4461,-121.769
300000,4,2.5,2200,8065,2200,0,47.4042,-122.213
413107,3,1.5,1420,7520,1420,0,47.601,-122.134
400000,3,1,1350,3090,1350,0,47.682,-122.348
535000,3,1,1290,6859,1290,0,47.5317,-122.387
555000,4,2,1680,2600,840,840,47.6648,-122.363
312000,3,2.5,2280,6386,2280,0,47.3861,-122.096
785200,3,2.25,1840,3500,1540,300,47.6063,-122.292
749000,4,2,2040,11850,1020,1020,47.6891,-122.208
285000,3,1.5,1490,10367,1010,480,47.4973,-122.347
425000,4,2.5,2440,5088,2440,0,47.5406,-121.889
360000,3,2,1930,15540,1260,670,47.7675,-122.307
260000,3,1,1200,6615,1200,0,47.5168,-122.351
369000,3,2,1550,8509,1150,400,47.5299,-122.344
275000,4,2.5,2180,11132,1620,560,47.3187,-122.367
407000,3,2.25,1430,1448,1430,0,47.6916,-122.341
575000,2,1.75,1230,5418,990,240,47.6839,-122.376
1.236E+06,3,1.5,1670,3852,1670,0,47.6411,-122.371
875000,2,2.5,2720,4913,1700,1020,47.6384,-122.404
320000,4,1.5,2220,6811,1270,950,47.5059,-122.193
810000,3,1.5,1520,9041,1520,0,47.6158,-122.213
274000,3,1.75,1590,7620,1090,500,47.3655,-122.048
239900,4,1.75,1480,9523,1120,360,47.3732,-122.217
450000,4,1.5,1860,7808,1080,780,47.7314,-122.3
263400,4,2,1360,60548,960,400,47.2718,-122.265
265000,3,1,1360,5967,1360,0,47.4973,-122.256
418000,4,3,2360,6250,1460,900,47.512,-122.249
390000,3,2,2360,5737,2360,0,47.7633,-122.262
430000,3,2,1860,7500,930,930,47.5662,-122.364
1.4425E+06,3,2.25,2630,9705,2630,0,47.6485,-122.121
297000,2,1.75,1280,37373,1280,0,47.2631,-122.019
650000,4,2.25,2330,7220,1600,730,47.7764,-122.386
195000,2,1,720,18000,720,0,47.5054,-122.261
554000,3,3.5,3380,108900,2700,680,47.4316,-122.075
550000,3,2,3650,843309,3650,0,47.3627,-122.496
700000,3,1.75,1640,4590,1640,0,47.6846,-122.294
300000,4,1,1730,177657,1730,0,47.5163,-121.829
315000,2,1,1030,8576,1030,0,47.7352,-122.295
603000,3,1,1790,5250,1400,390,47.6627,-122.276
530000,2,1,840,3400,840,0,47.6403,-122.372
397500,3,1.75,1300,8480,1300,0,47.6991,-122.13
221000,3,1,1240,5250,1240,0,47.4917,-122.206
466000,4,2.25,2170,8050,1220,950,47.7354,-122.174
197500,3,1,1330,5412,1330,0,47.2053,-121.993
280000,3,3,1390,1080,1140,250,47.5325,-122.282
412000,2,1.5,1240,3873,860,380,47.5752,-122.388
454000,2,1,880,6731,880,0,47.5694,-122.395
540000,4,2.25,2540,228254,1450,1090,47.719,-121.912
250000,5,1.5,2520,5753,1510,1010,47.2058,-121.997
900000,5,2.25,2510,35691,2510,0,47.6435,-122.154
245000,5,1.75,2020,7902,1220,800,47.51,-122.327
290000,3,1.75,2060,7251,1350,710,47.3569,-122.175
160000,2,1,930,7742,930,0,47.507,-122.302
1.26E+06,2,1.5,2700,7225,1660,1040,47.5892,-122.383
325000,2,1,1060,6050,940,120,47.7028,-122.321
185000,2,1,670,6750,670,0,47.4521,-122.283
477000,3,2,1750,4990,950,800,47.6667,-122.361
100000,2,1,930,7623,930,0,47.467,-122.349
345000,4,2.5,2420,11481,1370,1050,47.341,-122.318
530000,4,2.25,2410,14985,1950,460,47.4278,-122.343
203000,3,1,1150,7156,1150,0,47.4864,-122.317
599000,4,2.5,2480,5000,2480,0,47.6811,-122.035
370000,4,1,1310,6000,1310,0,47.5822,-122.295
140000,3,1,1240,8000,1040,200,47.4204,-122.316
500000,3,1,1150,5100,1150,0,47.5349,-122.384
527200,3,1.75,1460,4000,730,730,47.5768,-122.307
549900,5,2.75,3060,7015,1600,1460,47.5052,-122.372
760000,4,2.5,3520,8095,3520,0,47.7065,-122.109
319000,2,1,960,4400,960,0,47.5269,-122.264
362300,3,2.5,2430,15264,2430,0,47.3805,-122.208
421000,3,2.5,1930,4505,1440,490,47.3459,-122.326
690000,3,1,1090,4000,1090,0,47.6846,-122.386
640000,3,2.5,2790,31798,1650,1140,47.5241,-122.039
238000,4,1.75,1650,6900,910,740,47.2802,-122.211
789000,3,3,3740,39640,3740,0,47.4036,-122.462
1.05E+06,6,4,5310,12741,3600,1710,47.5696,-122.213
302500,3,2.5,1690,4476,1690,0,47.3663,-122.114
259950,4,1.75,1400,7920,1400,0,47.4658,-122.184
456000,3,1.5,1440,28516,1440,0,47.5829,-122.005
369950,3,2.5,1360,3718,1360,0,47.6827,-122.097
363750,3,1.75,1726,197326,1726,0,47.3484,-122.505
585000,3,1.75,2220,216493,2220,0,47.6624,-121.951
268000,3,2.5,1850,6676,1850,0,47.3103,-122.36
1.2E+06,5,2.5,2860,4000,2160,700,47.6225,-122.318
345000,3,1,1120,10176,920,200,47.5235,-122.277
539000,4,2.5,2340,19850,2340,0,47.7672,-122.306
851000,5,3.25,3760,9792,2550,1210,47.5654,-122.115
900000,3,2.5,1920,7200,1780,140,47.5709,-122.408
850000,3,2.5,3230,5000,2430,800,47.7011,-122.389
390000,3,1.75,1260,6500,1260,0,47.6224,-122.116
345000,3,1.75,1540,6909,920,620,47.7451,-122.313
534500,3,2.5,1700,3150,1700,0,47.5505,-121.998
643500,6,5.25,3600,3960,2400,1200,47.5656,-122.372
1.2065E+06,3,2.75,3150,5520,2130,1020,47.6345,-122.302
495000,2,1.75,1280,4000,730,550,47.5798,-122.383
535000,2,1,980,4120,830,150,47.6815,-122.291
435000,4,2.5,2190,6578,2190,0,47.5305,-121.847
305000,4,2,2470,1831,1970,500,47.4645,-122.337
799000,4,2.5,2590,7910,2590,0,47.6978,-122.284
700000,4,2.5,2580,15031,2580,0,47.6895,-122.094
467000,3,2.25,1270,1213,1040,230,47.6736,-122.375
263000,3,1,1250,7560,1250,0,47.4493,-122.173
760000,4,2.5,4660,7157,3020,1640,47.5352,-122.156
293000,4,2.5,2019,4435,2019,0,47.1958,-121.974
245000,3,2,1490,7929,1490,0,47.2875,-122.218
181000,2,1.5,1560,10807,1560,0,47.4444,-122.509
240000,3,1,1030,15264,1030,0,47.5016,-122.168
880000,4,2.75,2560,7961,1450,1110,47.6499,-122.199
285000,3,2,1460,6377,1460,0,47.3679,-122.02
407500,2,1,770,6017,770,0,47.7223,-122.321
325000,4,2.5,1960,3543,1960,0,47.4849,-122.184
405000,3,1.75,1900,10454,1390,510,47.7748,-122.291
291700,3,2.5,1970,4120,1230,740,47.5328,-122.346
370000,3,2.5,2490,18525,2490,0,47.2119,-122.001
270000,3,1.5,1430,8960,1430,0,47.4759,-122.349
800000,4,2.5,2680,7200,1380,1300,47.6835,-122.187
626500,3,1.75,1610,3210,910,700,47.6656,-122.335
1.13E+06,4,3.5,4300,8406,3580,720,47.5396,-122.214
399950,4,2.5,3200,7545,3200,0,47.3666,-122.03
419000,3,1.75,2140,15030,1570,570,47.4181,-122.338
1.16E+06,4,2.5,4240,43995,4240,0,47.6008,-122.044
1.405E+06,4,3.5,3410,10769,3410,0,47.6081,-122.198
710000,4,2.75,2090,8064,2090,0,47.6829,-122.195
650000,3,1,1410,4840,1230,180,47.6646,-122.204
369900,4,2.5,2820,33750,2820,0,47.7387,-122.096
641000,4,2.5,2770,63118,2770,0,47.6622,-121.961
403000,3,1,1400,6879,1400,0,47.7508,-122.286
1.015E+06,3,3.25,3620,4000,2730,890,47.6393,-122.403
865000,4,2.5,2260,13600,1770,490,47.5436,-122.233
2.485E+06,4,2.5,3440,23954,2260,1180,47.5636,-122.231
810000,4,1,2150,3588,1850,300,47.5767,-122.378
316750,3,2.5,1256,1154,1256,0,47.7146,-122.311
652500,4,2.25,2220,130244,2220,0,47.4989,-121.9
360000,6,2.75,2850,15240,1850,1000,47.5288,-122.345
208000,2,1,700,5100,700,0,47.4957,-122.168
898000,4,2.5,3700,63991,3700,0,47.7319,-122.051
295000,4,1.75,1400,11934,1050,350,47.7346,-122.244
652500,4,1.75,3130,18253,3130,0,47.7402,-122.348
560000,4,3,2170,5764,2170,0,47.5673,-121.999
280000,3,1,1020,8400,1020,0,47.4905,-122.18
289950,3,2.5,1760,8584,1760,0,47.4612,-122.325
397500,3,2.5,1860,44093,1860,0,47.4381,-122.188
380000,2,1,1140,75132,1140,0,47.7349,-122.074
415900,3,2.5,1670,22703,1310,360,47.4708,-121.756
475000,2,1.75,1710,8645,1510,200,47.7005,-122.313
125000,1,1,500,7440,500,0,47.5252,-122.362
238000,3,1,1470,32670,1020,450,47.3811,-122.144
296000,4,1.5,1370,9750,1070,300,47.4718,-122.323
475000,6,3,3470,117612,3470,0,47.7663,-122.234
390000,3,2.25,1650,6250,1650,0,47.5639,-122.4
425000,3,1,1180,3750,1030,150,47.5726,-122.382
725000,6,3,3110,5000,1810,1300,47.6631,-122.348
605000,3,2.25,2080,12134,1530,550,47.6315,-122.102
302000,3,1,1600,1950,1600,0,47.6028,-122.312
886000,3,2.25,2380,6000,1650,730,47.6472,-122.393
540000,4,1.75,1630,6120,980,650,47.6821,-122.31
435000,4,2.25,1910,8400,1910,0,47.7352,-122.175
409000,4,3.25,3140,10752,2300,840,47.5022,-122.363
405000,3,1,1250,7280,1250,0,47.6986,-122.129
560200,3,2.5,1990,3984,1990,0,47.5914,-122.017
324000,4,1.75,2110,7208,1170,940,47.4464,-122.129
390000,4,2.5,2490,8290,2490,0,47.3305,-122.171
414000,2,1,800,5000,800,0,47.4914,-122.204
441500,3,2.5,2360,4670,2360,0,47.537,-121.871
375000,3,2.5,1770,5146,1770,0,47.5263,-122.356
668500,4,2.5,2710,5500,2710,0,47.6027,-122.023
540000,5,1.5,1940,10202,1940,0,47.7213,-122.31
1.035E+06,4,3.25,3450,11240,2430,1020,47.4556,-122.372
1.345E+06,4,3.25,3440,4920,2520,920,47.5727,-122.409
758000,4,2.75,2410,9549,1780,630,47.6503,-122.197
949880,4,2.25,2290,10687,2290,0,47.5878,-122.202
570000,3,1,1030,4089,1030,0,47.574,-122.385
736000,4,2.5,2290,12047,2290,0,47.5599,-122.105
670000,3,1.5,1490,4400,1490,0,47.6113,-122.292
1.13E+06,4,1.75,2370,8400,1270,1100,47.6716,-122.264
650000,4,2,1930,3976,1930,0,47.6117,-122.297
690000,2,1.75,1600,4000,850,750,47.6408,-122.3
610000,4,2.25,2240,45738,2240,0,47.687,-122.047
413500,2,1,770,4000,770,0,47.6959,-122.364
765000,3,2.5,2300,9752,2300,0,47.5825,-122.076
828200,4,2.75,3400,7081,3400,0,47.5661,-122.123
205000,2,1,900,4397,900,0,47.4851,-122.205
465000,3,2.5,1450,5175,1030,420,47.7082,-122.338
556000,4,2.5,2240,5402,2240,0,47.772,-122.35
540000,4,2.5,1780,4169,1780,0,47.5695,-122.006
423000,4,2.5,2320,4254,2320,0,47.48,-122.137
375000,3,1.75,1590,14766,1590,0,47.5902,-122.147
173250,3,1,990,12696,990,0,47.4776,-122.279
599900,3,1.5,2605,12030,1355,1250,47.7725,-121.899
646000,5,2.75,2870,4461,1650,1220,47.675,-122.39
1.075E+06,5,4.75,5180,17811,4070,1110,47.5405,-121.868
558000,4,2,2180,3870,1020,1160,47.6089,-122.303
354000,2,1,850,5225,850,0,47.5311,-122.38
1.195E+06,4,4,4050,9517,3360,690,47.5769,-122.215
670000,4,2,2250,4200,1650,600,47.6136,-122.297
1.125E+06,6,4.25,3100,9378,3100,0,47.6381,-122.314
267500,2,1,1747,12250,1747,0,47.3282,-122.285
299800,4,2.5,2410,4708,2410,0,47.3229,-122.182
430000,4,1.75,2070,9120,1250,820,47.6045,-122.123
775000,5,1,1860,3040,1530,330,47.6559,-122.339
333000,3,1,950,5214,830,120,47.5362,-122.379
336000,3,2,1060,11765,1060,0,47.7333,-122.302
323000,2,1,880,1712,880,0,47.6475,-122.397
575000,4,2.5,2550,56628,2550,0,47.4913,-122.081
328000,2,2.25,1550,2079,1550,0,47.54,-122.368
572500,3,1,1590,4600,1290,300,47.6807,-122.399
600000,3,1.75,1650,5100,1040,610,47.6873,-122.321
412000,4,3,2430,7242,2430,0,47.3533,-122.015
827500,3,2.5,1810,7200,1310,500,47.6885,-122.211
300000,4,2.5,2890,17349,2890,0,47.2822,-122.34
415000,3,2.5,1280,5040,1280,0,47.5611,-122.276
750000,7,2.75,3410,4056,2130,1280,47.6454,-122.316
800000,3,2.75,2220,4000,1700,520,47.617,-122.291
420000,3,1,1060,6000,1060,0,47.5427,-122.275
266000,3,1.5,1120,8250,1120,0,47.4905,-122.179
499000,4,2.5,2680,10590,2680,0,47.7377,-121.97
440000,4,1.5,1770,5750,1770,0,47.5621,-122.394
495000,3,2,2950,12196,2310,640,47.4702,-122.365
630000,2,1.75,1260,5300,840,420,47.6809,-122.348
424000,3,1.75,1430,6818,1430,0,47.7271,-122.196
760000,4,2.5,2730,36183,2730,0,47.7036,-122.127
650000,4,3.5,3270,15704,2110,1160,47.6256,-122.042
248500,4,1.75,1720,10018,1720,0,47.3614,-122.119
379600,3,1.75,1270,12420,1270,0,47.5387,-122.179
538000,4,2.5,3260,10032,1960,1300,47.7203,-122.323
530000,4,2.5,2050,6360,2050,0,47.5641,-122.011
545000,4,2.25,2050,9720,2050,0,47.5911,-122.119
925000,4,3,3580,35261,3580,0,47.7577,-122.134
565000,4,2.75,1960,48787,1960,0,47.7484,-122.111
405100,2,1,840,3522,840,0,47.6575,-122.395
502000,3,1.75,1300,8800,1300,0,47.6199,-122.116
425000,3,2.25,1260,3000,1260,0,47.5454,-121.997
233500,3,2.25,1650,2958,1650,0,47.3916,-122.167
287000,3,2.5,1710,10341,1710,0,47.3494,-122.171
190000,3,1,1180,8775,1180,0,47.2848,-122.223
666000,3,2.25,2780,31510,2780,0,47.67,-122.024
330000,2,1,950,3090,950,0,47.551,-122.276
1.49E+06,5,3.5,3620,7821,2790,830,47.5738,-122.215
393000,3,2.25,2140,10256,2140,0,47.3751,-122.044
353000,4,2.75,1920,4627,1010,910,47.5003,-122.23
260000,2,1,750,6720,750,0,47.552,-122.31
680000,3,2.5,2060,2551,1900,160,47.5881,-122.165
921000,3,2.25,2380,11200,2380,0,47.5873,-122.193
319000,2,1,750,6380,750,0,47.7033,-122.308
280000,3,1,1160,10881,920,240,47.6339,-122.033
220000,3,1,1050,6300,1050,0,47.5128,-122.374
219000,3,1.5,1740,5200,1060,680,47.3657,-122.094
528000,4,2.75,2050,7171,1540,510,47.6194,-122.042
405000,3,1.75,1980,8100,1310,670,47.7353,-122.331
372977,3,2.5,1690,1618,1150,540,47.5518,-121.998
934550,4,3.25,2320,5900,2320,0,47.597,-122.292
1.465E+06,3,1.5,2480,9900,2130,350,47.7018,-122.381
975000,4,2.25,2290,5350,2120,170,47.6428,-122.411
800866,5,2.5,3180,13806,3180,0,47.652,-122.182
950000,7,3.5,3470,16264,3470,0,47.6203,-122.149
624000,4,3,1540,4140,1540,0,47.6728,-122.396
1.85E+06,5,2.25,2800,8442,2800,0,47.5784,-122.076
310000,3,1,1050,9876,1050,0,47.7635,-122.262
315000,3,1.75,1480,6800,1480,0,47.4633,-122.188
675000,3,2,1010,5973,1010,0,47.6652,-122.202
490000,3,1.75,1660,8208,1660,0,47.5919,-122.154
600000,5,2.25,2760,6350,1380,1380,47.5561,-122.379
154000,2,1,1040,20524,1040,0,47.6981,-121.875
480000,4,1.75,2220,6500,2220,0,47.4519,-122.375
196900,3,1,1270,7500,1270,0,47.4214,-122.316
735000,3,3.25,2960,39370,2960,0,47.7452,-122.202
205500,3,2,1330,8748,1330,0,47.2619,-122.298
357186,2,1.75,1210,1040,1210,0,47.5519,-121.999
275000,4,2.5,2120,6754,2120,0,47.3629,-122.184
248500,3,1.75,2090,12026,2090,0,47.3095,-122.217
350000,3,2.5,2680,7836,2680,0,47.3203,-122.185
390000,4,2.75,1790,47250,1220,570,47.5302,-121.746
390000,3,2.75,1950,12240,1250,700,47.7401,-122.258
660000,5,2.25,3740,14913,3740,0,47.6234,-122.059
310000,3,1.75,1140,8263,1140,0,47.7407,-122.327
717000,3,2.5,2480,5137,2480,0,47.684,-122.164
260000,5,2.5,2580,11250,1410,1170,47.397,-122.313
745000,3,2,2290,5001,1490,800,47.6909,-122.339
470000,4,2.5,2320,12042,1320,1000,47.763,-122.16
429000,3,2.5,2530,8820,2530,0,47.42,-122.205
220000,4,2,1400,7140,1400,0,47.7719,-122.309
497000,3,3,2060,1850,1400,660,47.6543,-122.373
716100,3,1,1640,4000,1640,0,47.6563,-122.351
371000,4,1,1960,94525,1960,0,47.5418,-121.962
379000,5,2.75,3000,25175,1500,1500,47.497,-122.088
937500,3,1,1320,8500,1320,0,47.6187,-122.226
720000,4,2,1760,4500,1760,0,47.6711,-122.331
616000,3,3.25,2130,2306,1420,710,47.5424,-122.391
259000,3,2,1390,7120,1390,0,47.3786,-122.179
538000,3,1.75,1400,3825,1100,300,47.6793,-122.393
605000,3,2.75,3230,9576,3230,0,47.7307,-122.183
369950,3,1,1110,7603,1110,0,47.7262,-122.224
310000,3,2.5,1670,4220,1670,0,47.3834,-122.028
227500,3,1,1540,9450,1540,0,47.3612,-122.315
274000,4,2.25,2090,7400,1670,420,47.3178,-122.38
410000,3,2,1410,8088,1410,0,47.7303,-122.227
354800,3,2,1370,78408,1370,0,47.3867,-122.081
650000,4,2.25,1910,5120,1300,610,47.6534,-122.409
353000,3,2,1678,13862,1678,0,47.3744,-122.19
224975,3,1,960,12745,960,0,47.3617,-122.03
600000,2,1.75,2080,13054,2080,0,47.7435,-122.292
437500,3,2.25,1790,7700,1340,450,47.7205,-122.168
567000,3,2.5,2540,6093,2540,0,47.7042,-122.236
225000,5,1.5,1790,11656,1790,0,47.3961,-122.308
255000,2,1,940,9330,940,0,47.5445,-122.273
2.479E+06,5,3.75,6810,7500,6110,700,47.6285,-122.322
370000,2,1,900,4600,900,0,47.6918,-122.361
675000,4,1.75,1900,8800,1140,760,47.6579,-122.197
285000,3,1,1440,4268,1040,400,47.5468,-122.293
310000,3,1.75,2070,37904,1420,650,47.425,-122.186
475000,4,2.5,2240,7245,1140,1100,47.7161,-122.17
410000,4,2.5,3320,5034,3320,0,47.4011,-122.164
895000,4,2.25,1950,5950,1330,620,47.639,-122.347
375000,3,1.5,1240,7733,790,450,47.714,-122.283
349000,4,2.5,1830,4694,1830,0,47.3573,-122.016
650500,3,1.75,1740,4400,1740,0,47.6115,-122.292
760000,3,1.75,1410,15120,1410,0,47.5974,-122.195
480000,4,2.75,2050,3960,1180,870,47.5808,-122.394
689000,4,2.75,3220,16145,3220,0,47.5786,-121.995
415000,3,1.75,1960,5000,980,980,47.5576,-122.317
195000,3,1.75,1070,6110,1070,0,47.3249,-122.207
318000,5,2.5,2820,9956,1410,1410,47.4715,-122.33
404000,4,3,4060,35621,2030,2030,47.3059,-122.108
339950,2,1,800,3090,800,0,47.5518,-122.277
215000,3,1,1260,7897,1260,0,47.1946,-122.003
339900,3,2.5,2420,7423,2420,0,47.3199,-122.186
285000,1,1.5,810,3211,810,0,47.6939,-122.184
550000,3,1,1600,5000,1110,490,47.655,-122.358
430000,4,1,1350,9000,1350,0,47.6953,-122.332
219000,3,1,970,7790,970,0,47.3165,-122.325
555000,2,1.5,1780,4750,1080,700,47.6859,-122.395
233000,3,2,1350,7686,1350,0,47.3609,-122.053
248000,3,1.75,1840,19501,1270,570,47.3364,-122.318
454000,5,2.25,2550,9200,1580,970,47.4673,-122.363
950000,4,2.5,1700,4418,1700,0,47.6434,-122.3
359000,3,2.5,2430,7857,1730,700,47.4546,-122.211
407500,5,2,2740,8230,2210,530,47.7352,-122.297
224000,3,1.5,1560,7300,1040,520,47.3427,-122.281
210000,2,1,1040,4590,1040,0,47.5078,-122.337
261000,4,1.75,1820,9824,1820,0,47.3833,-122.093
719000,3,3,1833,1706,1833,0,47.6827,-122.325
440000,3,2.5,2160,3738,2160,0,47.5661,-122.375
525000,3,2.75,2100,10362,1510,590,47.4347,-121.417
375000,3,1.5,1370,9720,1370,0,47.7302,-122.197
428000,2,2.5,1414,1960,1414,0,47.5423,-122.189
988830,5,3.25,4115,7910,4115,0,47.6847,-122.016
199950,3,1.75,1550,6225,1550,0,47.3098,-122.218
840000,4,2.25,2100,3671,1750,350,47.6359,-122.3
285000,3,1.75,1160,7006,1160,0,47.1937,-121.98
330000,5,2.5,3597,4972,3597,0,47.3002,-122.282
147500,3,1.5,1230,10125,1230,0,47.397,-122.299
320000,4,2.5,2190,7125,2190,0,47.3709,-122.285
382500,3,1.75,1040,9000,1040,0,47.5253,-122.043
2.048E+06,5,4,4690,8208,3040,1650,47.6321,-122.304
596000,4,2.25,2270,10000,1720,550,47.5599,-122.142
220000,4,2.25,1950,7280,1950,0,47.2957,-122.37
325000,3,2.5,1880,6818,1880,0,47.4206,-122.183
679950,4,2.5,2850,5664,2850,0,47.5835,-121.996
175000,2,1,1160,6911,1160,0,47.7149,-122.318
268000,3,1.75,1370,10050,1370,0,47.3338,-122.341
715000,4,3.5,3260,110579,3260,0,47.6436,-121.997
600000,7,2.25,3170,36384,3170,0,47.4654,-122.003
228000,0,1,390,5900,390,0,47.526,-122.261
950000,5,2.5,3450,35880,3450,0,47.7173,-122.099
475000,2,1.75,1490,224334,1490,0,47.2645,-122.163
700000,3,1.5,1460,78408,1460,0,47.59,-122.058
275000,3,1.75,1300,20700,1300,0,47.5587,-121.904
369500,3,1.75,1300,20700,1300,0,47.5587,-121.904
215000,4,2,1540,7575,1040,500,47.3664,-122.279
593450,4,2.25,2130,7172,2130,0,47.6271,-122.112
498800,2,1.75,1350,4614,1350,0,47.7091,-122.015
849000,5,3.25,2450,6534,1770,680,47.688,-122.281
1.15125E+06,4,2.5,1940,4875,1940,0,47.6427,-122.304
825000,5,2.5,2890,5110,2890,0,47.5453,-121.995
265000,3,1.75,1680,9769,1340,340,47.4631,-122.126
285000,4,2.25,1960,10400,1220,740,47.3199,-122.392
240000,3,1.75,1590,7931,1190,400,47.3628,-122.05
261000,4,1,1390,17739,1390,0,47.3457,-122.302
330000,4,1.75,2440,7350,1610,830,47.3743,-122.285
250000,4,2,1850,7560,1540,310,47.3666,-122.277
350000,4,2.5,2800,9538,2800,0,47.2675,-122.307
930000,3,2.5,3780,35273,3780,0,47.7499,-122.119
275000,3,2,1910,8050,1000,910,47.37,-122.17
325000,4,2.25,2460,7620,1230,1230,47.5285,-122.345
255000,1,1,810,5000,590,220,47.5696,-122.36
562200,3,1.5,1900,5250,1500,400,47.6991,-122.392
952000,2,1.75,3490,88909,2320,1170,47.5462,-122.112
365000,3,2.5,2200,7350,1570,630,47.4395,-122.161
332900,3,1.5,1190,11996,1190,0,47.7561,-122.071
721000,3,2.25,2040,18360,2040,0,47.6976,-122.137
487275,4,2.5,2400,3986,2400,0,47.5344,-121.877
310000,3,2.5,1670,5791,1670,0,47.4424,-122.188
245000,2,1,990,4800,990,0,47.5615,-122.28
325000,3,1.75,2920,10573,2920,0,47.4429,-122.195
550000,3,1.75,1840,9401,1840,0,47.5847,-122.075
350000,2,1,910,4500,910,0,47.5633,-122.289
599000,5,2.5,2950,72309,2950,0,47.4186,-122.079
259950,3,1.5,1240,9500,1240,0,47.4756,-122.35
240000,4,2.5,1980,7264,1980,0,47.3678,-122.019
186000,3,1,1200,10080,1200,0,47.3261,-122.135
395000,3,1.5,1280,15028,1280,0,47.6304,-122.035
475000,4,2.5,3150,5757,3150,0,47.4568,-122.117
815000,5,3.5,3500,10794,3500,0,47.5887,-121.974
572000,3,1.5,1680,13751,1680,0,47.5716,-122.227
419500,3,2.5,1360,3188,1360,0,47.6831,-122.096
298700,3,2.25,2110,7350,1530,580,47.3088,-122.341
549000,2,1,2034,13392,1159,875,47.3312,-122.503
278000,3,1.5,1900,9994,1120,780,47.4729,-122.301
455000,4,2,2380,4500,1470,910,47.5652,-122.281
925000,5,3.5,4050,13495,2230,1820,47.4384,-122.352
465000,2,1.5,1120,1201,1120,0,47.6524,-122.353
620000,4,4,2850,2970,2120,730,47.547,-122.01
499900,4,2.25,2360,7650,1640,720,47.75,-122.292
620000,5,3,2540,11422,1270,1270,47.5459,-122.176
450000,3,1.75,1160,6120,1040,120,47.6926,-122.287
690000,4,3.5,2710,2147,2220,490,47.5468,-121.994
1.895E+06,5,2.25,3120,16672,3120,0,47.6458,-122.219
1.94E+06,5,2.25,3120,16672,3120,0,47.6458,-122.219
832500,3,2,1870,9527,1870,0,47.5777,-122.224
245000,3,1,1010,9678,1010,0,47.4396,-122.285
820000,3,2.5,2980,18935,2980,0,47.7133,-122.079
369000,4,2.75,2420,6495,2420,0,47.3771,-122.029
1.05E+06,4,3.25,3830,8331,3830,0,47.6906,-122.019
653000,3,3,3040,5067,3040,0,47.5409,-122.267
220650,2,1.75,1460,10500,1460,0,47.4461,-121.768
300000,5,3,1940,6355,1200,740,47.498,-122.322
970000,4,3.5,3780,20023,3780,0,47.5491,-122.006
360000,4,2.5,1950,5451,1950,0,47.4341,-122.144
672500,3,2.5,2450,5760,2450,0,47.6145,-122.026
268000,4,1.5,1730,7020,1730,0,47.4939,-122.167
440000,4,1.5,1690,3245,1690,0,47.5445,-122.375
1.4E+06,3,2.5,2550,7200,2550,0,47.5996,-122.288
590000,4,2.5,2290,11072,2290,0,47.6283,-122.03
359000,4,2.25,2710,22860,1850,860,47.3207,-122.266
266500,4,1.75,1880,7632,1180,700,47.3068,-122.372
635000,4,2.5,2930,8679,2930,0,47.5164,-122.19
559000,3,2.5,3110,217800,3110,0,47.3281,-122.124
895000,4,2.5,3480,38985,3480,0,47.6895,-122.052
625000,2,1.5,1110,118047,1110,0,47.7467,-122.128
650000,4,2.25,2440,9320,1880,560,47.5933,-122.135
312500,4,1.75,2280,7840,1280,1000,47.4809,-122.224
225000,3,1,900,6099,790,110,47.4807,-122.289
425000,4,1.75,1980,8400,1330,650,47.6721,-122.152
329999,3,2.75,3360,41250,1820,1540,47.2604,-122.023
572000,5,2.25,2340,9225,2340,0,47.6369,-122.098
386500,4,2.5,3110,5048,3110,0,47.3782,-122.125
452000,2,1,980,5000,980,0,47.6744,-122.369
278000,4,2,1480,6324,1480,0,47.6147,-122.302
474900,3,2.25,1800,43647,1800,0,47.7757,-122.132
450000,2,1.75,2130,6574,1500,630,47.6529,-122.411
611000,2,1,1270,5100,1100,170,47.6771,-122.328
214100,2,2.5,1150,2064,1150,0,47.3516,-122.292
317000,3,2.5,1840,5011,1840,0,47.3555,-122.054
1E+06,4,3.5,3180,12528,2060,1120,47.7058,-122.379
1E+06,5,2.75,1510,5700,1510,0,47.6653,-122.27
525000,4,2.5,3070,7200,3070,0,47.4899,-122.138
436000,3,2.25,1800,6680,1800,0,47.7293,-122.223
450000,3,1.75,1540,9154,1540,0,47.6207,-122.042
588500,3,1.75,2330,14892,1970,360,47.6267,-122.046
340000,4,1.75,1400,8374,1400,0,47.4735,-122.344
482000,4,2.5,2846,85377,1976,870,47.317,-122.281
1.575E+06,4,3.5,5830,131116,5830,0,47.5986,-121.949
749000,3,2.5,3380,7126,3380,0,47.6276,-122.122
330000,3,1.5,1440,7875,1440,0,47.4561,-122.148
568000,3,2.5,1740,1279,1740,0,47.5891,-122.387
239000,3,1.75,1470,8925,1470,0,47.2026,-122
528000,3,2.5,2810,4932,2810,0,47.7739,-122.227
385000,4,3,2090,5102,1350,740,47.5427,-122.356
825000,4,3.25,4110,14219,2570,1540,47.7382,-122.264
815000,5,3.25,3230,5000,2350,880,47.5202,-122.393
625000,4,2.5,2601,34335,2601,0,47.742,-122.087
690000,3,1.75,2070,6000,1340,730,47.5226,-122.382
210000,3,1,1660,7440,1270,390,47.5242,-122.362
599000,4,1,1590,4280,1590,0,47.667,-122.335
860000,3,1.75,1860,5584,1310,550,47.637,-122.4
147200,3,1,1420,9600,1420,0,47.4232,-122.292
476900,3,1,1240,5758,960,280,47.5675,-122.396
450000,4,2.5,2500,36254,1590,910,47.4685,-122.004
570000,4,2.5,2640,11816,2640,0,47.733,-121.968
567500,3,1,1440,3060,1440,0,47.6769,-122.307
790000,5,3.25,3030,20446,2130,900,47.6133,-122.106
875000,3,1.5,1820,12686,1820,0,47.5886,-122.195
490000,3,2,2220,10275,1640,580,47.5304,-122.055
335000,3,1.75,2430,9133,1410,1020,47.5116,-122.157
550000,3,1.75,1670,10798,1670,0,47.549,-122.17
385000,3,1.75,1180,10541,940,240,47.6348,-122.032
395000,3,1.75,1620,8085,1210,410,47.7349,-122.197
650000,2,1,1030,5750,1030,0,47.5861,-122.391
637000,4,2.75,2900,5803,2900,0,47.7368,-122.232
692500,3,2.25,3420,9900,1710,1710,47.7412,-122.256
322400,3,1.75,1710,15844,1710,0,47.4706,-122.1
233500,3,1.5,1580,10517,1580,0,47.2903,-122.214
400000,3,2,1230,11413,990,240,47.6321,-122.034
547000,5,2.5,2200,4080,1420,780,47.6872,-122.35
519000,5,2.25,2570,13054,1470,1100,47.4487,-122.352
1.025E+06,4,3.5,3320,19850,2040,1280,47.527,-122.228
365000,3,1,1090,6435,1090,0,47.5334,-122.365
699000,5,2.75,2970,36817,2970,0,47.7731,-122.139
525000,3,1.75,1970,8000,1970,0,47.6324,-122.1
430000,4,3,3220,8936,2450,770,47.4208,-122.213
325000,3,1,1600,7500,1600,0,47.7198,-122.182
279000,2,1,670,6300,670,0,47.5161,-122.374
805000,4,1.75,2360,4750,1660,700,47.6729,-122.293
419950,3,3,2150,3962,1540,610,47.7183,-122.285
425000,2,1,620,4455,620,0,47.6877,-122.395
446000,4,1.75,1730,5922,1730,0,47.7188,-122.321
455000,5,2,2500,7860,1040,1460,47.7212,-122.226
226550,3,1,990,4440,990,0,47.522,-122.354
764000,3,2,1420,4080,1420,0,47.6801,-122.348
439950,3,2.25,2170,15000,2170,0,47.3863,-122.158
453000,4,2,1880,5100,1880,0,47.6872,-122.349
219950,3,1,1300,9620,1300,0,47.282,-122.331
702500,3,1.5,2360,6750,1930,430,47.6923,-122.332
285000,3,1.5,1780,12231,1780,0,47.335,-122.321
798750,2,2.25,2160,2578,2160,0,47.6607,-122.354
320000,2,1,950,5316,950,0,47.57,-122.38
425000,3,1.75,1680,14630,1680,0,47.5272,-122.044
540000,4,2.5,2290,4450,2290,0,47.7385,-122.169
1.06E+06,4,5.25,4140,14757,4140,0,47.5871,-121.969
1.165E+06,4,3.75,3920,4500,3920,0,47.6805,-122.346
576000,3,1.75,1500,13891,1500,0,47.5866,-122.175
525000,3,1.75,1720,7200,1140,580,47.6977,-122.132
324950,4,2.5,2641,8615,2641,0,47.4038,-122.213
600000,3,2.5,4930,77536,3930,1000,47.7634,-122.139
464000,3,2.5,2460,5400,1520,940,47.5231,-122.202
266000,4,2.25,1995,7102,1995,0,47.2986,-122.37
775000,3,2.5,3010,74390,3010,0,47.6442,-121.999
415000,3,1.75,1270,4800,1270,0,47.5362,-122.376
550000,4,2.75,3080,6731,3080,0,47.4522,-122.118
235000,3,2.25,1670,7606,1670,0,47.1949,-121.982
280000,3,2,1470,8089,1470,0,47.3878,-122.316
459000,3,1.75,1730,7807,1260,470,47.7211,-122.169
195000,3,1,1070,7615,1070,0,47.3189,-122.373
235000,3,1.5,1660,8738,1080,580,47.3117,-122.208
711800,4,2.25,2410,16650,2410,0,47.5706,-122.163
440000,3,2.5,1040,1032,1040,0,47.6673,-122.377
515000,2,1,970,3300,970,0,47.6609,-122.343
1.2E+06,5,2.75,2910,9480,2910,0,47.6552,-122.278
560000,3,1.75,2340,12443,2340,0,47.5432,-122.177
340000,3,1.75,1880,11249,1330,550,47.3295,-122.257
600000,2,1,1110,3500,970,140,47.6453,-122.327
764000,4,2.5,2790,7938,2790,0,47.6223,-122.026
337000,4,2,1590,8779,1590,0,47.7408,-121.974
1.385E+06,6,2.75,5700,20000,2850,2850,47.5601,-122.16
249000,4,1,1200,7552,1060,140,47.5317,-122.37
350000,3,3,3200,35782,2360,840,47.4121,-122.154
269950,3,2.25,1510,6000,1150,360,47.3484,-122.036
735000,3,1.75,1880,108900,1880,0,47.5913,-122.01
1.295E+06,4,2.5,3070,4000,2070,1000,47.659,-122.281
475000,4,2.25,2110,7560,2110,0,47.7331,-122.183
339000,3,2,2350,8459,2350,0,47.3043,-122.349
600000,4,3.5,3270,15160,1660,1610,47.7437,-122.287
397500,4,1.75,2220,4760,1320,900,47.5215,-122.348
1.525E+06,4,3.5,5990,111078,5990,0,47.667,-121.994
460000,3,2,1760,9055,1760,0,47.6534,-122.128
370000,4,2.75,2200,5207,1120,1080,47.74,-122.343
250000,4,1,1550,7296,1550,0,47.5184,-122.366
1.1E+06,4,3.75,5070,60123,5070,0,47.6567,-122.004
430000,2,2.25,1040,1516,1040,0,47.6037,-122.307
1.085E+06,3,1.5,2560,4000,1660,900,47.6384,-122.279
670000,3,1.75,1850,8160,1850,0,47.7241,-122.363
461550,3,1.5,2090,11895,1790,300,47.5362,-122.267
479990,3,2.5,2010,2386,1390,620,47.5525,-121.998
643000,4,2.5,2518,4663,2518,0,47.5894,-122.017
607000,3,2.75,2810,12813,2040,770,47.6796,-122.114
625000,3,2.5,2600,10092,2600,0,47.6223,-122.032
731100,3,2.5,2060,8778,1160,900,47.5245,-122.384
859000,3,2.5,2920,434728,2920,0,47.3809,-122.13
435000,4,2.5,2130,10375,2130,0,47.4381,-122.16
465000,3,3,2290,15600,1420,870,47.3558,-122.29
740000,3,1,1230,6380,1230,0,47.6947,-122.315
740000,3,1.75,2020,9478,2020,0,47.5383,-122.238
250000,3,2,1430,7280,990,440,47.3742,-122.18
656000,2,2.5,2270,1763,1820,450,47.6757,-122.121
300000,4,2.5,1910,8058,1910,0,47.3891,-122.172
643000,3,1.5,1780,214315,1780,0,47.7631,-122.028
311000,4,2.5,2690,6124,2690,0,47.3343,-122.058
360000,3,1.75,1330,7482,1330,0,47.7322,-122.207
475000,4,2.5,3060,10043,1700,1360,47.7387,-122.337
469950,3,3.25,1760,1778,1760,0,47.7201,-122.301
240000,3,1.75,1570,8750,1570,0,47.4425,-122.333
232000,2,1,960,8100,810,150,47.494,-122.304
350000,3,2,1680,81893,1680,0,47.3248,-122.179
803000,2,1,1440,33747,1440,0,47.7223,-122.209
355000,3,2.25,1960,7000,1600,360,47.4427,-122.126
475000,4,2,1790,2250,840,950,47.6526,-122.345
823000,3,2.5,2560,9825,2560,0,47.5497,-122.145
395000,2,1.5,1010,3060,1010,0,47.6897,-122.354
499000,4,3.75,2560,5250,1900,660,47.7326,-122.342
420000,2,1.75,1200,3136,800,400,47.6132,-122.297
961500,3,2.5,3910,14000,3910,0,47.6374,-122.12
833000,4,1.75,2260,12238,2260,0,47.5976,-122.178
479000,3,2.25,2110,11319,2110,0,47.742,-122.105
1.15E+06,4,2.5,3340,10422,3340,0,47.6515,-122.197
267000,3,1,1400,8100,1400,0,47.7124,-122.289
555000,4,1.75,1760,94525,1760,0,47.5882,-122.07
490000,3,2.5,2010,9725,2010,0,47.568,-122.018
619000,4,2,2300,3400,1550,750,47.678,-122.361
569950,5,2.75,2510,28185,1600,910,47.7719,-122.282
549000,3,2,1340,3000,1340,0,47.6857,-122.349
422500,3,1.75,1560,7245,1560,0,47.6868,-122.119
400000,4,3.5,3350,9681,2140,1210,47.3978,-122.322
692500,4,2.75,3710,7984,3710,0,47.5352,-121.868
310000,4,2.5,2430,5499,2430,0,47.3779,-122.125
499900,3,1.75,2430,8820,1630,800,47.4972,-122.233
492000,3,2.25,2100,7335,2100,0,47.647,-122.061
460000,2,2.5,1880,40575,1880,0,47.5614,-121.899
800000,3,2.5,1630,2640,1630,0,47.6452,-122.371
832600,4,1,1640,4200,1640,0,47.6601,-122.332
470000,4,2.75,2310,7350,1670,640,47.7505,-122.182
542000,2,2,1930,4500,1930,0,47.7104,-122.031
1.3095E+06,4,4.5,4750,13912,3600,1150,47.5332,-122.265
308130,4,2.5,2300,7500,1650,650,47.4125,-122.33
310000,2,1,1050,2699,1050,0,47.5471,-121.996
235000,2,1,1500,8015,1500,0,47.5027,-122.348
215000,3,1,1150,7560,1150,0,47.4613,-122.184
210000,4,1.5,1920,10403,1370,550,47.2987,-122.366
730000,4,2.75,3660,150282,3660,0,47.6813,-122.048
245000,3,1.75,1720,9342,1140,580,47.3177,-122.182
540000,3,2.25,2100,20018,1470,630,47.4544,-122.366
299000,4,2.5,2400,6078,2400,0,47.2606,-122.285
510000,3,2.5,2540,40106,2540,0,47.6037,-122.043
198000,4,1.75,2080,7200,1050,1030,47.3385,-122.282
950000,5,3.25,3400,7452,3400,0,47.6141,-122.136
300000,4,1.75,2200,7600,2200,0,47.3131,-122.191
528000,5,1.75,2140,8580,1200,940,47.6625,-122.178
507000,5,3.25,3850,16249,3030,820,47.3324,-122.168
770000,4,3.25,4270,6384,3060,1210,47.5362,-121.874
255000,3,1.75,1340,7210,1340,0,47.4182,-122.167
220000,1,1.5,1100,3451,1100,0,47.3829,-122.322
690700,5,2.75,2870,5349,2870,0,47.5405,-122.187
447000,2,1,1320,8380,1320,0,47.705,-122.367
755000,6,2,2150,4505,1270,880,47.6514,-122.369
700000,4,1.5,2470,6000,1480,990,47.6365,-122.391
250000,4,2.75,1910,7700,1000,910,47.369,-122.17
320000,3,2.5,2130,6969,2130,0,47.3655,-122.027
565000,4,2.5,2240,14667,2240,0,47.5276,-122.161
754300,5,2.75,1800,4500,1680,120,47.6648,-122.358
650000,3,1.5,2160,9000,1400,760,47.7241,-122.369
529888,4,2.5,3140,8455,3140,0,47.4866,-122.147
432000,3,2.5,1920,9812,1920,0,47.7633,-122.243
235000,3,1,1050,7670,1050,0,47.2046,-121.996
994900,4,3.5,3695,6556,3695,0,47.683,-122.015
489000,4,2.5,3910,8442,2710,1200,47.3766,-122.027
800000,4,2.75,3010,7427,3010,0,47.7068,-122.112
370000,4,1.5,1370,9957,900,470,47.7237,-122.181
436000,4,2.75,2080,9600,1240,840,47.7149,-122.235
395000,3,2.5,2250,3757,2250,0,47.4787,-122.129
377691,5,1.75,2120,8399,1320,800,47.7621,-122.335
370000,5,3,2220,5185,2220,0,47.543,-122.29
515000,3,2.5,1440,4394,1440,0,47.5688,-122.019
169000,3,1,910,7686,910,0,47.3405,-122.288
475000,3,1,1270,4268,1270,0,47.6848,-122.392
420000,3,2.5,2480,6180,2480,0,47.4044,-122.208
1.297E+06,6,2.75,2630,9420,2510,120,47.6695,-122.337
822000,3,2,2410,13300,1840,570,47.5632,-122.148
1.5E+06,4,2.75,2930,25697,2310,620,47.6264,-122.226
485000,3,2.25,1570,6810,1180,390,47.6176,-122.044
270000,4,1,1900,8505,1200,700,47.4406,-122.196
300000,6,2.5,2590,11250,1390,1200,47.4608,-122.196
878000,4,2.5,3810,7728,3810,0,47.5925,-122.058
590000,3,2.5,2290,4203,2290,0,47.5441,-122.172
611900,1,2.25,1220,2100,1220,0,47.6703,-122.204
240000,3,1.75,1100,7373,1100,0,47.3124,-122.183
395000,4,2.5,2810,10951,2810,0,47.3249,-122.187
169000,3,1,890,7110,890,0,47.4971,-122.261
200500,3,2,1280,14972,1280,0,47.4129,-122.209
308000,3,2.5,2320,7140,2320,0,47.275,-122.295
290256,3,2.25,1720,7885,1720,0,47.3136,-122.344
279950,3,1.75,1530,8800,1040,490,47.4483,-122.158
195000,3,1.75,1580,7875,1580,0,47.1958,-122.003
630000,3,1,1360,13000,1360,0,47.3359,-122.033
1.16E+06,4,3,2680,15438,2680,0,47.6109,-122.226
478000,3,2.25,1640,3896,1640,0,47.5689,-122.006
835000,3,2.25,2520,6690,1700,820,47.5705,-122.381
639000,3,2.25,1400,2421,1400,0,47.695,-122.169
623000,4,2.75,2300,12633,2300,0,47.6218,-122.032
220000,3,1.75,1900,7680,1260,640,47.5081,-122.266
526000,3,2.25,2000,18099,1250,750,47.5443,-122.18
243500,2,1,900,5016,900,0,47.542,-122.282
750000,4,2.5,2980,4930,2890,90,47.5445,-122.12
329000,4,2,1850,9126,1850,0,47.5009,-122.164
525000,4,1,1570,4000,1570,0,47.6275,-122.321
190000,2,1,670,3101,670,0,47.5546,-122.274
772650,4,2.5,2660,10800,2660,0,47.5894,-122.172
355000,3,2.5,2110,4038,2110,0,47.3875,-122.153
650000,3,1.75,1970,54450,1570,400,47.5936,-122.012
678500,3,2.75,1210,3600,1210,0,47.6798,-122.354
669950,4,2.5,2670,11877,2670,0,47.6327,-122.036
850000,3,2.25,3000,18450,3000,0,47.7274,-122.062
572000,3,2.75,2200,3885,2200,0,47.6171,-122.028
492450,3,1.75,1540,13002,1200,340,47.6231,-122.044
813000,3,1.75,2080,11866,2080,0,47.5872,-122.173
710000,3,2,1780,9732,1780,0,47.5796,-122.229
792500,3,1.5,1960,2400,1330,630,47.6423,-122.37
285900,5,1.5,1690,7725,1690,0,47.3859,-122.288
389000,3,2,2080,12972,1250,830,47.3733,-122.432
675000,3,2.25,2070,2833,1490,580,47.5543,-122.398
352000,2,0.75,760,33801,760,0,47.4703,-122.076
1.05E+06,4,3.25,4020,11588,4020,0,47.5217,-122.155
768500,4,1.75,3620,10400,1820,1800,47.6069,-122.167
500000,4,2,2330,7778,1230,1100,47.7109,-122.323
685000,3,2.5,1460,8800,1460,0,47.5895,-122.232
648475,4,2.75,2250,5700,1200,1050,47.6406,-122.344
655000,6,5,2850,6600,2850,0,47.6813,-122.187
895000,4,2.75,2640,4000,1730,910,47.6727,-122.297
195000,3,1,1310,9554,960,350,47.2949,-122.285
368000,4,2.5,2720,7350,2720,0,47.3028,-122.35
997000,4,3.5,3430,13609,3430,0,47.5196,-122.151
335000,3,2.75,1990,19991,1340,650,47.7434,-122.106
250000,3,2,1170,7258,1170,0,47.3333,-122.266
278500,3,1.75,1390,8980,1390,0,47.2015,-122.005
260000,4,1.5,1540,7300,1540,0,47.3317,-122.276
162500,2,1,760,6141,760,0,47.5469,-122.277
239000,4,1,1280,8316,1280,0,47.4989,-122.302
600000,4,2.5,2990,5122,2990,0,47.5773,-122.055
350000,4,2.25,1770,7778,1770,0,47.4192,-122.201
852500,5,3.75,3830,8131,3830,0,47.5837,-121.971
485000,3,2.5,2870,5490,2870,0,47.4471,-122.207
299000,3,1,1520,8320,1520,0,47.7699,-122.335
227450,2,1,660,6509,660,0,47.4938,-122.171
383000,3,1,1800,5612,1200,600,47.525,-122.378
835000,2,3.25,3570,392475,2370,1200,47.5448,-121.93
760000,5,1.5,3050,2992,1920,1130,47.621,-122.302
532500,2,1,820,3000,820,0,47.6842,-122.348
635000,3,2.5,3610,26359,1950,1660,47.6306,-121.968
438500,3,2,1490,3072,770,720,47.5772,-122.307
545500,3,2.5,1560,9361,1360,200,47.5591,-122.295
675000,3,1.75,1660,9549,1660,0,47.6503,-122.198
450000,3,1.75,1180,4080,760,420,47.6825,-122.391
199999,3,1,960,10815,960,0,47.3091,-122.006
375000,3,1.5,1630,16170,1630,0,47.7104,-122.235
600000,4,2.25,2260,43847,2260,0,47.7713,-122.129
292600,3,1.5,1520,7123,1520,0,47.4991,-122.176
1.038E+06,5,2.75,3050,8904,1650,1400,47.5709,-122.214
610000,3,1,1000,4959,1000,0,47.6629,-122.277
397450,4,2.5,2650,9451,2650,0,47.3693,-122.129
382000,3,2.25,1750,15528,1270,480,47.7739,-122.274
370000,3,2.25,1770,7667,1270,500,47.7724,-122.362
520000,3,2.25,1770,7667,1270,500,47.7724,-122.362
260000,2,1,770,7906,770,0,47.766,-122.32
890000,4,2.5,3370,7200,3370,0,47.7698,-122.384
344000,5,2,2130,8412,1440,690,47.7403,-122.318
205000,3,1,1050,8498,1050,0,47.4038,-122.203
379000,5,2.5,2803,8550,2803,0,47.3032,-122.306
424240,3,2,2080,12094,2080,0,47.7035,-122.164
589950,3,2,2080,12094,2080,0,47.7035,-122.164
582000,4,1.75,2120,4650,1190,930,47.6964,-122.4
349000,3,2.5,2550,7709,2550,0,47.3081,-122.391
658000,3,1,1290,12005,1290,0,47.6835,-122.199
294000,5,2.75,1790,5000,1060,730,47.5655,-122.363
690000,5,3.5,2720,7598,1860,860,47.6931,-122.283
600000,3,1,1040,5000,1040,0,47.6754,-122.359
199990,3,1,840,5200,840,0,47.3685,-122.077
220000,3,1.75,1650,8850,1650,0,47.4331,-122.291
440000,4,2.25,2080,15750,1460,620,47.7225,-122.2
439990,4,2.5,1540,1994,1540,0,47.5526,-121.999
815000,4,2.5,3880,7208,3880,0,47.5841,-121.971
535000,4,2.25,1860,3766,1860,0,47.5699,-122.006
215000,3,1.75,1280,10016,1280,0,47.2823,-122.333
605000,3,2.5,3200,35012,2100,1100,47.4651,-121.993
349900,3,2.5,2200,7278,2200,0,47.4624,-122.132
495000,3,1,1570,5510,1070,500,47.6942,-122.319
515100,3,2.5,2074,4900,2074,0,47.7327,-122.233
620000,4,2.5,2450,55387,2450,0,47.6323,-121.985
657500,4,2.25,2520,10370,2520,0,47.6377,-122.049
250000,5,1.75,2190,8250,1190,1000,47.4887,-122.223
385000,5,1.75,2190,8250,1190,1000,47.4887,-122.223
307000,3,1.5,2320,7500,2320,0,47.7413,-121.979
288000,3,2.5,1370,9253,1090,280,47.3717,-122.073
226450,3,1.75,1730,7200,1730,0,47.3774,-122.236
390000,3,2.5,1640,6991,1110,530,47.7255,-122.327
350000,3,1,1300,10236,1300,0,47.5028,-121.77
368000,3,1.5,1560,7884,1060,500,47.7312,-122.298
469000,2,1,1120,4284,730,390,47.6688,-122.324
865000,3,2.25,2670,150270,2670,0,47.7601,-122.134
515000,5,2.5,3810,15916,3810,0,47.4521,-122.14
410000,3,1.75,1440,8560,1440,0,47.7296,-122.232
210000,4,1,1200,43560,1200,0,47.3375,-122.123
460000,3,1.75,1520,7700,820,700,47.7226,-122.219
241500,4,2.5,2500,9654,1830,670,47.3137,-122.343
322200,4,2.25,2010,19000,2010,0,47.3734,-122.119
279000,4,1,1210,6000,1210,0,47.5026,-122.234
303000,2,1,1100,27007,1100,0,47.4471,-122.473
420000,3,1.5,1050,6615,800,250,47.6578,-122.39
249000,3,1.75,2120,18335,1380,740,47.451,-122.273
294950,3,1,1240,8840,1240,0,47.7277,-122.308
1.315E+06,4,3.5,3460,3997,2560,900,47.6718,-122.329
335000,3,1.75,1270,4800,1270,0,47.693,-122.361
1.155E+06,4,2.25,2980,8051,2020,960,47.6426,-122.409
520000,2,1,1250,3708,1250,0,47.685,-122.363
560000,4,1.75,1740,8800,1740,0,47.6232,-122.142
243400,4,1.5,1730,7464,1730,0,47.3782,-122.304
405000,3,2,1240,14404,1240,0,47.6614,-122.06
495000,2,1,1670,14695,1670,0,47.7001,-122.2
350000,4,2.5,2140,7095,2140,0,47.3528,-122.057
368500,5,2.75,2530,7601,1520,1010,47.4683,-122.263
99000,2,1,960,8236,960,0,47.4698,-122.166
1.07E+06,4,3.75,4130,12320,4130,0,47.5194,-122.151
430000,4,1.75,1710,7724,1710,0,47.7721,-122.293
412500,3,1.5,1490,8475,1490,0,47.6571,-122.133
1.1225E+06,4,3.25,4750,62365,4750,0,47.7149,-122.099
915000,4,2.5,3400,35062,3400,0,47.7168,-122.113
535000,3,2.5,2210,7620,2210,0,47.6938,-122.13
390000,3,1.5,1650,8676,1130,520,47.7471,-122.352
499000,3,1.5,1260,3135,780,480,47.6693,-122.371
375000,3,1,1960,7955,1260,700,47.7641,-122.364
349000,4,2.5,1800,7620,1800,0,47.4346,-122.201
635000,3,2.25,1940,7482,1240,700,47.6004,-122.195
682000,4,2.75,2820,8009,2820,0,47.6,-121.977
321027,4,2.25,2820,16770,1920,900,47.3186,-122.364
150000,2,1,720,4120,720,0,47.303,-122.217
410000,3,1.75,1640,17583,1110,530,47.726,-122.203
449950,3,2,1560,4080,1560,0,47.6892,-122.319
194990,6,2.5,1560,7144,1060,500,47.5335,-122.272
475000,4,1.75,1910,8775,1210,700,47.7396,-122.247
530000,5,1.75,1570,3000,1570,0,47.6677,-122.316
319950,4,2.5,2038,7643,2038,0,47.3296,-122.18
210000,3,2.25,1720,9435,1220,500,47.2979,-122.377
485000,3,2.75,1670,3330,1670,0,47.6551,-122.36
774000,4,2.75,2830,10240,2830,0,47.5903,-121.986
478000,4,2,1690,8208,1210,480,47.6052,-122.126
385000,4,2.5,1620,5280,1620,0,47.5132,-122.384
595000,4,2.5,2360,43017,2360,0,47.774,-122.077
285000,3,1.5,1480,7117,1170,310,47.7766,-122.248
723000,4,2.5,2700,4004,2700,0,47.5521,-121.995
279000,3,1.5,1780,16000,1240,540,47.419,-122.322
195000,3,1.5,1430,7560,1430,0,47.4518,-122.179
625000,2,1,2160,2192,1170,990,47.6364,-122.371
270000,3,1.75,1800,9314,1800,0,47.7762,-122.198
559000,2,2,1930,5520,1930,0,47.7191,-122.022
474000,4,2.25,1960,14834,1330,630,47.7434,-122.095
303500,4,2.5,1920,7345,1920,0,47.3526,-122.055
350000,3,1.75,1470,8645,1470,0,47.7524,-122.323
367500,5,3,2980,10064,1680,1300,47.7372,-122.316
595000,5,3,2980,10064,1680,1300,47.7372,-122.316
589000,3,2,2360,118483,2360,0,47.5595,-121.867
585000,3,1.75,1790,87213,1790,0,47.732,-122.077
482975,3,2.25,2130,8801,1370,760,47.7462,-122.29
365500,4,2.5,2030,4499,2030,0,47.4511,-122.119
570000,4,2,1790,7800,1790,0,47.6266,-122.103
335000,3,2.5,2260,8040,2260,0,47.3203,-122.184
767500,4,2,2350,4815,1450,900,47.6681,-122.338
386591,3,2.5,1690,1613,1150,540,47.5518,-121.998
279000,3,1,1320,5750,1320,0,47.5288,-122.325
620000,4,2.5,2690,32780,2690,0,47.6612,-121.955
407000,4,2.25,2810,23400,1710,1100,47.395,-122.311
364250,3,2.5,2280,213879,2280,0,47.4213,-122.033
399000,4,2.5,2870,9292,2540,330,47.4522,-122.123
766950,3,2.5,3030,30007,3030,0,47.743,-122.036
710000,4,2.75,2940,4232,2940,0,47.5529,-121.99
320000,3,1,1190,4120,1190,0,47.5513,-122.272
300000,3,2.5,1800,3253,1800,0,47.5401,-122.292
263000,3,1.75,1580,9187,1180,400,47.3538,-122.047
445000,3,2.5,1730,4408,1730,0,47.5683,-122.005
554000,3,2,1910,9001,1910,0,47.6037,-122.119
335000,2,1.75,1000,5100,940,60,47.6787,-122.391
307000,4,2.75,2520,6964,1260,1260,47.4038,-122.175
404000,3,1,1420,8160,970,450,47.7164,-122.306
775000,4,3.5,3080,5250,3080,0,47.5992,-121.972
220000,3,1,1060,9126,1060,0,47.201,-121.999
518000,4,2.5,2160,9750,2160,0,47.7438,-122.246
1.6E+06,4,3.5,4060,9486,4060,0,47.6634,-122.2
315000,1,2.25,1940,2550,1100,840,47.7313,-122.343
572650,4,2.5,2250,11349,2250,0,47.7111,-122.239
350000,2,1,1620,9205,850,770,47.7119,-122.23
285000,2,1,920,5850,920,0,47.5441,-122.304
231000,3,2.5,1370,7247,1370,0,47.3767,-122.303
179000,3,1,920,5200,920,0,47.3603,-122.085
244000,3,1.5,1360,9625,1360,0,47.3799,-122.211
185850,3,1.5,1630,11662,1630,0,47.4455,-122.278
610000,6,2.5,3610,12033,3210,400,47.7692,-122.219
419000,4,2.5,3010,9155,3010,0,47.3542,-122.027
779000,3,1.75,2320,6400,1420,900,47.6449,-122.389
695000,5,3,3290,14134,1870,1420,47.6708,-122.14
319900,3,2.5,2040,7580,2040,0,47.2618,-122.209
329000,3,2.75,1920,7700,1320,600,47.3213,-122.378
475226,3,2.5,2120,4512,2120,0,47.75,-122.183
638000,3,2.5,2170,5000,2170,0,47.5453,-121.996
440000,2,1.5,1330,15873,900,430,47.6359,-122.033
214000,3,2,1580,5080,800,780,47.4963,-122.35
600000,3,2.75,3580,14217,2210,1370,47.3244,-122.379
935000,4,2,2580,4500,1850,730,47.6245,-122.316
630000,4,1.75,1930,10210,1670,260,47.7078,-122.277
575000,3,2.5,2120,4780,2120,0,47.681,-122.032
345000,3,2.5,1990,20466,1410,580,47.3259,-121.896
323000,4,1.75,1310,9690,1310,0,47.7559,-122.226
425000,3,2.5,2670,13218,2670,0,47.3683,-122.153
411000,2,2.25,1910,108900,1010,900,47.4206,-122.023
299800,4,1.5,1530,9000,1530,0,47.6492,-121.908
823000,6,1.75,2920,5000,2780,140,47.6024,-122.295
200000,3,1,1010,8108,1010,0,47.735,-122.309
760000,4,1.75,2450,13300,1630,820,47.5564,-122.13
359950,4,2.5,1820,3899,1820,0,47.735,-121.985
375000,4,2.5,2090,8325,1470,620,47.4888,-122.184
295000,2,1.75,2200,89298,1100,1100,47.4633,-121.976
250000,4,3,2250,7882,1570,680,47.3703,-122.314
497000,3,2.25,1450,1387,1450,0,47.6765,-122.302
520000,4,2.5,2280,8798,2280,0,47.7471,-122.247
365000,4,3.5,2720,6781,2100,620,47.4612,-122.215
459900,3,2.25,2250,8000,1460,790,47.7229,-122.202
158000,3,2,1090,6090,940,150,47.5118,-122.259
294700,3,2,1970,9600,1300,670,47.2824,-122.301
439950,4,2.25,2780,15075,2780,0,47.477,-122.116
899000,4,2.25,2290,40946,1550,740,47.616,-122.103
535000,3,1.75,2330,12141,1390,940,47.7607,-122.146
530000,4,4.5,4060,10800,4060,0,47.4241,-122.29
215000,4,2,1470,7000,1470,0,47.3742,-122.289
290000,2,1,1620,5400,920,700,47.7069,-122.299
798000,5,2.75,3220,5934,3220,0,47.7076,-122.101
785000,4,2.5,3270,9578,3270,0,47.5373,-122.051
433000,3,1.75,2160,8565,1730,430,47.7664,-122.262
425000,2,1,1150,6835,1010,140,47.5567,-122.273
654000,4,2.5,2240,7540,1540,700,47.6965,-122.308
215000,3,1.5,1280,5065,1280,0,47.3343,-122.217
232000,3,1,840,6540,840,0,47.3743,-122.116
675000,3,1.75,1680,10500,1680,0,47.6098,-122.169
665000,5,2.75,2330,8000,1550,780,47.6651,-122.144
835000,4,2.5,3030,29163,3030,0,47.6569,-122.02
525000,6,3,2880,7560,2880,0,47.5959,-122.3
780000,3,2.75,2910,3094,2010,900,47.7071,-122.276
844000,4,3.25,3090,67518,3090,0,47.6674,-122.046
680000,4,2.75,2720,54048,2720,0,47.7181,-122.089
290000,3,1.5,1310,8100,1310,0,47.7328,-122.201
560000,2,1,1790,15783,1360,430,47.691,-122.387
605500,3,2.5,2830,6536,2830,0,47.7462,-122.172
762500,4,2.5,3150,5979,3150,0,47.7082,-122.101
1.74E+06,5,3.25,3930,5500,2910,1020,47.6802,-122.208
665000,6,2.75,2840,8346,1420,1420,47.5518,-122.266
540000,5,1,2480,4400,1640,840,47.6046,-122.3
375000,3,2.5,1930,6180,1330,600,47.7481,-122.327
342000,3,1,1260,6826,720,540,47.731,-122.303
340000,3,1,670,23522,670,0,47.5329,-121.89
1.25E+06,5,3.25,3930,12719,2540,1390,47.5631,-122.213
693000,4,2.5,3160,13063,3160,0,47.5996,-122.021
638500,4,1.75,1770,12462,1770,0,47.4355,-122.338
805000,5,3,2240,18265,2240,0,47.5171,-122.029
250000,3,1,990,8062,990,0,47.4151,-122.334
325000,3,2.5,1580,4698,1580,0,47.3539,-122.025
270000,4,1.75,1560,4290,1560,0,47.5292,-122.323
880000,6,2.5,2640,3680,1760,880,47.5771,-122.38
300000,2,1.75,2120,6350,1440,680,47.6974,-122.356
290000,2,1,1200,8750,1200,0,47.7548,-122.327
2.85E+06,4,4,5040,17208,2870,2170,47.5701,-122.188
259950,3,1,1460,5825,1260,200,47.4958,-122.191
1.78E+06,4,3.25,4890,13402,4890,0,47.5303,-122.131
299950,3,1,1580,5250,1580,0,47.4964,-122.168
483000,3,2.25,2100,43560,1330,770,47.7511,-122.072
890000,3,2.25,2060,8640,2060,0,47.6534,-122.195
719000,3,2.5,1690,4500,1690,0,47.5841,-122.383
785000,4,3,3370,100681,1920,1450,47.4319,-122.148
660000,3,2.5,2330,3995,2330,0,47.5542,-122.001
264000,4,1.75,1820,8118,1080,740,47.4104,-122.172
575000,3,1.75,1890,11141,1890,0,47.5697,-122.163
1.215E+06,4,3.75,3820,53574,3820,0,47.7337,-122.121
475000,3,2.5,2770,98881,2770,0,47.2568,-121.952
845800,4,3.5,3020,12750,3020,0,47.6524,-122.184
352500,3,1.75,1170,8182,1170,0,47.7368,-122.298
347000,3,1,1270,8400,1270,0,47.7604,-122.198
560000,4,2.75,1950,6192,1950,0,47.5698,-121.999
323000,4,2.75,2230,50094,1330,900,47.2576,-122.099
595000,3,1.75,2220,22081,2220,0,47.4693,-122.364
257500,4,2,2060,6400,1170,890,47.2924,-122.197
450000,3,1,1100,4600,1100,0,47.5686,-122.385
410000,4,1,1140,7208,900,240,47.742,-122.173
810000,3,1.75,1980,13503,1320,660,47.5867,-122.111
372500,5,3,2480,10090,1300,1180,47.4964,-122.263
325000,3,1,1050,9083,1050,0,47.7533,-122.307
280000,3,1,1260,7660,1260,0,47.7476,-122.35
258000,3,2,1680,19978,880,800,47.3924,-122.308
329950,4,1,1360,5900,1360,0,47.7512,-122.318
836000,4,2.5,2450,12987,2030,420,47.6197,-122.15
365000,5,2.5,2260,7040,2260,0,47.352,-122.038
111300,2,1,1060,6000,1060,0,47.3066,-122.223
864000,4,2.5,3720,105850,3720,0,47.655,-122.029
725000,3,1.75,1610,8613,1610,0,47.6527,-122.195
550000,4,2.5,3350,6605,2670,680,47.7498,-122.181
130000,2,1,790,7500,790,0,47.4007,-122.294
765000,2,1.75,1660,4000,990,670,47.6394,-122.28
255000,3,1.5,1420,7480,1420,0,47.4651,-122.184
439500,3,2.5,2050,40003,1570,480,47.47,-122
268000,3,1.75,1250,5546,1250,0,47.4725,-122.187
985000,3,1.75,1700,8534,1700,0,47.6276,-122.205
751305,4,2.5,2660,8469,2660,0,47.5529,-122.12
280000,3,1,1350,7553,1350,0,47.5345,-122.274
304000,4,2,1810,8750,1110,700,47.4307,-122.17
200000,4,2.75,2210,13235,1730,480,47.3541,-122.303
325000,3,1.5,2120,41325,1420,700,47.2906,-122.055
736000,3,2.25,2470,11603,1540,930,47.6569,-122.123
426500,4,2.5,2700,6515,2700,0,47.4356,-122.11
640000,2,1.75,1760,4400,880,880,47.65,-122.34
230000,5,2,1930,6120,1930,0,47.5073,-122.337
366350,4,1,1680,5043,1680,0,47.5354,-122.273
365000,2,1,1390,8336,910,480,47.4646,-122.361
482000,4,2.25,2240,8322,2240,0,47.728,-122.206
345000,4,1,1980,7991,1980,0,47.4604,-122.17
682000,3,1.75,1830,5120,1830,0,47.6051,-122.311
657500,3,1.75,980,6002,980,0,47.6643,-122.203
895000,6,2.5,3550,6533,3550,0,47.5719,-122.284
425000,3,1.5,1660,5665,920,740,47.5391,-122.274
532500,4,2.5,2490,8750,2040,450,47.5931,-122.116
540000,4,2.5,2329,9436,2329,0,47.7366,-122.204
578000,3,2.25,1790,9580,1790,0,47.5541,-122.162
1.086E+06,3,3,2830,6041,1840,990,47.5694,-122.283
322500,3,1,1160,9750,1160,0,47.7429,-122.072
140000,3,1,1000,10560,1000,0,47.3217,-122.317
485000,3,2.5,2540,51836,1820,720,47.389,-122.088
575000,2,1.5,1750,19709,1440,310,47.3351,-122.044
421000,3,2.5,2890,21780,2890,0,47.4326,-122.286
355000,4,2,1870,3497,1200,670,47.5309,-122.347
515000,4,2.25,2200,6967,2200,0,47.7355,-122.202
309000,3,1,1300,7200,1300,0,47.5063,-122.369
815000,5,2.25,3410,35536,2530,880,47.65,-122.155
285000,3,1,1160,7875,1160,0,47.724,-122.323
700000,3,1.75,2100,5000,2100,0,47.6776,-122.36
289000,3,2.5,1490,8628,1490,0,47.3643,-122.041
458000,4,3,3280,62726,3280,0,47.7509,-122.056
230000,3,1.75,1450,8378,1450,0,47.3093,-122.385
432500,3,2.5,1930,7120,1420,510,47.7715,-122.34
288000,3,1.75,1660,10440,1040,620,47.4448,-121.77
354000,3,1.75,1260,12330,1260,0,47.7412,-122.095
119500,3,1,1170,11000,1170,0,47.7346,-121.983
805000,4,3,3350,23781,2020,1330,47.56,-122.132
435000,3,2.5,1420,2581,1420,0,47.7027,-122.357
260000,3,1.75,2170,10018,1630,540,47.3087,-122.264
377000,4,1.75,1800,8385,900,900,47.7744,-122.338
602000,4,2.5,2000,7376,2000,0,47.5719,-121.999
530000,3,1.75,1660,4800,960,700,47.5734,-122.412
525000,4,2,1540,3740,770,770,47.6886,-122.375
250000,2,1.5,1160,1086,890,270,47.768,-122.315
681000,3,1,1700,6356,1700,0,47.5677,-122.281
625000,3,1.75,1580,20588,1580,0,47.706,-122.29
448500,3,2.5,2080,3920,2080,0,47.5412,-122.286
260000,3,2,1030,7260,1030,0,47.5113,-122.347
538000,3,1.75,1770,8050,1020,750,47.5862,-122.118
385500,3,2,1540,7947,1120,420,47.7605,-122.217
428400,4,2.5,2650,6000,2650,0,47.3768,-122.028
346290,4,2.75,2690,9240,2690,0,47.1896,-122.014
587000,4,2.75,2210,8430,2210,0,47.5994,-122.017
355000,4,2.5,2390,6775,2390,0,47.4811,-122.182
650000,5,2.75,2580,7865,1480,1100,47.6208,-122.139
340000,4,2.5,2160,5455,2160,0,47.4799,-122.183
565000,4,2.5,2230,8624,1430,800,47.6623,-122.152
630000,4,2,2000,5000,2000,0,47.5787,-122.293
227000,3,1,1280,7198,1280,0,47.2094,-121.996
600000,4,2.75,2810,17674,1640,1170,47.6745,-122.144
540400,4,1.75,1680,6758,1680,0,47.641,-122.113
569000,3,2.5,2150,8060,2150,0,47.6952,-122.188
735000,3,2.5,2820,8159,2820,0,47.5527,-121.992
434000,3,2.25,1750,9353,1210,540,47.7305,-122.225
578888,2,2,1060,4000,1000,60,47.6626,-122.337
465425,4,2.75,2430,20720,2430,0,47.775,-122.139
280500,4,2.75,2660,7754,1590,1070,47.3078,-122.337
539950,2,2,1670,3507,1670,0,47.5545,-122.003
406430,3,2,1380,15426,1380,0,47.5951,-122.036
1.15E+06,4,3.75,4160,35000,4160,0,47.669,-122.067
250000,3,2.5,1790,6191,1790,0,47.4102,-122.195
266000,3,2.5,1940,8547,1460,480,47.3491,-122.177
258000,3,2,1390,7200,1390,0,47.434,-122.154
472000,3,2,2200,21890,1200,1000,47.7584,-122.271
530000,3,2.25,1264,1536,1264,0,47.6694,-122.279
302282,2,1,1095,5120,1095,0,47.6058,-122.313
370000,2,1,850,6213,750,100,47.5282,-122.384
625000,4,2,1760,5307,1170,590,47.6714,-122.28
142500,1,1,690,6825,690,0,47.3109,-122.225
334000,3,1.75,1400,7405,1400,0,47.7569,-122.334
362000,5,3,1810,3000,1810,0,47.5622,-122.291
181000,2,1,1310,4000,950,360,47.5798,-122.306
241500,3,1,1400,10425,1400,0,47.2738,-122.301
245000,3,1.75,2350,12720,1180,1170,47.3594,-122.175
227500,3,1,1150,8848,1150,0,47.3626,-122.111
158550,5,1.5,1710,8100,1710,0,47.3839,-122.288
450000,3,2.25,1660,10247,1130,530,47.7262,-122.222
485000,3,1.75,1950,10080,1950,0,47.7282,-122.186
353000,4,1.75,1780,9794,1780,0,47.7419,-122.073
500000,4,3,2450,4668,2450,0,47.7721,-122.235
360000,1,2.25,2060,10600,1560,500,47.3291,-122.304
357500,3,1.5,1540,11858,1540,0,47.4755,-122.157
272000,3,2.5,1650,13816,1650,0,47.6553,-121.912
422000,3,1,1160,7854,1160,0,47.7304,-122.308
365000,2,2,1440,15000,1440,0,47.7648,-122.159
450000,3,1.75,2150,13789,1610,540,47.7591,-122.295
275053,2,1,1060,6504,1060,0,47.7412,-122.327
1.88E+06,3,2.75,2620,17919,2620,0,47.6144,-122.228
725000,3,1.75,1630,9000,960,670,47.6023,-122.205
235000,3,1.75,1840,9697,1500,340,47.3764,-122.179
510000,2,1,820,4206,820,0,47.7076,-122.284
489950,2,1,820,4206,820,0,47.7076,-122.284
463000,3,2.5,2010,4195,2010,0,47.732,-122.197
536000,4,2.25,1990,5948,1990,0,47.5712,-121.995
375000,4,2.5,2990,6145,2990,0,47.2612,-122.294
630000,4,2.5,2540,4727,2540,0,47.7034,-122.236
362000,3,2.25,1640,14374,1140,500,47.4476,-122.332
350000,4,2.75,2500,11659,1490,1010,47.3381,-122.332
1.691E+06,4,3.5,4020,13515,4020,0,47.6462,-122.212
255000,3,2,1500,8775,1390,110,47.4809,-122.335
269000,4,2.5,1594,7665,1088,506,47.3262,-122.211
370000,4,3,2130,4838,2130,0,47.4871,-122.203
270000,3,1,1130,7920,1130,0,47.4852,-122.125
265000,3,2,1690,9516,1690,0,47.2132,-122.001
487000,2,1,1440,4046,960,480,47.6901,-122.382
835000,4,3.25,3270,6027,3270,0,47.6346,-122.063
850000,4,3.25,4350,112750,2200,2150,47.5435,-121.966
575000,4,2.75,1610,11201,1020,590,47.7024,-122.198
335000,3,1,950,8000,950,0,47.7193,-122.184
318000,3,1,1010,7200,1010,0,47.7601,-122.307
510000,3,2,1420,11325,1420,0,47.5356,-122.046
242500,3,1.5,1200,9720,1200,0,47.4225,-122.153
750000,5,2.25,2020,8400,1010,1010,47.5763,-122.219
439900,5,3.5,3390,7950,3390,0,47.4792,-122.181
710000,2,1,1700,3040,1460,240,47.6442,-122.369
2.4E+06,5,3.25,3410,9088,2760,650,47.6285,-122.361
435000,3,1.75,2030,13700,1630,400,47.7726,-122.197
874000,4,2.75,2860,6867,1560,1300,47.6723,-122.263
385000,4,1.75,1690,4080,870,820,47.572,-122.289
110000,2,1,760,4746,760,0,47.4836,-122.214
477000,3,1.75,1780,8085,1210,570,47.7357,-122.197
500000,3,2,1550,6394,1550,0,47.5222,-122.379
885000,4,2.5,4090,11225,4090,0,47.581,-121.971
235000,2,1,880,5600,880,0,47.5071,-122.265
210000,3,2.75,1320,15236,880,440,47.365,-122.184
320000,2,1,950,4000,950,0,47.5728,-122.312
406000,3,1.75,1390,7904,1390,0,47.4892,-122.181
350000,3,1.75,1900,10225,1220,680,47.4781,-122.357
350000,2,0.75,1392,43710,1392,0,47.4491,-122.453
720000,4,2.5,3340,8930,3340,0,47.535,-121.867
604700,4,2.75,2750,14982,1720,1030,47.3566,-122.32
343000,3,1,1400,5662,1400,0,47.5271,-122.036
558000,3,2.25,2220,15757,1280,940,47.6212,-122.043
364000,4,1,1210,7740,1210,0,47.5216,-122.374
420000,3,1.75,2390,11242,1290,1100,47.7759,-122.272
450000,5,2,1870,7344,1870,0,47.5951,-122.144
392000,2,1.5,940,5000,810,130,47.5375,-122.374
100000,4,1,1120,2685,860,260,47.4904,-122.203
480000,3,2.5,1250,1103,1250,0,47.6619,-122.352
212000,3,1.5,1060,9225,1060,0,47.3217,-122.318
560000,5,2.5,2410,8960,1600,810,47.7372,-122.2
359950,5,2.75,2844,3990,2844,0,47.3259,-122.167
535000,4,2.5,2200,110642,1330,870,47.7409,-122.052
980000,5,4,3460,5400,2830,630,47.5201,-122.204
720000,2,1,1580,2199,1580,0,47.6541,-122.329
619950,2,1,1520,5400,920,600,47.6796,-122.279
489000,3,2.5,2260,19821,2260,0,47.448,-122.088
415000,4,2,1800,2970,1000,800,47.6833,-122.312
672500,4,2.5,2650,11108,2650,0,47.6304,-122.051
352500,3,1,1000,4171,1000,0,47.6834,-122.097
258750,4,2,2300,8400,1150,1150,47.3282,-122.332
350000,3,1,1080,7000,1080,0,47.7637,-122.351
152000,3,1,902,10464,902,0,47.363,-122.308
378500,2,1,730,7528,730,0,47.6997,-122.305
1.017E+06,4,1.75,2600,41041,2600,0,47.6634,-122.172
419000,3,1.5,1570,6700,1570,0,47.6022,-122.134
895000,5,3,2876,13927,1970,906,47.5528,-122.229
668500,4,2.25,2290,9546,1780,510,47.5617,-122.13
487000,2,2.5,1470,2533,1470,0,47.6874,-122.165
538000,3,3.5,2620,10137,1970,650,47.4979,-122.371
898000,5,1.5,2680,28014,1450,1230,47.6348,-122.196
315000,4,2,2020,7767,2020,0,47.3391,-122.309
800000,3,2.5,2100,4440,2100,0,47.5865,-122.397
516130,3,1.75,1510,8250,1510,0,47.6183,-122.113
1.6E+06,3,2.5,2850,19593,1790,1060,47.5894,-122.111
1.2E+06,4,2.5,4280,12796,3400,880,47.5588,-122.124
355425,4,2.5,3238,9112,1678,1560,47.4005,-122.311
1.1574E+06,3,2.5,2740,5925,2740,0,47.6313,-122.303
689000,4,2.5,2020,9600,2020,0,47.5434,-122.395
500000,3,3.25,1520,1500,1520,0,47.67,-122.389
430000,5,2.5,3860,42733,2300,1560,47.3117,-122.254
299500,4,2.25,1600,15312,1080,520,47.4629,-121.743
349950,4,2.5,2090,5289,2090,0,47.4289,-122.164
1.419E+06,5,3.25,4020,4500,3120,900,47.6349,-122.204
998000,4,2.25,2910,10189,2910,0,47.5465,-122.155
329000,3,1,900,9600,900,0,47.7423,-122.173
575000,3,1.75,1720,5956,1720,0,47.6875,-122.202
529900,5,2.25,3030,9430,2600,430,47.7515,-122.353
1.47E+06,4,2.5,3030,10189,2380,650,47.6367,-122.206
725000,4,1.75,2190,9400,1450,740,47.6531,-122.196
286000,3,2.5,1680,5000,1680,0,47.3196,-122.395
335000,3,2,1210,9926,1210,0,47.5731,-122.135
395300,3,1.5,1120,7000,1120,0,47.5987,-122.146
510000,4,2.75,3180,13348,3020,160,47.7439,-121.977
203000,3,1,920,7500,920,0,47.3791,-122.289
248000,2,1,700,8301,700,0,47.7712,-122.323
265000,3,2.25,2540,7216,2540,0,47.2906,-122.349
1E+06,4,1.5,2100,4560,2100,0,47.6497,-122.336
1E+06,3,1,1540,24500,1540,0,47.7213,-122.29
241400,3,2,1420,9828,1420,0,47.3287,-122.011
309950,4,1.75,1450,10074,1450,0,47.4546,-122.182
294010,3,1.75,1550,4057,830,720,47.5291,-122.351
345000,3,2.25,1920,9672,1920,0,47.6233,-122.046
625000,3,2.25,1920,9672,1920,0,47.6233,-122.046
660000,4,2.5,2510,4543,2510,0,47.5962,-122.039
559000,2,2,1660,4500,1660,0,47.7094,-122.031
866000,4,3.25,3990,9786,3990,0,47.6784,-122.026
770000,3,2,2350,5700,1810,540,47.639,-122.31
259950,3,1.5,1350,7827,1350,0,47.3786,-122.219
352000,5,2.75,2980,9838,1710,1270,47.3807,-122.222
2.46635E+06,5,4.75,6390,13180,4560,1830,47.6312,-122.291
395000,3,2,1590,10229,1590,0,47.7239,-122.227
276500,4,1.75,1400,6650,1400,0,47.4888,-122.332
530000,3,2.25,1880,100623,1880,0,47.5342,-121.883
798000,4,3.25,3500,10260,3500,0,47.5902,-122.13
380000,2,2,1370,5756,1370,0,47.714,-122.205
350000,4,2.5,2810,10433,2810,0,47.1895,-122.015
325000,3,2.5,2220,6049,2220,0,47.3972,-122.182
336000,3,2.5,2110,4549,2110,0,47.3885,-122.154
286900,3,2.25,1720,17235,1440,280,47.3438,-122.073
472000,5,2.25,1780,7245,1330,450,47.6946,-122.12
263000,3,1.75,1410,8100,1410,0,47.3617,-122.046
565000,3,3,2110,4000,1110,1000,47.5696,-122.375
765000,3,2.5,2700,8444,2700,0,47.5597,-122.113
1.517E+06,3,2.25,2610,9409,2610,0,47.5789,-122.076
405000,3,2,1660,8174,830,830,47.7103,-122.199
1.098E+06,4,3.5,4570,16219,4570,0,47.5859,-121.968
555000,3,3,3760,188760,2640,1120,47.308,-122.087
305000,3,2.5,1610,3516,1610,0,47.4491,-122.188
289950,3,2.25,1740,9370,1390,350,47.391,-122.316
487500,5,3.5,3530,218472,2380,1150,47.7309,-121.905
96500,3,1,840,12091,840,0,47.3281,-122.343
185000,3,1,840,12091,840,0,47.3281,-122.343
150550,4,1,1470,6061,1470,0,47.4819,-122.289
339000,4,2,2470,5080,1970,500,47.5308,-122.348
675000,4,1.75,2220,7230,1280,940,47.7065,-122.279
615000,3,1.75,1720,4080,960,760,47.5747,-122.287
837500,4,2.5,2700,9320,2700,0,47.6861,-122.198
250000,2,1,950,11835,950,0,47.7494,-122.237
583000,3,2.5,1790,8144,1790,0,47.6169,-122.045
499000,3,2.5,1610,1728,1610,0,47.6776,-122.318
550000,3,2.5,2290,6328,2290,0,47.5103,-122.382
400000,4,2.5,2170,204296,2170,0,47.281,-121.933
990400,3,2.5,2100,4097,2100,0,47.5983,-122.2
600000,3,2.5,2320,52272,2320,0,47.587,-122.068
325000,2,1,1120,6236,1120,0,47.763,-122.291
265000,3,2.5,1530,6000,1530,0,47.3487,-122.036
1.6205E+06,3,2.5,3490,9362,1770,1720,47.6605,-122.27
347500,3,1.5,1180,8353,1180,0,47.7652,-122.274
629000,5,2,2050,3000,1470,580,47.6864,-122.352
1.0875E+06,2,2,2360,11340,2360,0,47.5835,-122.227
397500,4,2.5,2570,7859,2570,0,47.3736,-122.045
404500,2,1,1270,3700,1270,0,47.5949,-122.307
225000,3,1.5,1250,7500,1250,0,47.3719,-122.215
267000,3,2.25,2510,9900,1610,900,47.2988,-122.374
800000,4,3.75,2690,4000,2120,570,47.6418,-122.372
339000,4,2.5,2900,6918,2900,0,47.3504,-122.284
1.85E+06,4,2.5,3830,11972,2370,1460,47.7404,-122.284
525000,5,1,1280,3876,1280,0,47.6605,-122.324
1.15E+06,5,3.5,4350,6218,3520,830,47.5396,-121.997
565000,1,1,1370,6250,1370,0,47.5571,-122.385
387000,2,2.25,1230,1280,960,270,47.5942,-122.298
720000,4,2.5,2440,34290,2440,0,47.6685,-122.044
1.5E+06,4,3.5,4410,12426,3420,990,47.5518,-122.107
235000,2,1,910,7617,910,0,47.7332,-122.305
365000,2,1,910,7617,910,0,47.7332,-122.305
368250,3,2.5,2150,7484,2150,0,47.6191,-122.043
580000,3,2.5,2150,7484,2150,0,47.6191,-122.043
1.1E+06,4,3.25,3190,11774,2610,580,47.5033,-122.225
215000,4,2.5,2130,4496,2130,0,47.3041,-122.28
648000,4,2.5,2740,9959,2740,0,47.5672,-122.011
705000,4,3,3150,9318,3150,0,47.5959,-122.018
465000,3,2.25,1450,1540,1180,270,47.6685,-122.365
650000,5,2,2400,3500,1900,500,47.6762,-122.356
335000,4,2.25,2280,7500,1140,1140,47.4182,-122.332
640000,4,2,2310,31850,2310,0,47.7713,-122.122
638250,4,2.5,2460,8029,2460,0,47.6262,-122.03
1.46E+06,4,3.5,4200,14353,3640,560,47.5331,-122.217
375000,4,2,1620,4600,1620,0,47.5533,-122.307
842000,4,1.75,2170,9525,2170,0,47.5685,-122.217
499950,3,2.25,2880,7200,1710,1170,47.7707,-122.35
810000,4,2.5,3280,25211,3280,0,47.6398,-122.05
310000,5,2,2900,11970,2900,0,47.741,-122.095
730000,3,2.5,2160,8809,1540,620,47.6994,-122.349
637800,4,1.75,2250,4750,1420,830,47.6738,-122.292
225000,3,1,1340,4800,1340,0,47.477,-122.209
417500,4,1,1390,10800,1390,0,47.7248,-122.359
265000,4,2,1600,10160,1600,0,47.2015,-122.003
550000,4,2.5,2050,8683,2050,0,47.62,-122.043
625700,3,2,2570,159865,2570,0,47.5547,-121.892
595000,3,2.5,2660,10637,2660,0,47.7383,-122.22
270000,3,1.5,1540,13475,1540,0,47.4766,-122.153
739375,5,3,2640,3200,2140,500,47.6188,-122.308
357562,2,1.75,1210,1032,1210,0,47.5522,-121.999
1.01E+06,4,2.5,3760,29224,3760,0,47.7203,-122.128
455000,2,1.75,1350,4286,1350,0,47.7171,-122.033
310000,5,2.25,2600,9600,1810,790,47.3257,-122.365
415000,3,2.75,3900,111514,3460,440,47.5621,-121.924
452000,2,1,1340,8100,1340,0,47.7212,-122.364
810000,3,2,1760,16928,1760,0,47.6363,-122.202
730001,3,2,1840,4750,1010,830,47.6862,-122.395
825000,3,2.25,2980,86636,2230,750,47.6627,-122.003
665000,3,2.5,1730,3000,1730,0,47.6532,-122.34
327500,4,1.75,1650,7800,1650,0,47.4507,-122.139
699950,3,2.5,3370,36218,3370,0,47.5855,-121.987
424000,3,2.5,2200,34680,2200,0,47.3139,-122.116
657000,4,2.5,2180,3375,1420,760,47.6846,-122.361
445000,3,1.75,1490,10844,1210,280,47.6208,-122.106
450000,3,2.5,1530,762,1050,480,47.642,-122.374
350000,3,1,1180,7455,1180,0,47.7276,-122.241
460000,4,2.5,2080,17532,2080,0,47.4835,-122.136
385000,4,2.5,3200,22651,1610,1590,47.3931,-122.183
272000,4,2.25,1880,6160,1880,0,47.3214,-122.347
535000,3,2.5,2510,5544,2510,0,47.6903,-122.042
216500,2,1,1060,5200,1060,0,47.3688,-122.08
325000,3,2.5,2130,12245,2130,0,47.3406,-122.057
420200,3,1.75,1320,7280,1320,0,47.7229,-122.18
258000,3,1.75,1040,5650,1040,0,47.5111,-122.256
450000,3,2,1150,4500,1150,0,47.6985,-122.348
720168,4,2.25,2120,3794,1420,700,47.6893,-122.359
652000,3,2,2130,5000,1330,800,47.6746,-122.362
569500,4,2.5,2340,8248,2340,0,47.6314,-122.03
411000,4,1.75,2250,292288,2250,0,47.3787,-122.091
524950,3,1.75,1890,3825,1290,600,47.6831,-122.381
153000,2,1,1140,10152,760,380,47.7369,-122.321
775000,3,2.5,2780,5467,2780,0,47.5791,-122.378
338500,4,2.5,2390,6111,2390,0,47.3677,-122.173
570000,3,1.75,2390,9000,1500,890,47.6809,-122.113
653000,3,2,2680,8429,1880,800,47.372,-122.036
435000,2,2.5,1560,1222,1080,480,47.604,-122.307
207000,2,1,1130,8160,1130,0,47.4997,-122.317
540000,2,1,1120,7500,1120,0,47.619,-122.096
386000,4,2.25,2050,9583,1770,280,47.3978,-122.313
265000,5,2.25,2600,8075,2600,0,47.2961,-122.188
250000,3,2.25,1050,572,740,310,47.5549,-122.363
1.697E+06,3,2,2600,6600,1930,670,47.6055,-122.285
455000,4,2.5,2811,7251,2811,0,47.3686,-122.058
1.795E+06,4,3.25,4060,13000,4060,0,47.581,-122.246
759000,3,2,2260,7200,1130,1130,47.5886,-122.288
970000,4,2.75,4430,74358,4430,0,47.6392,-121.988
280000,1,0,600,24501,600,0,47.5316,-121.749
690000,3,2.25,2430,8327,1430,1000,47.5534,-122.16
789900,3,2.5,3420,25150,1750,1670,47.5706,-122.152
447500,2,1,1180,5100,1180,0,47.6947,-122.346
440000,4,2.25,2010,7575,1220,790,47.7328,-122.2
278000,3,2,1230,7789,1230,0,47.3718,-122.073
980000,5,2.5,2750,6000,1750,1000,47.6729,-122.334
245000,3,2.75,1300,14197,860,440,47.3652,-122.183
287000,3,1.5,1150,11475,1150,0,47.4629,-121.744
435000,3,1.75,2220,132858,1110,1110,47.4853,-122.034
585000,3,2.5,2050,11690,2050,0,47.5279,-122.161
616000,4,1.75,1700,5846,1700,0,47.6539,-122.408
203000,3,1.75,1610,9000,1100,510,47.3187,-122.179
860000,4,2.75,2720,3840,1790,930,47.6624,-122.361
833000,4,2.5,2190,12690,1170,1020,47.6627,-122.189
565000,4,2.75,2730,6856,2730,0,47.7739,-122.164
572500,3,2.5,2490,7589,2490,0,47.5355,-122.179
254000,4,2,1510,4235,1510,0,47.546,-122.293
1.525E+06,4,4.25,4720,21000,4720,0,47.7591,-122.376
900000,4,3,3810,217800,3810,0,47.7696,-122.021
899000,3,2.5,1950,3730,1950,0,47.6731,-122.199
560000,3,2,1300,6000,1300,0,47.5482,-122.392
512500,3,1.75,1610,7200,1180,430,47.5966,-122.144
775000,4,2.5,2040,5000,1180,860,47.6786,-122.36
200000,2,1,700,4700,700,0,47.4953,-122.169
172000,3,1,970,4700,720,250,47.5285,-122.354
219900,3,1,910,6000,910,0,47.5065,-122.338
641200,3,1,1060,9123,1060,0,47.6218,-122.193
473000,5,3.25,2180,7200,2180,0,47.7078,-122.234
540000,3,1.75,2050,9580,1400,650,47.6212,-122.038
295000,2,1,750,4500,750,0,47.607,-122.297
370000,3,1,800,2296,800,0,47.6546,-122.356
1.727E+06,4,2.25,3470,8000,2360,1110,47.6149,-122.287
275000,3,1.5,1390,48257,1390,0,47.5603,-121.894
89000,3,1,900,4750,900,0,47.3026,-122.363
175000,2,1.75,1050,9800,1050,0,47.7595,-121.473
490000,3,2.5,2410,11900,1600,810,47.3384,-122.34
342400,3,2.25,1180,9630,1180,0,47.7352,-122.232
345000,3,1,1140,4200,1140,0,47.6012,-122.296
399000,2,1,700,3400,700,0,47.6212,-122.296
550000,4,2.5,2060,9719,1320,740,47.5549,-122.176
652450,3,2.25,2230,11835,1630,600,47.563,-122.178
438000,2,2.25,1950,29347,1350,600,47.739,-122.351
605000,3,1.75,2100,5058,1340,760,47.5743,-122.378
395000,4,2.5,2130,11733,1330,800,47.512,-122.16
449950,3,2,1880,3048,1880,0,47.6031,-122.303
651100,4,2.5,2310,5526,2310,0,47.6299,-122.02
241000,3,1,880,6050,880,0,47.4995,-122.248
3.4188E+06,5,5,5450,20412,5450,0,47.6209,-122.237
268500,2,1.5,1290,1749,660,630,47.6118,-122.116
200000,2,1,1010,7200,1010,0,47.4815,-122.339
400375,4,1.75,1690,7680,890,800,47.5296,-122.375
429000,2,1.75,1350,6315,1350,0,47.7141,-122.032
230000,3,1,680,2400,680,0,47.5982,-122.299
1.2E+06,4,2.25,2860,10702,2860,0,47.6451,-122.189
314200,1,1,610,6000,610,0,47.6911,-122.367
513000,4,2.5,2660,8887,1880,780,47.439,-122.342
535000,2,1,1390,5346,960,430,47.5567,-122.279
420000,6,3,2290,6344,2290,0,47.565,-122.37
345950,3,2.5,2110,4118,2110,0,47.3878,-122.153
483500,3,2,1200,2016,600,600,47.5811,-122.404
695000,4,2.25,2360,2500,1520,840,47.6771,-122.358
295000,4,2.5,2350,8906,2350,0,47.4205,-122.215
434975,3,2.25,1590,9960,1060,530,47.7742,-122.287
513000,3,2.5,1810,4592,1810,0,47.5764,-121.996
360000,3,1.75,1900,11407,1900,0,47.7455,-122.294
234900,3,1,1250,8000,1250,0,47.5065,-122.337
963000,4,3.5,3280,6603,3280,0,47.5642,-122.126
595000,2,1.5,870,4800,870,0,47.6509,-122.37
942500,4,3.25,3570,14408,3570,0,47.536,-121.857
1.029E+06,4,3.25,3780,11200,3780,0,47.521,-122.15
350000,3,1,1190,3600,1190,0,47.5985,-122.298
416500,4,2,2280,39848,2280,0,47.5003,-122.465
209900,3,1,1030,60720,1030,0,47.375,-122.166
802000,3,1.75,2870,5000,1840,1030,47.5788,-122.292
230000,4,1.5,1520,8800,1520,0,47.3136,-122.208
489000,3,3,3700,10375,3700,0,47.4286,-122.291
497000,3,1.5,2240,28750,1620,620,47.7137,-122.254
250000,3,2.25,1920,7738,1520,400,47.4562,-122.33
925000,3,3,2560,3600,2110,450,47.633,-122.37
390000,4,2.5,1840,15496,1840,0,47.4683,-122.07
415000,3,2.75,2080,9600,2080,0,47.7698,-122.238
785000,3,2,1600,9638,1600,0,47.5753,-122.224
575000,3,2,2168,4000,2168,0,47.6561,-122.325
170000,2,1,860,8636,860,0,47.5081,-122.356
750000,4,1.75,2100,3400,1100,1000,47.6429,-122.371
230000,3,1,1140,9639,1140,0,47.3112,-122.265
855000,4,3,3090,35074,3090,0,47.6359,-122.159
235000,3,1,1330,45738,1330,0,47.436,-122.185
335000,2,1,1360,69260,1360,0,47.5229,-121.838
1.195E+06,5,3,3420,18129,2540,880,47.5333,-122.217
677000,4,2,2180,6000,2060,120,47.5958,-122.306
575000,3,2,1800,5000,1600,200,47.5447,-122.389
450000,2,1,1120,4590,1120,0,47.5663,-122.285
817250,3,2.5,2980,7202,2980,0,47.6769,-122.177
440000,4,2.25,2600,28600,1810,790,47.7757,-122.139
526000,2,2,1550,2400,1550,0,47.654,-122.346
762500,3,2.25,3330,15258,3330,0,47.7262,-122.06
325000,4,2.5,2200,7719,2200,0,47.3649,-122.194
840000,4,3.5,3840,85728,3840,0,47.615,-121.954
377500,2,1,840,4500,840,0,47.5441,-122.39
212500,3,1.5,1270,7128,1270,0,47.422,-122.321
749400,4,2.5,3240,20301,3240,0,47.719,-122.114
663000,3,2.5,2480,37843,2480,0,47.4003,-122.422
1.476E+06,3,2.25,4470,22518,3240,1230,47.574,-122.18
261000,3,1,1780,7800,1060,720,47.4932,-122.263
515000,4,2.5,1850,9248,1850,0,47.735,-122.244
410000,3,2.25,2200,16921,2200,0,47.3727,-122.051
336000,3,2.25,2760,10160,2760,0,47.4504,-122.15
440000,2,1,1090,4128,1090,0,47.696,-122.314
908950,4,2.75,3090,6200,3090,0,47.5538,-122.189
554000,2,1,820,3700,820,0,47.588,-122.251
387000,3,2.25,1445,1606,1300,145,47.5348,-122.072
268643,4,2.25,1810,9240,1810,0,47.4362,-122.187
514000,3,1.75,1620,5000,920,700,47.681,-122.372
420000,2,1.75,1060,4182,1060,0,47.6787,-122.308
199000,3,1.75,1050,9871,1050,0,47.3816,-122.087
225000,3,1,1010,15701,1010,0,47.4518,-122.292
320000,4,2.5,2050,8424,2050,0,47.196,-122.011
204995,2,1,970,8185,970,0,47.4025,-122.201
376000,3,2,1540,1827,1540,0,47.5479,-121.999
705000,4,2.75,3000,6222,3000,0,47.5582,-122.025
725995,4,2.5,3190,7869,3190,0,47.5317,-121.866
285000,4,2.5,1870,8190,1100,770,47.4521,-122.161
285000,4,2.5,2200,9397,2200,0,47.3406,-122.269
731000,4,2.5,3070,5936,3070,0,47.5902,-121.988
1.56435E+06,4,3.75,3730,17000,2820,910,47.5355,-122.242
510000,4,2.5,2440,10423,2440,0,47.725,-122.172
620000,2,1,990,4332,990,0,47.6528,-122.331
1.11E+06,3,4,4160,31796,4160,0,47.6635,-122.017
796000,4,3.5,3670,4960,2870,800,47.7022,-122.374
255000,3,1.5,910,25500,910,0,47.4565,-122.276
807000,3,2.5,1940,4000,1940,0,47.659,-122.398
315000,4,2.5,1780,6000,1780,0,47.3774,-122.027
637000,3,2.25,2200,7355,2200,0,47.7266,-122.103
2.725E+06,4,4.25,6410,43838,5610,800,47.5703,-122.28
490000,3,2,2070,10023,1220,850,47.6492,-122.062
253000,3,1.75,2040,7281,1020,1020,47.4681,-122.282
325900,4,2.5,2320,6270,2320,0,47.3501,-122.14
425000,2,2,1440,6677,870,570,47.5513,-122.264
215000,4,2.5,1700,6675,1700,0,47.3638,-122.053
315000,4,2.5,1700,6675,1700,0,47.3638,-122.053
724800,3,2,2050,3933,1180,870,47.6436,-122.303
295000,2,1,800,6500,800,0,47.7621,-122.358
509007,3,1.75,1800,7620,1350,450,47.7165,-122.361
306000,5,2,1460,169448,1460,0,47.3714,-122.177
205000,3,1.75,1290,7210,1290,0,47.2889,-122.363
275000,3,1.5,1900,9737,1200,700,47.4125,-122.207
685000,3,1.75,1480,7000,1480,0,47.6018,-122.291
465000,4,2.5,2090,12833,1220,870,47.7266,-122.175
560000,4,2.25,1950,9800,1330,620,47.666,-122.178
458500,3,1.75,1250,9605,1250,0,47.6325,-122.121
354000,3,1,990,7590,990,0,47.6228,-122.121
441000,3,2.5,2740,7923,2740,0,47.4349,-122.105
194000,3,1.75,1260,10488,1110,150,47.5417,-122.357
316500,4,2.5,2150,6807,2150,0,47.4053,-122.189
524950,3,1.75,1750,3250,1230,520,47.6807,-122.366
1.052E+06,3,2.25,2880,6092,1920,960,47.5878,-122.381
925000,4,2.25,2590,13894,2590,0,47.6351,-122.165
780000,3,1.75,2430,4524,1830,600,47.674,-122.35
241000,2,2,1470,3128,1470,0,47.349,-122.021
519000,3,2.75,2020,10744,1270,750,47.4403,-122.343
286000,2,1,610,4000,610,0,47.5469,-122.391
400000,3,2,3000,17800,1500,1500,47.7058,-122.315
255000,2,1,920,43560,920,0,47.5245,-121.931
152000,3,1.75,1070,7754,1070,0,47.5079,-122.344
599000,4,2,3410,15143,3410,0,47.6709,-122.052
330000,4,2.5,1820,3905,1820,0,47.7346,-121.985
461000,2,1,1060,7193,1060,0,47.7102,-122.356
620000,5,2.5,3070,34991,3070,0,47.4721,-122.148
352500,4,2.5,2300,219106,1840,460,47.4044,-121.963
435000,3,2,1610,6911,1260,350,47.7188,-122.177
725000,5,2.75,2830,5310,2830,0,47.7074,-122.101
300000,3,1,970,12300,970,0,47.7335,-122.227
252000,3,2.5,1680,8284,1680,0,47.3609,-122.048
464625,4,2.75,2040,8996,1260,780,47.666,-122.185
340000,3,1,1450,9586,1450,0,47.7443,-122.326
1.325E+06,4,2.25,2870,6280,1980,890,47.6329,-122.31
455000,5,2,1870,13970,1120,750,47.5243,-122.042
495000,4,3.5,2490,18042,2490,0,47.4161,-122.441
925000,4,2.5,3350,4501,2640,710,47.688,-122.379
587000,4,2.75,3190,8737,3190,0,47.523,-121.877
524000,3,1.75,1560,5520,780,780,47.6515,-122.399
1.03E+06,4,2.5,2750,4800,1960,790,47.6709,-122.337
176000,2,1,920,2332,920,0,47.3779,-122.32
249900,2,1,1140,5500,1140,0,47.5187,-122.363
499500,3,2.5,2520,53143,2520,0,47.743,-121.925
600000,5,3.5,3150,10542,1620,1530,47.7469,-122.217
294000,4,2.5,2040,7800,2040,0,47.473,-122.293
272000,4,2,1780,19843,1780,0,47.4414,-122.154
390000,3,2.5,2240,10800,2240,0,47.7433,-122.229
700000,4,2.5,3270,9650,2320,950,47.409,-122.333
635000,5,2.75,3110,6621,3110,0,47.543,-121.888
920000,4,1.5,1850,3600,1660,190,47.6376,-122.307
500000,3,1.75,1570,8530,1190,380,47.6881,-122.184
263500,2,1,750,4515,750,0,47.5198,-122.351
975000,4,2.25,2240,9990,2240,0,47.5516,-122.217
575000,3,2.5,1870,3485,1870,0,47.5493,-122.004
822000,4,2.5,2683,40386,2683,0,47.6982,-122.138
300000,3,1,1490,7200,1490,0,47.7276,-122.307
487600,4,2.5,2340,12080,2340,0,47.7325,-121.969
500000,4,2,1700,8640,850,850,47.5774,-122.153
680000,2,2,1450,989,1450,0,47.6354,-122.346
419000,3,2.5,3310,21096,3310,0,47.3049,-122.386
450000,4,1.75,1520,5250,1520,0,47.6581,-122.39
650000,5,1.75,1260,4500,1260,0,47.6452,-122.369
550000,3,1.75,1840,8086,1840,0,47.67,-122.155
330000,4,2,1750,5202,1070,680,47.5677,-122.317
282510,4,1,1450,32234,1450,0,47.3818,-122.21
2.385E+06,4,4,6330,13296,4900,1430,47.6488,-122.201
230000,2,2,1260,10200,1020,240,47.2593,-122.312
750000,4,1.75,2100,6613,2100,0,47.567,-122.385
321000,4,2.5,2430,5366,2430,0,47.3352,-122.19
2.196E+06,4,3.25,4250,18000,3350,900,47.5612,-122.229
245000,4,2,1830,10416,1370,460,47.4878,-122.341
510000,2,1,1310,4000,1310,0,47.6854,-122.329
751000,4,3.25,3090,9571,2370,720,47.7058,-122.131
675000,4,2.5,2560,36601,2560,0,47.5851,-121.992
295000,3,1.75,1930,13350,1930,0,47.3317,-122.365
312000,2,1,1460,6000,1260,200,47.7009,-122.317
730000,3,3,3460,13129,2560,900,47.7315,-122.058
762500,5,3.5,3290,5880,2670,620,47.7067,-122.119
150000,3,1,820,7680,820,0,47.528,-122.359
270000,3,1,1480,7374,760,720,47.7775,-122.336
400000,4,2,1420,9301,1420,0,47.6325,-122.121
650000,3,2.5,2790,6720,2790,0,47.5958,-122.038
530000,2,1.5,1390,5000,970,420,47.5673,-122.401
248000,3,1,950,9400,950,0,47.5746,-122.136
760000,4,3.5,3000,5300,1780,1220,47.6748,-122.279
199000,4,1,1280,10521,1280,0,47.4215,-122.289
240000,2,1,870,8400,870,0,47.4493,-122.282
415000,3,1.5,1360,1795,1360,0,47.6471,-122.397
228000,3,1,1000,16376,1000,0,47.4825,-122.108
525000,4,2.5,2740,12106,1980,760,47.7648,-122.355
399950,3,1.75,1560,5223,810,750,47.7175,-122.288
781000,4,2.5,2590,8571,2590,0,47.691,-122.105
827000,3,2.5,1850,1330,1560,290,47.6831,-122.325
525000,5,2.25,2500,8621,2500,0,47.7379,-122.185
671300,4,2.5,3280,5232,3280,0,47.6798,-122.033
175000,2,1,670,2378,670,0,47.5769,-122.372
1.1E+06,5,2.75,2890,22547,2150,740,47.5476,-122.219
800000,5,2.5,3000,10560,1500,1500,47.6249,-122.206
329950,4,2.5,1920,4600,1920,0,47.3795,-122.023
445000,4,3.25,1960,7200,1960,0,47.7291,-122.218
237000,3,1.75,2000,12208,1140,860,47.3752,-122.236
1.1125E+06,6,4,3600,6224,2610,990,47.6531,-122.405
438900,4,2.5,2740,5700,2740,0,47.3535,-122.026
1.28E+06,9,4.5,3650,5000,2530,1120,47.6604,-122.289
600000,4,2.5,2310,3866,2310,0,47.5498,-121.996
670000,4,2.5,2095,4569,2095,0,47.6603,-122.087
519000,2,2,1560,4823,1560,0,47.7111,-122.032
320000,3,2.25,1880,7350,1390,490,47.4457,-122.123
270000,2,1.5,840,867,840,0,47.6955,-122.304
1E+06,3,2.5,2730,5832,2730,0,47.6216,-122.161
330000,1,1,860,4800,860,0,47.6146,-122.299
657500,3,2,2320,10960,1510,810,47.6157,-122.174
450000,3,1.75,1540,61419,1540,0,47.7663,-122.228
150000,3,1,890,6488,890,0,47.7087,-121.352
792500,4,2.5,4290,175421,4290,0,47.3585,-121.988
540000,3,2.5,1950,13227,1950,0,47.7217,-122.256
229900,3,1,1010,8848,1010,0,47.2742,-122.299
533000,4,2.5,2830,6536,2830,0,47.3888,-122.032
239000,4,1.75,1500,12560,1000,500,47.2918,-122.197
713900,3,2.5,3370,167706,3370,0,47.4379,-122.022
427500,4,2.5,3160,8726,3160,0,47.2582,-122.223
302000,3,1,1110,7000,1110,0,47.754,-122.341
1.15E+06,3,2.5,3830,48743,3830,0,47.5663,-122.125
555000,3,2.5,3160,4270,2650,510,47.7453,-122.194
495000,3,2.25,2100,3000,2100,0,47.595,-122.306
495000,3,1.5,2240,13288,2240,0,47.6762,-122.17
340000,2,0.75,1060,48292,560,500,47.4285,-122.511
464950,4,2.25,2350,36116,2350,0,47.3533,-122.082
320000,4,2.5,1940,7040,1940,0,47.2632,-122.209
440000,1,1,1160,64469,1160,0,47.7433,-122.082
686000,3,1.5,1840,9990,1840,0,47.7145,-122.369
555000,4,1.75,2260,11000,1620,640,47.6224,-122.109
361500,2,1,840,3860,840,0,47.6842,-122.365
1.24E+06,5,3,2830,7500,2460,370,47.6579,-122.277
154950,4,1,1600,10183,1600,0,47.277,-122.211
247200,3,1.75,1370,8719,1370,0,47.3664,-122.087
250000,3,2.25,1960,7414,1490,470,47.2977,-122.374
590300,3,1.5,1470,7200,1470,0,47.5602,-122.28
541125,5,2.75,2740,8426,1370,1370,47.5563,-122.184
310000,2,2.5,1090,923,1090,0,47.5347,-122.071
704111,4,2.75,2460,9520,1680,780,47.7021,-122.233
277500,3,2.25,1820,19602,1820,0,47.331,-122.286
325000,4,2.75,1960,8937,980,980,47.451,-122.278
289200,3,2.25,1760,7023,1760,0,47.7468,-121.98
185000,1,1,720,5000,720,0,47.5289,-122.272
1.445E+06,4,3.5,3470,8580,2500,970,47.6433,-122.403
420550,4,2,1370,8100,1370,0,47.749,-122.312
603000,4,2.25,2370,11310,1550,820,47.7684,-122.289
345000,3,1,1390,2640,1230,160,47.6078,-122.307
650000,3,2,1840,3075,920,920,47.6894,-122.35
589950,5,3,2790,19439,1500,1290,47.4088,-122.089
309950,2,2.25,1460,1607,1460,0,47.5395,-122.369
775000,3,2.5,2620,241200,2620,0,47.4574,-122.01
590000,4,1.5,2230,5109,1330,900,47.6996,-122.31
863500,4,3,3250,2760,2420,830,47.6104,-122.303
517500,3,1,1190,7000,1190,0,47.6453,-122.403
700000,3,3,2090,7440,1290,800,47.6891,-122.331
699000,3,2.5,2580,8154,2090,490,47.7259,-122.361
350000,3,2.5,2100,3574,1690,410,47.7453,-121.984
795000,4,2.5,3160,16564,3160,0,47.6365,-122.04
543000,3,2.5,2090,7640,1360,730,47.7369,-122.338
325000,3,2.5,1570,3143,1570,0,47.7364,-121.969
337500,3,1,1020,6000,1020,0,47.5254,-122.318
425000,2,1,1300,11080,1300,0,47.7281,-122.233
780000,3,2.5,2110,9773,2110,0,47.5628,-122.115
259000,2,1,1210,17389,1210,0,47.5044,-122.148
524400,4,1.75,1990,12950,1850,140,47.5434,-122.166
260000,3,2,1630,8018,1630,0,47.2638,-122.243
273000,2,2,1384,1822,1384,0,47.7525,-122.244
639900,4,2.5,3380,75794,3380,0,47.3511,-122.266
420000,4,2.5,2480,8626,2480,0,47.3185,-122.262
510500,3,1,1270,8000,1270,0,47.5874,-122.136
290000,4,1,1010,7200,1010,0,47.742,-122.325
226000,3,1.75,1490,6269,990,500,47.4917,-122.188
300000,2,1,820,3844,820,0,47.7049,-122.349
407450,3,2,1810,10860,1810,0,47.6393,-121.967
390000,4,2.25,3060,7920,1530,1530,47.4879,-122.245
1.0588E+06,6,2.75,2980,20000,2130,850,47.7599,-122.375
610000,3,2.5,3440,18167,3440,0,47.2909,-122.342
239975,3,2.5,1820,7242,1220,600,47.4318,-122.292
375000,3,2.5,2320,5760,1480,840,47.504,-122.248
742500,4,2.5,2620,4400,2620,0,47.5524,-121.991
450000,4,1.75,2190,11625,2020,170,47.4979,-122.363
300000,3,2.25,1780,10395,1780,0,47.4539,-122.15
216600,3,1.75,2200,7700,1240,960,47.4119,-122.181
525000,3,1.75,1600,6120,1600,0,47.6847,-122.291
455000,4,2.25,2450,21000,1650,800,47.4559,-122.344
390000,4,2.25,2680,35218,2680,0,47.4613,-121.997
450000,3,1.75,1850,8667,880,970,47.7025,-122.198
382000,4,1,1740,4400,1740,0,47.6058,-122.3
287000,3,2.25,1490,9600,1170,320,47.7378,-121.977
460000,4,2,1960,190357,1960,0,47.5538,-121.958
435000,3,2.25,1380,3015,1380,0,47.6783,-122.157
575000,2,1,1510,4032,1310,200,47.6371,-122.393
626700,3,1.5,1410,3600,1410,0,47.6402,-122.357
352000,4,1.5,1440,8680,1440,0,47.502,-122.228
650000,3,1,920,6750,920,0,47.6322,-122.212
197000,3,1,1090,17630,1090,0,47.288,-122.196
340000,8,2.75,2790,6695,1470,1320,47.7565,-122.331
560000,3,2,1840,14985,1840,0,47.6916,-122.158
354000,3,1.75,1340,6300,1340,0,47.7186,-122.218
670000,4,2.5,2570,9086,2570,0,47.6373,-122.064
769000,4,3.5,3010,6202,3010,0,47.5533,-121.993
650000,4,2.5,2160,3139,1080,1080,47.6662,-122.338
650000,3,1.75,2140,9484,1290,850,47.6234,-122.191
289950,4,1.75,2090,7416,1050,1040,47.4107,-122.179
300000,3,1.75,1810,21138,1240,570,47.4674,-122.178
471000,4,1.75,1760,5750,1070,690,47.5521,-122.373
639000,4,2.5,2500,8540,2500,0,47.5759,-121.994
287000,2,1,930,6900,930,0,47.506,-122.242
740000,4,2.5,3030,8335,3030,0,47.578,-122.056
499922,3,2,1460,3000,940,520,47.682,-122.365
675000,4,2.5,2940,14071,2940,0,47.5627,-122.018
738515,5,2.75,3360,9200,3360,0,47.7754,-122.173
445000,3,1.75,2110,4800,1210,900,47.567,-122.318
1.039E+06,4,2.25,2740,11343,1980,760,47.7117,-122.278
346000,2,1,1070,2196,880,190,47.5726,-122.308
450000,3,2,1680,4886,1180,500,47.5536,-122.286
350000,4,2.5,2260,13755,2260,0,47.3767,-122.161
2.4E+06,4,3.5,5860,7200,3690,2170,47.6287,-122.287
594950,4,2.25,2380,35008,2380,0,47.5834,-122.001
1.695E+06,5,3,3320,5354,3320,0,47.6542,-122.331
219000,2,1,1050,9000,1050,0,47.2887,-122.299
450000,4,2.5,2070,3982,2070,0,47.531,-121.854
402000,4,2.25,1790,7311,1790,0,47.5055,-122.189
275000,2,1,840,4000,840,0,47.5531,-122.307
421500,3,1.5,990,4500,990,0,47.6051,-122.298
560000,3,3,4120,60392,3180,940,47.6804,-121.913
314000,3,1.75,1620,9600,1620,0,47.4749,-122.155
287000,4,2,1340,8190,1340,0,47.4905,-122.343
277000,4,1,1500,5750,1500,0,47.4768,-122.206
337500,2,1,1300,6731,1300,0,47.5697,-122.395
792000,4,2.75,3100,10245,3100,0,47.6858,-122.107
435000,3,2.5,3380,7074,2200,1180,47.7462,-121.978
313100,4,2.5,2660,9030,1450,1210,47.4558,-122.212
575000,3,2.25,1700,3333,1100,600,47.6784,-122.361
510000,4,2.5,1840,7800,1240,600,47.7762,-122.384
299950,2,1,890,5200,890,0,47.5311,-122.373
1.028E+06,3,3,2800,5800,1580,1220,47.6493,-122.413
364000,4,1.75,2010,8625,1340,670,47.7496,-122.355
335000,3,1,1380,7470,1380,0,47.7479,-122.343
219950,3,1,1210,8000,1210,0,47.4211,-122.314
215000,3,2,1280,6994,1280,0,47.3889,-122.048
640000,4,2.5,4090,215186,3670,420,47.2964,-122.116
535000,3,1,1580,6300,1180,400,47.6505,-122.384
253000,4,2,1910,7826,1140,770,47.3493,-122.306
650000,2,2.5,1740,2500,1210,530,47.622,-122.3
672000,3,2.25,1130,4445,1130,0,47.6845,-122.375
606000,3,1.75,1970,8540,1130,840,47.7213,-122.365
292000,3,2.25,1780,9720,1280,500,47.4762,-122.156
289950,3,2,1670,7757,1670,0,47.3802,-122.207
257500,4,1.5,1360,9323,1360,0,47.3168,-122.401
380000,3,2.5,1840,6985,1290,550,47.7586,-122.342
360000,3,1.75,1255,1113,1255,0,47.6958,-122.343
269500,3,1.75,1840,7412,1240,600,47.3933,-122.188
449000,4,2.5,2960,6031,2960,0,47.3596,-122.04
375000,4,1.5,1430,7232,1430,0,47.7197,-122.328
2.2E+06,5,4.75,5990,10450,4050,1940,47.5554,-122.077
810000,4,2.5,3480,59242,3480,0,47.7391,-122.102
994000,5,3.25,4260,7861,4260,0,47.611,-121.992
275000,5,2.25,1820,10500,1080,740,47.4058,-122.177
300000,2,1,1290,2482,1290,0,47.6972,-122.025
380000,5,2.5,2130,8428,2130,0,47.4726,-122.282
200000,3,2,1170,10051,1170,0,47.4229,-122.324
635000,3,3.5,1730,1349,1350,380,47.6224,-122.326
280000,2,1,880,5750,880,0,47.5642,-122.379
574000,3,2.5,2380,6832,2380,0,47.5372,-121.876
1.05E+06,4,1,1330,9729,1330,0,47.6223,-122.208
545000,3,2.25,1780,191228,1780,0,47.4575,-121.748
271950,3,1.5,1220,8400,1220,0,47.5467,-122.173
630000,5,1.75,2490,24969,1540,950,47.336,-122.35
400000,2,1,1180,10800,1180,0,47.7273,-122.236
334000,4,2.5,2310,6200,2310,0,47.3321,-122.172
332500,4,2,1440,4855,1440,0,47.5717,-122.287
525000,2,1.5,1620,1444,1080,540,47.5892,-122.309
408000,3,2.5,2620,8403,2620,0,47.3675,-122.042
846450,4,2.5,3710,7491,3710,0,47.5596,-122.016
411100,3,1.5,1040,10323,1040,0,47.5882,-122.155
409124,5,3.25,3320,11340,2480,840,47.3904,-122.154
335950,2,1.5,800,5192,800,0,47.5119,-122.386
480000,5,2.5,2040,9597,1240,800,47.6544,-122.134
280000,2,1.75,1960,30144,980,980,47.4234,-122.212
668000,4,2.5,2670,4410,2670,0,47.5978,-122.038
750000,4,2.5,2930,8641,2930,0,47.7199,-122.246
394475,2,1,830,4000,830,0,47.6929,-122.379
848000,5,1.75,2290,4320,1980,310,47.664,-122.31
675000,3,1.5,2510,3600,2510,0,47.6195,-122.313
175000,3,1,1280,7572,1280,0,47.4491,-122.176
560000,4,1.5,1810,6000,1350,460,47.5233,-122.386
538888,5,2.75,2080,13189,2080,0,47.6288,-122.031
359000,4,1.75,1680,9244,1680,0,47.4612,-122.352
300000,3,2.25,1660,5128,1660,0,47.7362,-121.967
273000,3,2.5,1650,5994,1650,0,47.3603,-122.19
670000,3,2.5,1420,1438,1280,140,47.6265,-122.323
530000,4,2.25,2240,8376,1740,500,47.6323,-122.029
625000,3,1.5,1230,3060,910,320,47.667,-122.333
248000,3,1,1260,6000,1260,0,47.4187,-122.323
533000,3,2.5,2060,4812,2060,0,47.5793,-122.002
549950,4,3.5,3090,10510,2190,900,47.7176,-122.214
485000,4,1.75,3220,7392,2010,1210,47.7719,-122.361
353500,3,2.5,2020,4845,2020,0,47.3848,-122.033
435000,2,1.75,1910,12142,1910,0,47.6276,-122.053
241000,3,1,1150,10000,1000,150,47.5075,-122.262
885000,4,2.75,2730,3560,1550,1180,47.6737,-122.304
799200,6,3,2890,2370,2290,600,47.6227,-122.323
760000,3,2.5,2280,12746,1490,790,47.6362,-122.175
270000,2,1,1040,5700,1040,0,47.519,-122.26
675000,4,1.75,2440,7475,2040,400,47.6339,-122.096
499000,3,2.5,1720,5940,1000,720,47.6631,-122.129
1.2025E+06,3,2.5,3430,28718,3430,0,47.6477,-122.183
320000,4,2.5,2570,4865,2570,0,47.3588,-122.038
890000,4,3.25,4360,210254,2320,2040,47.4375,-122.008
275000,4,2.75,2060,7350,1210,850,47.3424,-122.275
490000,4,2.5,3020,8302,3020,0,47.363,-122.127
550000,3,2.5,2340,4200,1540,800,47.6033,-122.303
390000,5,2,2400,9537,1210,1190,47.5112,-122.186
277000,3,2.25,1610,11920,1110,500,47.3683,-122.279
236000,3,1.75,1090,7647,1090,0,47.2613,-122.302
265953,3,1.75,1470,13068,1470,0,47.3096,-122.197
545000,3,2.25,1670,6240,1240,430,47.6413,-122.113
535000,3,2.5,1850,10109,1850,0,47.7163,-122.229
1.45E+06,3,2.75,3940,9671,2140,1800,47.5654,-122.158
490000,4,3,2330,3497,1920,410,47.554,-122.308
319950,4,2.5,2020,7200,2020,0,47.5223,-121.818
625000,3,1.5,1300,7200,1300,0,47.6821,-122.196
248000,3,1,1180,6947,1180,0,47.4233,-122.177
475000,3,1.75,1320,7840,1320,0,47.6024,-122.143
410000,6,2.75,2520,9324,1320,1200,47.7636,-122.294
670000,3,2.5,1680,2000,1680,0,47.6604,-122.29
430000,3,2.5,2000,35438,2000,0,47.4733,-121.994
313000,2,1,1180,4900,1180,0,47.5321,-122.029
950000,3,3.25,3330,15093,3330,0,47.5395,-122.242
751750,2,2,1880,5400,1880,0,47.6238,-122.311
760000,4,2.5,2990,5280,2210,780,47.5353,-122.066
310650,3,1.75,1510,12408,1510,0,47.5069,-122.141
367500,4,3,3110,7231,3110,0,47.3279,-122.191
580000,4,2.5,2150,5000,2150,0,47.6962,-122.314
580000,3,2.25,1900,3960,1200,700,47.6122,-122.298
665000,4,2.5,2720,10000,2720,0,47.6293,-122.051
239950,3,2.25,1560,8280,1560,0,47.3393,-122.259
470000,4,2.5,1990,30083,1990,0,47.7678,-122.272
733000,3,1.75,1740,3060,950,790,47.6816,-122.31
250000,4,2,2130,8400,1350,780,47.4133,-122.209
402000,4,1.75,1510,9176,1510,0,47.7651,-122.339
295000,5,3.5,2100,5107,1410,690,47.5108,-122.257
355000,5,2.5,2344,8000,1560,784,47.3185,-122.377
289000,3,1.5,1970,22486,1970,0,47.4511,-122.089
376000,3,2.25,1470,9140,1470,0,47.7162,-122.349
212700,2,1,940,5040,940,0,47.5375,-122.374
325000,3,1.75,1780,13095,1780,0,47.367,-122.152
415000,4,2.5,2230,5743,2230,0,47.7245,-121.957
935000,3,2.5,3570,15151,2400,1170,47.7475,-122.364
372000,3,2.5,1920,15260,1920,0,47.7317,-121.964
240000,3,1.5,1290,8366,1020,270,47.4853,-122.318
334950,3,1.75,1880,16262,1880,0,47.5089,-122.155
426500,4,2.5,2960,4640,2960,0,47.3597,-122.04
430000,2,1.75,1840,14874,1300,540,47.4382,-122.348
400000,3,1.5,1890,6183,1090,800,47.5396,-122.269
455850,3,2.25,1820,6000,1120,700,47.5684,-122.3
1.96522E+06,4,3.5,4370,8510,3610,760,47.5876,-122.204
400000,3,1.75,1530,10731,1530,0,47.7655,-122.244
397500,3,1,1030,10480,1030,0,47.5742,-122.139
755000,3,2.5,2000,1950,2000,0,47.6476,-122.356
287000,5,1.5,1730,9230,1010,720,47.4646,-122.184
480000,4,2.5,3620,16000,3620,0,47.3711,-122.06
490000,3,2.5,2040,9622,2040,0,47.4833,-121.8
365000,3,2.5,2640,6715,1680,960,47.441,-122.125
260000,3,2.5,1600,2244,1600,0,47.4899,-122.164
505000,4,1,1480,12675,1480,0,47.763,-122.342
260000,2,1,700,4800,700,0,47.6147,-122.3
430000,2,1,700,4800,700,0,47.6147,-122.3
905000,4,2.5,3520,12193,3520,0,47.5535,-122.095
440000,3,2,1650,6408,1650,0,47.6638,-122.128
439500,4,1,1360,5500,1360,0,47.6878,-122.285
270000,3,2,1350,6696,680,670,47.4919,-122.187
306500,3,2.5,1970,6291,1970,0,47.3627,-122.073
380000,3,2,1470,1656,1310,160,47.5653,-122.369
215000,4,1.75,1610,9652,1610,0,47.3281,-122.135
299900,2,1,810,6150,810,0,47.7289,-122.34
1.45E+06,4,3.5,2820,7809,2820,0,47.622,-122.195
239950,3,1,1900,33888,1900,0,47.2738,-122.271
494000,4,2.5,1830,7345,1540,290,47.7741,-122.373
317500,4,1.5,1730,7700,1010,720,47.4996,-122.163
670000,4,2.5,2110,7291,2110,0,47.6888,-122.201
650000,3,2.5,3060,7831,3060,0,47.5401,-121.861
852000,4,2.5,2620,7328,2620,0,47.5514,-122.263
250000,2,1.5,1088,1360,1088,0,47.7094,-122.213
264950,3,1.5,1400,10853,1400,0,47.4433,-122.194
582500,2,2,1540,6804,1020,520,47.7044,-122.372
384000,3,2.5,1540,1564,1300,240,47.586,-122.313
817000,3,1.5,2310,3360,1790,520,47.6431,-122.359
320000,4,1.75,1730,9520,1730,0,47.4756,-122.157
445800,4,2.25,2070,39446,1470,600,47.7765,-122.276
263300,2,1,900,4500,900,0,47.5273,-122.265
215000,3,1,860,6635,860,0,47.7508,-122.339
842500,5,4,2980,4500,2070,910,47.6736,-122.323
850000,5,4,2980,4500,2070,910,47.6736,-122.323
386000,5,2.5,2740,12413,2740,0,47.4199,-122.183
251100,4,2.5,1790,5257,1790,0,47.3849,-122.204
435000,3,1.75,1750,16748,1330,420,47.7421,-122.089
870000,4,4,3610,12811,3610,0,47.5812,-121.993
800000,6,1,1430,20620,1430,0,47.6255,-122.209
555000,3,1.75,1570,15500,1570,0,47.6916,-122.122
280000,2,1,2280,37500,2280,0,47.525,-122.389
356000,3,1,940,2366,940,0,47.6744,-122.383
675000,4,2.5,2920,6000,2920,0,47.5333,-121.859
605000,4,2.25,2260,11900,2260,0,47.6415,-122.057
690500,5,2,2000,4211,1280,720,47.6283,-122.301
437000,2,1.75,1440,4225,1440,0,47.7143,-122.032
850000,5,2,2310,13430,2310,0,47.6395,-122.203
350000,4,2.25,2300,4600,1340,960,47.5895,-122.311
480000,2,2.25,1490,6770,1490,0,47.5577,-122.297
379500,3,2.25,1830,25641,1830,0,47.4786,-122.112
600000,5,4.5,4440,9784,4440,0,47.4702,-122.275
1.436E+06,4,3.5,4970,16582,3930,1040,47.5496,-122.12
303000,2,1.5,1000,1075,840,160,47.5708,-122.288
800000,4,2.5,4940,10037,3450,1490,47.5095,-122.247
549000,2,2,1980,6000,1220,760,47.6809,-122.351
324950,3,2.5,1560,9600,1210,350,47.457,-122.27
170000,2,1,870,6537,870,0,47.4906,-122.306
178000,3,1,840,6500,840,0,47.3704,-122.08
144000,3,1,1250,8314,1250,0,47.4522,-122.178
1.58E+06,4,2.75,3120,20031,1980,1140,47.5389,-122.242
258000,2,1,750,7000,750,0,47.5655,-121.89
345000,3,1.75,710,5050,710,0,47.5194,-122.375
470000,3,1.75,2290,14800,1620,670,47.7735,-122.273
2.903E+06,5,2.5,3750,91681,3750,0,47.5379,-122.264
350000,3,1.5,980,7790,980,0,47.7141,-122.213
225500,2,1.75,1590,11276,1590,0,47.3177,-122.21
473000,2,1,940,4000,720,220,47.6488,-122.385
279000,3,1.75,1750,9623,1150,600,47.3997,-122.313
470000,3,1,1460,8227,880,580,47.7009,-122.301
565000,3,1.75,1540,4800,770,770,47.67,-122.284
695000,3,2,2560,6800,1380,1180,47.5506,-122.395
315000,3,1.75,1660,37642,1660,0,47.2559,-122.007
529000,3,2.5,1880,4499,1880,0,47.5664,-121.999
750000,5,3.75,3500,101494,3500,0,47.6745,-122.054
481500,3,2.25,1840,10500,1840,0,47.7326,-122.234
211000,3,2,1060,7412,1060,0,47.3897,-122.051
455000,3,2.25,1790,7500,1390,400,47.7321,-122.198
238950,2,1,810,4838,810,0,47.4909,-122.203
722500,4,3.5,2600,5100,1820,780,47.6948,-122.395
795000,4,2.5,3230,19193,2000,1230,47.5755,-122.07
327500,4,2.25,2240,9600,2240,0,47.361,-122.281
585000,4,3,3400,5100,3400,0,47.3548,-122.002
775000,4,2,3140,10875,1940,1200,47.6656,-122.406
645000,4,2.5,2780,4200,2780,0,47.5989,-122.039
445000,4,2.75,2320,12368,1670,650,47.7373,-122.35
257950,3,1.75,1370,5858,1370,0,47.3815,-122.313
375000,5,1.75,2230,7560,1230,1000,47.5055,-122.26
245000,3,2.5,1610,7223,1610,0,47.3661,-122.173
725000,3,2.5,3410,41022,3410,0,47.3228,-122.08
702000,4,2.5,2810,4922,2810,0,47.614,-122.041
330000,3,1.75,1850,14986,1850,0,47.4837,-122.148
940000,3,1.5,1790,4800,1790,0,47.6332,-122.362
354500,3,1,1150,11396,1150,0,47.7435,-122.296
279950,4,2.75,2420,8700,2420,0,47.3109,-122.229
284000,3,2.25,1580,7034,1180,400,47.3564,-122.04
480000,5,2,1760,21562,1560,200,47.7597,-122.263
647500,5,2,1760,21562,1560,200,47.7597,-122.263
625000,3,2.5,2750,35000,2750,0,47.75,-122.024
152000,3,1,920,4875,920,0,47.3623,-122.09
322000,3,1,960,10181,960,0,47.7231,-122.229
445000,3,1.75,1120,4000,870,250,47.6684,-122.368
595000,3,1,1560,3960,1560,0,47.5936,-122.301
165000,3,1,1380,7334,980,400,47.4339,-122.192
278500,4,2.5,1940,6206,1940,0,47.3063,-122.359
517500,3,1.75,1810,10625,1370,440,47.5322,-122.049
343566,2,1,1100,4200,1100,0,47.5312,-122.392
286285,4,2.25,1980,9714,1170,810,47.3207,-122.209
474905,4,1.5,1340,6200,1340,0,47.6214,-122.119
550000,3,1.75,1680,4800,1400,280,47.5535,-122.377
286000,4,2.5,2060,16000,2060,0,47.2849,-122.251
900000,3,3.25,2620,7215,1770,850,47.5836,-122.2
449950,3,2.25,1610,5159,1610,0,47.5675,-122.019
259000,4,1.5,1490,7560,1490,0,47.3684,-122.318
340000,3,2.25,1900,8125,1540,360,47.4564,-122.162
785000,4,2.5,3440,56192,3440,0,47.6969,-122.046
490000,2,1,1840,3300,1130,710,47.6757,-122.362
344950,4,2,2330,6250,1400,930,47.3782,-122.228
950000,3,2,2250,2975,1880,370,47.6289,-122.309
810000,4,1.75,2000,3988,1000,1000,47.5925,-122.391
998160,2,2.5,3010,16050,1260,1750,47.5643,-122.16
377000,3,1.75,1680,7389,1150,530,47.5199,-122.184
595000,3,2,1530,6773,1530,0,47.6653,-122.194
313300,2,1,970,4800,970,0,47.5754,-122.414
360000,5,1.75,1550,5225,1550,0,47.554,-122.306
188000,3,1.75,1660,7350,1660,0,47.3118,-122.337
755000,3,2.5,3680,203860,3680,0,47.6903,-121.929
1.289E+06,5,3.5,3210,4060,2290,920,47.6801,-122.357
455000,3,1,1480,13280,1480,0,47.5378,-122.043
817500,5,3.5,3600,9312,2680,920,47.6582,-122.122
550000,3,2.25,1700,1481,1700,0,47.6598,-122.349
260000,3,1.75,1680,8725,1240,440,47.3107,-122.397
320000,3,2,1550,34175,1550,0,47.4855,-121.698
1.153E+06,3,3.25,3780,10623,2650,1130,47.5506,-122.101
362000,4,2.5,2360,7370,1460,900,47.7201,-122.308
503500,3,2.5,1810,1750,1350,460,47.6513,-122.386
653000,3,2.5,2290,3475,2290,0,47.5551,-122.001
760000,4,2.75,3370,12447,3370,0,47.7309,-122.058
775000,4,1.75,2090,5050,1090,1000,47.6802,-122.358
1.339E+06,4,3.75,2130,34689,2130,0,47.5489,-122.398
417500,5,1.75,2060,10911,1360,700,47.7767,-122.365
525000,3,1.5,1560,9350,1220,340,47.6729,-122.148
217000,2,1,730,2400,730,0,47.35,-122.322
525000,4,2.75,2910,6308,1640,1270,47.7352,-122.201
442500,4,2.25,2490,8700,1890,600,47.7397,-122.324
525000,4,1.75,1710,10440,1710,0,47.5756,-122.158
425500,4,1.75,1520,10630,1520,0,47.7347,-122.193
710000,3,2.75,2930,218235,2930,0,47.5481,-121.886
545000,4,3,3160,10948,1930,1230,47.3733,-122.422
410000,5,2.75,2910,16410,2910,0,47.44,-122.145
245000,3,2.25,1700,8100,1200,500,47.3601,-122.046
194900,2,1,810,6697,810,0,47.3057,-122.216
284000,4,2.5,2000,5390,2000,0,47.3732,-122.129
280000,2,1.75,1894,52769,1520,374,47.3088,-122.273
280000,3,1.75,2080,87991,1040,1040,47.6724,-121.865
360000,4,2,1730,5500,1010,720,47.5304,-122.353
405000,2,1,720,4323,720,0,47.6604,-122.401
865000,4,2.5,3560,13981,3560,0,47.6002,-121.98
483300,4,2,1210,11100,1210,0,47.5747,-122.145
355000,4,2.5,2130,9268,2130,0,47.262,-122.22
274950,3,2.25,1570,8767,1180,390,47.3568,-122.038
1.925E+06,3,4.5,3950,6134,2880,1070,47.6413,-122.405
755000,3,3.25,3450,15586,2690,760,47.4294,-122.343
1.94E+06,4,5.75,7220,223462,6220,1000,47.7097,-122.013
309212,3,1.75,1150,9600,1150,0,47.4434,-121.774
219950,3,2.25,1500,7615,1150,350,47.3146,-122.351
690000,3,2.5,1300,5150,1300,0,47.6838,-122.362
250800,3,1.75,1290,4000,1170,120,47.5309,-122.354
557500,3,2,2510,35255,2510,0,47.4012,-122.025
941000,4,1.75,2320,3825,1820,500,47.6659,-122.327
3.65E+06,6,4.75,5480,19401,3910,1570,47.6515,-122.277
305000,4,2.75,2030,8600,1230,800,47.3942,-122.16
815000,4,1.5,2060,16110,2060,0,47.5983,-122.202
1.015E+06,3,2.5,2920,34527,1800,1120,47.5799,-122.4
1.24E+06,4,3,3330,6990,2330,1000,47.5886,-122.287
535000,3,2.5,2110,8164,2110,0,47.5269,-122.171
775000,3,1,1175,10454,1175,0,47.6388,-122.218
255000,3,2,1590,8670,1590,0,47.3725,-122.073
327000,2,1,1070,9750,1070,0,47.7532,-122.318
560000,4,2,2720,8819,2240,480,47.338,-122.333
1.339E+06,4,3.5,2980,6349,2980,0,47.6819,-122.208
199500,3,1.75,1160,5200,1160,0,47.3643,-122.09
760000,4,2.5,3580,97574,3580,0,47.3901,-122.071
439000,3,2.25,3020,6000,1980,1040,47.5249,-122.319
527000,4,2.25,2380,5250,1410,970,47.6164,-122.115
199950,3,2.75,2270,13590,1300,970,47.2099,-122.001
254000,3,2.25,1660,8188,1660,0,47.3766,-122.115
393000,2,1,830,5000,830,0,47.6914,-122.352
585000,5,2.25,2480,12614,1860,620,47.7393,-122.2
450000,2,2,1900,7740,1150,750,47.5227,-122.372
565000,2,1.75,1670,4008,1670,0,47.5539,-122.001
330000,5,2.25,2000,7900,1300,700,47.4291,-122.292
870000,3,2,2320,65340,2320,0,47.6106,-122.055
585000,4,2.5,1860,8117,1460,400,47.6228,-122.104
500000,3,2.5,2110,208737,2110,0,47.2674,-122.072
225000,3,2,1400,7384,1150,250,47.4655,-122.174
295000,3,2,1400,7384,1150,250,47.4655,-122.174
775000,3,2.75,2850,14800,1920,930,47.559,-122.146
280000,3,1,1370,11050,1370,0,47.4485,-121.776
539000,3,2.5,2170,3200,1280,890,47.6543,-122.347
567500,3,1.75,2570,14033,2570,0,47.4335,-122.338
442500,4,2.25,1970,7902,1310,660,47.7249,-122.298
598200,5,3.75,2980,4635,2980,0,47.5508,-122.268
610000,4,2.5,2300,10843,2300,0,47.6988,-122.202
544900,3,2.5,1990,4936,1990,0,47.5911,-122.018
557500,4,2.5,2390,38258,2390,0,47.7433,-122.094
532500,3,2.5,2160,7500,1430,730,47.6188,-122.064
1.35E+06,4,3.25,3300,15907,3300,0,47.5413,-122.216
750000,3,2,1840,2825,1040,800,47.6428,-122.302
530000,3,2.5,2030,10958,2030,0,47.7251,-122.11
346100,3,2.5,1400,2036,1400,0,47.5516,-122.382
260000,4,2.25,2320,16800,2320,0,47.2959,-122.166
365000,3,1.75,1410,9150,1410,0,47.5683,-122.178
615000,3,2,1860,42800,930,930,47.5898,-122.004
318400,4,2.5,1820,6916,1820,0,47.3862,-122.029
498500,4,2.5,1910,7172,1910,0,47.7615,-122.309
450000,3,1.75,1540,7490,1540,0,47.7222,-122.177
200000,3,2,1430,7905,1430,0,47.2757,-122.145
234000,3,1,1010,8906,1010,0,47.3627,-122.108
121800,2,1,940,8384,940,0,47.5065,-122.364
805000,3,2.75,2600,5875,1600,1000,47.5773,-122.406
410000,4,2.25,2060,7283,1220,840,47.7435,-122.317
475000,3,2.5,1920,4534,1920,0,47.7144,-122.204
1.3375E+06,4,2.5,2900,21074,2900,0,47.6696,-122.416
269000,1,1,1020,7920,1020,0,47.5385,-122.355
573000,4,2.25,2150,9520,2150,0,47.6885,-122.113
330000,3,2.5,1660,2890,1660,0,47.5434,-122.293
252750,4,1,1230,7410,1230,0,47.4798,-122.344
745000,2,2.5,2170,7546,2170,0,47.7242,-122.032
280000,3,2,1280,7633,1280,0,47.3883,-122.05
535000,4,2.5,2240,6920,1380,860,47.5011,-122.375
580000,4,1.5,1780,5100,1320,460,47.6944,-122.288
301000,3,1.75,1840,7200,1220,620,47.456,-122.209
600000,4,1.75,1740,7700,1740,0,47.6259,-122.111
538900,5,3,3040,6604,3040,0,47.548,-122.356
366000,3,2.5,2370,4375,2370,0,47.354,-121.999
303000,4,2.5,2100,6783,2100,0,47.3504,-122.141
432000,3,2.25,1470,1578,1090,380,47.5388,-122.387
300000,2,1.5,1300,6120,820,480,47.5088,-122.338
908800,3,3,3420,7826,2430,990,47.5873,-122.29
500000,3,1.5,1190,4750,970,220,47.6726,-122.386
254000,5,2,2080,16117,1740,340,47.3424,-122.289
470000,5,1.5,2180,4268,1340,840,47.6848,-122.389
480000,3,2,1460,7860,1460,0,47.6233,-122.108
536000,3,1.75,1530,8503,1150,380,47.6872,-122.185
1.349E+06,4,3.5,4740,8611,3640,1100,47.5375,-122.07
550000,3,2.25,1980,40887,1980,0,47.6478,-122.029
260000,3,1.75,1710,6400,1240,470,47.3036,-122.377
284900,2,1.5,1160,982,890,270,47.7675,-122.315
740000,3,2.5,2200,3000,1530,670,47.6451,-122.35
425000,2,1,1170,5000,1030,140,47.5449,-122.388
230000,3,1,1120,7500,1120,0,47.5112,-122.359
675000,3,1.5,1710,4000,1710,0,47.5714,-122.385
267500,3,1.75,1650,7807,1650,0,47.3514,-122.167
814000,4,2.5,2840,8820,1420,1420,47.5542,-122.265
1.25E+06,4,3,3310,217800,3310,0,47.6616,-121.999
460000,3,2,1860,7232,1320,540,47.7165,-122.319
445000,3,2.5,2250,9608,2250,0,47.4865,-121.802
715000,3,2.5,2890,7027,2890,0,47.6111,-122.009
425000,3,1.75,2120,5992,1060,1060,47.7083,-122.308
370000,4,2.5,2130,4750,2130,0,47.4324,-122.184
302000,2,1.75,1170,8200,780,390,47.3263,-122.305
453000,4,1.75,2120,7420,1060,1060,47.6019,-122.13
290000,3,1.75,1280,10716,1280,0,47.4755,-122.145
1.035E+06,4,2.5,3170,47502,3170,0,47.6495,-122.185
925000,4,2.25,2260,41984,2260,0,47.6622,-122.171
600000,3,1.75,2930,19876,2030,900,47.7443,-122.17
354000,3,1.5,1060,5750,1060,0,47.5512,-122.371
204950,4,1.75,1740,9344,1180,560,47.3196,-122.399
675000,4,2.5,2990,5400,2990,0,47.6122,-122.009
995000,4,3.25,3530,20012,3530,0,47.7193,-122.127
800000,5,2,2960,10960,1500,1460,47.6162,-122.174
472500,3,2.5,1650,3711,1650,0,47.6863,-122.093
549950,4,2.5,2720,13500,1510,1210,47.6191,-122.145
575575,3,1.75,1516,2897,998,518,47.6842,-122.341
545000,4,3.25,4386,12275,2356,2030,47.3329,-122.2
340000,3,2.25,2580,7434,1630,950,47.7446,-122.332
225000,3,1,960,5512,960,0,47.4944,-122.165
299950,2,1.75,1460,10506,1460,0,47.4048,-122.178
829900,4,3.5,3840,4000,2640,1200,47.6642,-122.291
340000,4,2.5,2090,4200,2090,0,47.3659,-122.017
515000,4,2.25,2470,7800,1470,1000,47.6913,-122.115
601000,4,2.5,2090,6906,2090,0,47.5718,-121.996
470000,3,2.5,2070,8581,2070,0,47.5101,-122.151
371500,3,1,1650,6400,980,670,47.52,-122.365
550000,3,1.75,1880,45738,1410,470,47.7662,-122.114
242550,4,2.5,2060,7720,2060,0,47.2956,-122.374
367500,3,1.5,1410,9647,1410,0,47.7608,-122.361
359000,4,3.5,2770,8763,2100,670,47.2625,-122.308
204900,3,2,1390,8245,1390,0,47.2669,-122.254
850000,4,2.75,5440,239580,2720,2720,47.354,-122.293
187000,3,1.5,1280,4452,1280,0,47.3344,-122.216
326000,3,2.75,1720,28000,1720,0,47.4375,-122.176
340000,3,2.75,1720,28000,1720,0,47.4375,-122.176
330000,6,2.25,3040,28535,1890,1150,47.3864,-122.223
782000,4,3.5,3780,7769,3110,670,47.691,-122.129
612000,4,2.5,2670,5974,2670,0,47.7122,-122.231
400000,3,2,1350,7216,1350,0,47.7616,-122.365
941500,5,3.5,3490,9680,2460,1030,47.7757,-122.391
313000,2,1.5,870,747,800,70,47.6967,-122.342
735000,4,2.25,2410,4250,1460,950,47.6849,-122.376
471000,3,1.75,1640,10123,1340,300,47.7698,-122.167
350000,3,1,1540,9800,1540,0,47.7604,-122.329
530000,4,2.5,2370,9601,1570,800,47.5327,-122.054
415000,4,3,1830,9548,1830,0,47.7379,-122.224
639500,4,2.25,2330,8994,2330,0,47.7264,-122.104
580379,4,2.75,2240,27820,2240,0,47.5936,-122.054
378000,2,2.5,1700,2513,1700,0,47.5163,-121.878
265000,3,2.25,1750,9298,1410,340,47.4579,-122.164
212000,3,1.75,1100,9750,1100,0,47.2955,-122.362
400000,4,3,2320,13068,2320,0,47.3497,-122.317
750000,4,2.5,2540,6491,2540,0,47.6363,-122.117
384900,5,2.5,3090,12750,1750,1340,47.3408,-122.335
176000,2,1,770,5200,770,0,47.3627,-122.087
350000,3,2.75,2370,4632,2370,0,47.3794,-122.022
168000,3,1,1200,7210,1200,0,47.3729,-122.183
358000,4,2,2200,3060,1100,1100,47.565,-122.284
580000,3,2.75,2660,32757,2660,0,47.7649,-122.098
442500,3,1.75,1600,10280,1050,550,47.725,-122.174
515000,2,2.5,1330,1249,1330,0,47.6668,-122.285
554000,5,2.5,3440,12900,1720,1720,47.4426,-122.342
659000,3,2.5,2510,6320,2510,0,47.5868,-122.033
414999,4,2.5,2150,10098,1090,1060,47.7166,-122.201
275000,3,1.5,1180,10277,1180,0,47.488,-121.787
193000,2,1,680,8640,680,0,47.4559,-122.289
525000,4,2.5,2840,4750,2840,0,47.4511,-122.121
424000,3,2.5,1820,7500,1820,0,47.7155,-122.104
455000,2,1,1070,5150,870,200,47.6853,-122.366
463000,2,1,1250,5650,1250,0,47.5495,-122.377
1.1E+06,4,2.5,2190,6300,1240,950,47.6918,-122.216
523000,3,1.75,3000,5413,1900,1100,47.6962,-122.312
615000,4,1.75,2270,9830,2270,0,47.5999,-122.176
1.515E+06,4,4,4500,11795,4500,0,47.5533,-122.098
870000,5,4,3400,5000,2320,1080,47.6655,-122.363
710000,3,2.5,2830,9680,2830,0,47.6249,-122.024
215000,3,1,960,9563,960,0,47.2864,-122.357
590000,2,1,1530,6450,1530,0,47.6833,-122.398
323000,5,2.5,2500,13034,1300,1200,47.3343,-122.194
279000,4,2,1560,7569,1560,0,47.4496,-122.155
535100,3,2.25,2070,7207,1720,350,47.7735,-122.371
830000,5,2.25,2710,19800,1910,800,47.5958,-122.175
815000,4,2.5,3150,4203,3150,0,47.688,-122.164
535900,3,2.25,1880,10880,1480,400,47.5937,-122.116
230000,3,1,1250,8800,1250,0,47.497,-122.357
325500,4,1.75,2290,8142,1490,800,47.4564,-122.211
359000,3,2.25,1990,4331,1990,0,47.4917,-122.167
505000,3,2.5,2100,5824,2100,0,47.5334,-121.867
253905,3,1,940,8400,940,0,47.5112,-122.167
369950,3,1.75,1640,4860,1200,440,47.7125,-122.32
350000,3,2.25,1860,8378,1860,0,47.3875,-122.032
650000,4,2.25,2100,2500,2100,0,47.6726,-122.298
295000,3,1.75,1500,15246,1500,0,47.4367,-122.463
620000,3,1.75,1680,28046,1180,500,47.7648,-122.37
1.998E+06,2,2.5,3900,920423,3900,0,47.5371,-121.756
246000,3,1,1400,7410,1400,0,47.4798,-122.343
430000,3,2.75,2600,12860,1350,1250,47.695,-121.918
509990,3,2,1440,4859,1440,0,47.5503,-122.285
490000,4,1.75,1870,9500,1090,780,47.7012,-122.187
385000,4,2.75,2960,10454,2360,600,47.4006,-122.322
769000,4,2.5,2440,6733,2440,0,47.6374,-122.064
185000,2,1,1122,9100,1122,0,47.328,-122.341
303500,3,1.5,1060,10464,1060,0,47.7313,-122.229
468000,4,2.5,2150,8165,1430,720,47.773,-122.371
449950,4,2.5,3100,10000,3100,0,47.3741,-122.15
235000,2,1.5,880,1805,880,0,47.7064,-122.342
520000,4,2.5,2490,34947,2150,340,47.4823,-122.031
203000,2,1,1080,9067,1080,0,47.4815,-122.331
657000,5,2.5,2530,10190,1290,1240,47.616,-122.115
275000,3,1,1200,7800,1200,0,47.5196,-122.371
540000,4,2.25,2850,7453,2850,0,47.7439,-122.174
455000,4,2.5,2950,4502,2950,0,47.5002,-122.151
458500,2,1.75,1160,6828,860,300,47.6937,-122.298
549900,4,3.5,3420,4751,3420,0,47.4734,-122.193
750000,3,1.75,2240,10578,1550,690,47.6954,-122.292
235000,4,1.75,1450,8891,1180,270,47.478,-122.278
286000,4,2.5,1820,7930,1820,0,47.359,-122.05
2.65E+06,4,3.5,4700,13730,3500,1200,47.6899,-122.217
602000,4,1.75,2430,14000,1580,850,47.6554,-122.134
640000,3,1.5,1960,4080,1960,0,47.6768,-122.31
267000,3,1.75,1440,10920,1440,0,47.3812,-122.168
712000,4,2.5,2730,4385,2730,0,47.5975,-122.038
244500,2,1,910,9000,910,0,47.526,-121.81
301000,2,1,910,9000,910,0,47.526,-121.81
990000,4,2.5,2430,6325,2020,410,47.6413,-122.354
739999,4,2.75,3350,6500,3350,0,47.5838,-122.027
480000,4,1.75,2320,4322,1140,1180,47.5755,-122.289
305000,3,2.5,1260,1622,1260,0,47.7325,-122.343
703300,3,2,1980,3525,1590,390,47.6847,-122.368
265000,4,1.5,1580,8468,1580,0,47.3336,-122.281
600000,4,2.5,2710,35009,2710,0,47.4815,-121.714
253000,3,1,1400,9750,1400,0,47.3862,-122.304
617950,4,2.5,2410,7950,2410,0,47.7185,-122.226
385000,4,3.25,1790,2460,1100,690,47.534,-122.346
319000,3,2,1640,9234,1060,580,47.5162,-122.274
696000,3,2.5,1670,8023,1170,500,47.615,-122.117
345000,2,1,970,5750,970,0,47.5518,-122.37
380000,3,2.5,1610,1778,1610,0,47.6902,-122.306
647500,4,1.75,2060,26036,1160,900,47.4444,-122.351
725000,3,2.5,3570,35271,3570,0,47.4782,-122.035
269950,3,1.75,1400,7735,1400,0,47.357,-122.04
875000,4,2.5,3470,32109,3470,0,47.7311,-122.036
299950,3,1,1210,9525,1210,0,47.5274,-122.345
1.875E+06,4,3.25,3930,10929,3930,0,47.6259,-122.194
430000,2,1,990,4802,990,0,47.6876,-122.395
495000,5,2.5,2200,4942,2200,0,47.5772,-122.001
275000,3,1.5,1510,16200,1510,0,47.3926,-122.167
333000,3,1,1620,5040,1120,500,47.5263,-122.286
247000,3,2.25,1580,7941,1580,0,47.2843,-122.357
204555,3,1.75,1260,15000,1260,0,47.2737,-122.153
432000,3,2,2190,13673,2190,0,47.3542,-122.098
175000,3,1.75,1230,13056,1230,0,47.3171,-122.279
556300,4,2.5,2030,7140,1400,630,47.6244,-122.109
286000,2,1,780,3475,780,0,47.4944,-121.789
320000,2,1.5,1110,1200,1110,0,47.6931,-122.342
815000,3,2.5,2790,53143,2790,0,47.7687,-122.036
385000,4,1.75,1660,10757,1000,660,47.5071,-122.194
1.039E+06,4,1,3410,5000,2190,1220,47.5807,-122.291
350000,4,2.25,2390,13002,2390,0,47.3111,-122.35
277000,4,2.5,1850,5880,1850,0,47.3322,-122.173
415000,6,2,2500,5200,1250,1250,47.5517,-122.268
295000,3,1,1000,8320,1000,0,47.7548,-122.316
969000,4,2,2450,5000,2200,250,47.5619,-122.405
339888,4,1.75,1440,6144,720,720,47.5257,-122.357
269950,3,2.25,1660,7003,1660,0,47.3599,-122.188
1.185E+06,3,2.5,2510,4600,2510,0,47.7051,-122.223
780000,4,2.5,3090,12511,3090,0,47.5932,-121.983
198000,3,1,860,5185,860,0,47.3634,-122.086
350000,2,1,1220,28703,1220,0,47.4952,-122.172
350000,3,1,1010,7680,1010,0,47.732,-122.231
319000,4,2.25,2390,7350,2390,0,47.2938,-122.348
311000,4,2.25,3340,8000,3340,0,47.317,-122.385
394000,5,3.25,3620,4650,2790,830,47.3552,-122.026
1.335E+06,5,2.25,4200,5800,2910,1290,47.6284,-122.312
2.7E+06,5,2.75,3831,13800,3831,0,47.5919,-122.251
396000,3,1,1980,9540,1080,900,47.7551,-122.353
809000,4,1.75,1790,8372,1340,450,47.6605,-122.189
480000,3,2,1580,7400,1050,530,47.6715,-122.162
535000,6,1.75,2460,6000,1230,1230,47.6721,-122.323
425000,5,2.75,2110,5120,1870,240,47.5294,-122.357
408000,3,2.5,1470,1204,1470,0,47.6998,-122.366
1.255E+06,4,2.5,3510,13100,3510,0,47.5306,-122.227
310000,1,0.75,520,2885,520,0,47.6886,-122.378
292000,3,2.5,1950,7421,1950,0,47.3842,-122.036
217000,2,1,770,9715,770,0,47.4924,-122.312
398500,4,2.5,2250,6064,2250,0,47.4956,-122.174
2.25E+06,3,3,4040,7200,3340,700,47.6288,-122.284
700000,4,1.75,2360,6000,1280,1080,47.6465,-122.357
585000,4,2.5,2330,45860,2330,0,47.5842,-121.992
399950,3,1,1720,8910,1720,0,47.7736,-122.296
235000,3,1.75,1900,8540,950,950,47.4868,-122.303
212000,3,1,1040,6800,1040,0,47.492,-122.224
310000,3,2,2070,9195,1220,850,47.6491,-122.061
539000,3,2,2070,9195,1220,850,47.6491,-122.061
390000,3,3,1550,1608,1280,270,47.6042,-122.303
560000,3,2.5,2020,11935,2020,0,47.632,-122.092
800000,5,2.5,3320,9024,3320,0,47.5865,-122.056
1.9E+06,4,3.25,4130,112521,4130,0,47.6392,-122.165
472000,5,2,2030,9804,1110,920,47.6297,-122.114
502550,3,1.75,1770,7875,1170,600,47.606,-122.125
830000,4,3.25,3330,7809,3330,0,47.5977,-121.976
224950,4,2.5,2260,9686,1520,740,47.286,-122.218
375000,3,2.5,1950,6871,1950,0,47.7603,-122.307
645000,3,2.5,2930,19900,2930,0,47.7234,-122.066
599000,3,2.75,1960,2500,1410,550,47.6744,-122.353
515000,4,2.5,2980,12534,2980,0,47.3999,-122.211
135000,2,1,780,6685,780,0,47.305,-122.215
485000,3,2.5,1650,4218,1650,0,47.5998,-122.016
890000,3,3.25,4030,12765,2800,1230,47.6331,-122.166
215000,3,1,1010,10125,1010,0,47.3423,-122.088
299500,3,1,1190,9600,1190,0,47.4805,-121.762
800000,2,1,1050,8750,1050,0,47.6294,-122.215
275000,3,2.5,1560,4244,1560,0,47.3834,-122.027
256400,3,1.5,1490,7800,1010,480,47.3431,-122.304
310000,2,1,770,8149,770,0,47.7439,-122.301
385000,1,1,620,5100,620,0,47.5699,-122.287
203000,3,1.5,1200,9120,1000,200,47.4545,-122.187
285000,4,2,2120,6865,1060,1060,47.7775,-122.337
473975,3,2.5,2330,3610,2330,0,47.6022,-122.021
320000,3,1.75,2000,9760,1400,600,47.4417,-122.134
599000,5,2.75,2820,4608,1450,1370,47.6886,-122.361
580000,3,2,2040,4800,1020,1020,47.5561,-122.377
269500,4,2.25,1700,7056,1700,0,47.3385,-122.262
274000,2,1,820,6200,820,0,47.4163,-122.34
347000,2,1.75,1315,2162,1315,0,47.752,-122.253
270000,3,1.75,1390,10905,860,530,47.5517,-122.36
1.43E+06,3,2,1890,12017,1890,0,47.6203,-122.21
220000,3,1.75,1460,7226,1460,0,47.3839,-122.321
243000,3,1,1480,15416,1480,0,47.2142,-121.987
457500,3,1.75,1840,4030,1050,790,47.5549,-122.311
340000,2,1.75,1880,7208,940,940,47.6946,-122.328
657500,4,1.5,1910,5000,1610,300,47.6597,-122.29
332500,4,2.5,2220,4720,2220,0,47.3541,-122.024
340000,3,2,1410,10015,1410,0,47.4948,-121.776
350000,4,3,3380,16133,2330,1050,47.5501,-122.261
428000,4,2.5,1950,5602,1120,830,47.5437,-122.291
515055,4,2.5,2400,8320,2400,0,47.4808,-121.781
450000,3,1.75,1560,8968,1560,0,47.6243,-122.1
190000,3,1,1040,8910,1040,0,47.5024,-122.32
1E+06,4,2.75,3090,16538,2590,500,47.5803,-122.403
299000,3,2.5,1850,4600,1850,0,47.4661,-122.145
508000,2,1,1200,2500,1090,110,47.6304,-122.301
294000,4,2.25,2190,3746,2190,0,47.3896,-122.034
320000,2,1,1380,5820,1380,0,47.6875,-122.392
641000,5,2.75,3710,8674,3710,0,47.514,-122.176
675000,3,2.5,2320,98445,1380,940,47.7323,-122.116
255000,3,1.5,1110,10296,1110,0,47.422,-122.153
286651,3,2.5,1830,4997,1830,0,47.3035,-122.283
607500,4,2.5,2460,45738,1650,810,47.5952,-122.056
765000,3,1,1270,6500,1270,0,47.6874,-122.214
334950,4,1.75,1700,40973,1700,0,47.3439,-122.198
426000,3,1,1130,9147,1130,0,47.7006,-122.197
775000,3,1.75,1640,18730,1640,0,47.5975,-122.196
343000,2,1.5,1040,8526,1040,0,47.7349,-122.295
470101,4,2.5,2320,7800,2320,0,47.7738,-122.266
195000,3,1.5,1200,7800,1200,0,47.3137,-122.212
772500,4,1,1720,4410,1720,0,47.6791,-122.402
450000,3,1.5,2330,11740,1330,1000,47.7481,-122.292
1.4375E+06,4,3.75,4410,9231,4410,0,47.5427,-122.265
525000,4,1.75,1650,8560,1650,0,47.6652,-122.146
280000,3,1.5,1370,11400,1370,0,47.4477,-121.77
270000,3,2.5,1770,8640,1420,350,47.326,-122.273
406100,3,2.25,1410,1332,1410,0,47.6916,-122.34
332544,2,1.75,1710,4187,1710,0,47.4732,-122.188
110000,2,1,790,8250,790,0,47.4523,-122.286
685000,6,2.25,2770,5854,2120,650,47.6466,-122.304
461000,4,1,1260,8505,1260,0,47.7181,-122.371
615000,3,2.25,2300,8067,1300,1000,47.7091,-122.198
550000,2,1,1070,3000,870,200,47.6828,-122.353
1.06E+06,4,3.5,3850,8100,2430,1420,47.6855,-122.19
685000,3,2.5,2320,219978,2320,0,47.6847,-122.064
1.555E+06,5,2.5,2870,16238,2870,0,47.6308,-122.238
312000,4,2.5,1830,5175,1830,0,47.3565,-122.016
507500,3,1.75,1990,9594,1190,800,47.6617,-122.137
217000,3,1,1110,9827,1110,0,47.369,-122.311
439000,3,2.25,1830,13477,1170,660,47.7243,-122.21
620000,6,3.5,3600,6875,2740,860,47.5401,-121.879
915000,4,2.5,3210,8532,3210,0,47.625,-122.144
425000,4,2,1490,5300,1110,380,47.5949,-122.296
435000,2,1,990,5643,870,120,47.6802,-122.298
305000,3,2.25,1646,12414,1646,0,47.363,-122.035
276000,2,1,720,4000,720,0,47.5346,-122.353
327500,3,2.25,2310,7200,2310,0,47.4051,-122.193
810000,3,2.5,2670,10481,2670,0,47.6673,-122.176
715000,3,3.25,3060,9055,2460,600,47.6971,-122.101
272000,3,1.5,1380,11760,1380,0,47.4243,-122.202
266000,2,1,700,5559,700,0,47.7492,-122.311
543000,3,1.5,1710,8364,1710,0,47.5175,-122.393
400000,3,2.5,1450,8064,1450,0,47.6256,-122.037
509500,5,2.25,2060,9000,1320,740,47.6122,-122.137
495000,3,3.5,2380,6250,1670,710,47.5137,-122.252
424950,4,2.5,2760,5564,2760,0,47.4814,-122.189
230000,3,1,940,10875,940,0,47.5121,-122.168
235000,4,1.5,1760,6150,1760,0,47.3871,-122.224
763000,3,2,1360,8752,1360,0,47.6879,-122.208
350000,3,1.75,2010,6150,2010,0,47.4975,-122.231
900000,3,1.5,2160,2260,1620,540,47.6321,-122.371
250000,3,1,930,6060,930,0,47.5289,-122.28
225000,3,2.5,1020,2040,720,300,47.5294,-122.361
255000,2,2,1360,5433,1360,0,47.3804,-122.32
161700,4,1.75,1720,7200,1220,500,47.306,-122.375
336000,3,3,1790,13350,1190,600,47.4958,-122.262
410500,3,1,1150,6800,1150,0,47.727,-122.339
502700,4,3.5,2710,14016,2710,0,47.7601,-122.286
505000,3,2.5,2400,9601,1390,1010,47.7256,-122.211
250000,3,1,1660,7650,1350,310,47.5576,-122.277
570000,3,1,1660,7650,1350,310,47.5576,-122.277
349900,4,2.5,2290,8796,2290,0,47.3762,-122.318
465000,3,2.5,2870,25663,2870,0,47.2769,-122.333
625000,4,3.25,4240,25639,3550,690,47.3241,-122.378
655000,3,1.75,1800,5102,1170,630,47.6514,-122.407
469000,4,1.75,2960,11347,1570,1390,47.4738,-122.353
355000,3,2.25,1980,7200,1300,680,47.7625,-122.36
596000,3,2.5,1730,2631,1730,0,47.5878,-122.165
790000,4,2.5,3020,36893,3020,0,47.768,-122.092
885000,4,2.25,4470,86225,4470,0,47.6377,-121.985
1.03E+06,4,3.25,2830,4000,1910,920,47.5845,-122.291
710000,4,1.75,2120,5400,1060,1060,47.6501,-122.395
428040,3,2.5,2150,9266,2150,0,47.7445,-122.248
1.37E+06,5,2.25,3510,13843,1850,1660,47.5817,-122.246
546000,2,1,970,3400,970,0,47.6444,-122.357
540000,4,1,1360,5766,1360,0,47.6827,-122.289
435000,3,2.5,1470,3000,930,540,47.6832,-122.286
540000,4,2.25,3040,10283,1430,1610,47.6268,-122.038
284000,2,1,860,7204,860,0,47.5361,-122.351
208000,2,1,820,5700,820,0,47.4915,-122.184
315000,3,1.75,1900,7076,1130,770,47.7569,-122.326
417500,2,1,1330,5510,850,480,47.6901,-122.362
345000,3,1.75,1240,38095,1240,0,47.6522,-121.97
375000,3,2.5,1330,1064,1330,0,47.6835,-122.387
389800,3,1.75,1880,12821,1880,0,47.7681,-122.305
475000,3,1.75,1890,7560,1430,460,47.7322,-122.185
569000,4,2.25,2250,41688,2250,0,47.6695,-122.05
985000,5,4.25,4650,108464,3260,1390,47.5669,-121.956
532000,3,2.5,1830,8022,1830,0,47.6198,-122.044
280000,2,1,720,5000,720,0,47.5195,-122.374
435000,4,2,1960,50112,1050,910,47.4353,-122.084
223000,3,1,1220,71191,1220,0,47.3261,-122.353
390000,2,1,1800,119790,1200,600,47.4617,-122.012
315000,3,1.75,1340,12800,880,460,47.4437,-122.137
612000,3,3,1740,3700,1740,0,47.6102,-122.309
591000,3,1.75,1680,2400,870,810,47.6155,-122.3
800000,4,2.25,3220,8436,3220,0,47.6381,-122.116
225000,3,2,1610,8400,1610,0,47.1958,-122.009
589900,2,3,3160,66646,3160,0,47.7479,-122.034
565000,4,2.5,2520,13156,1520,1000,47.6558,-122.135
650000,3,1.5,2120,8448,1060,1060,47.6438,-122.403
499000,3,2.5,2090,8505,2090,0,47.7195,-122.371
280000,3,1,1330,20562,1330,0,47.4807,-121.775
649950,3,2.5,2420,7500,1210,1210,47.6949,-122.389
420000,3,1.75,1510,6360,1510,0,47.7321,-122.353
319990,4,2.5,2120,5293,2120,0,47.4217,-122.201
265000,3,2,1850,16535,1850,0,47.6565,-121.912
482000,3,1.75,2300,16474,1220,1080,47.7609,-122.144
452000,3,2.25,2600,14810,1490,1110,47.4326,-122.341
1.488E+06,4,4.25,5180,13077,4280,900,47.5513,-122.109
375000,2,1,1810,8527,1810,0,47.7275,-122.336
588000,5,3,2190,4900,1490,700,47.6892,-122.386
635000,4,2.5,2500,10215,2500,0,47.5912,-121.986
280500,4,2.5,1890,6962,1890,0,47.3328,-122.187
210500,2,1.75,2040,8600,1430,610,47.2755,-122.308
196500,3,2,1310,7000,1310,0,47.303,-122.383
1.395E+06,5,3.5,4010,8510,2850,1160,47.6578,-122.286
475000,3,1.75,1780,8033,1210,570,47.7275,-122.219
550000,3,2.5,1980,9061,1980,0,47.6366,-122.029
1.58E+06,3,3.25,3690,7200,3690,0,47.6815,-122.2
240000,3,1.75,1540,6687,1200,340,47.1938,-121.981
272000,3,1,1130,8100,1130,0,47.4935,-122.306
408506,3,2.75,2480,209199,1870,610,47.3085,-121.888
640000,3,2.5,2580,7500,2580,0,47.5577,-122.396
316000,4,2.5,2010,7226,2010,0,47.2588,-122.21
299000,4,2,2320,12000,1720,600,47.5246,-122.325
447500,2,2.25,1180,2090,1180,0,47.6032,-122.31
736500,4,2.5,3180,21904,3180,0,47.515,-122.117
665000,4,2,2970,52567,2970,0,47.7333,-122.128
707000,5,2.5,3050,13212,1590,1460,47.5596,-122.142
215000,4,1.75,1630,8000,1630,0,47.3948,-122.201
275000,3,2.25,1620,6415,1620,0,47.3577,-122.038
648000,4,2.25,2170,8240,2170,0,47.5634,-122.128
415000,4,2.5,2150,8173,2150,0,47.511,-122.153
690000,3,2,1770,1800,1770,0,47.6102,-122.314
320000,4,2.75,2110,13260,1290,820,47.4513,-122.16
750000,3,1.75,1590,8285,1590,0,47.5855,-122.194
355000,3,2.25,1370,1524,1370,0,47.6982,-122.347
246000,3,1.75,1390,7399,1390,0,47.4183,-122.182
1.155E+06,3,1.75,1640,10464,1640,0,47.5873,-122.205
744000,3,2.5,2670,12187,2670,0,47.6677,-122.15
1.21E+06,3,3.75,5400,24740,5400,0,47.6426,-121.955
217000,3,2,1690,6750,1210,480,47.3021,-122.375
583000,3,2.5,2600,5100,2600,0,47.5175,-122.205
515000,2,1.5,1400,5000,1150,250,47.6681,-122.362
594000,4,1.75,2140,8000,1410,730,47.622,-122.139
303100,3,1.5,1640,5650,1640,0,47.509,-122.251
430000,3,1.75,1720,15225,1020,700,47.579,-122.051
708000,5,3.25,3060,11778,3060,0,47.7212,-122.222
221000,3,1,1150,7260,1150,0,47.7344,-122.333
325000,3,2.5,2000,7205,2000,0,47.3499,-122.302
1.29565E+06,0,0,4810,28008,4810,0,47.6642,-122.069
385000,3,1.75,1560,5950,780,780,47.719,-122.307
359500,3,2.5,2070,4689,2070,0,47.3545,-122.056
433000,3,2,1920,7200,1300,620,47.7703,-122.265
525000,2,1,1000,4950,800,200,47.5671,-122.394
356200,3,2,1690,10062,940,750,47.5102,-122.241
595000,4,2,3090,87120,1590,1500,47.7275,-122.122
560000,4,1.5,1790,3420,1020,770,47.6489,-122.337
2.175E+06,4,3,4750,21701,4750,0,47.6454,-122.218
513000,4,2,2090,4000,1480,610,47.6751,-122.379
365000,2,1,680,2550,680,0,47.6767,-122.388
368000,4,1.75,2100,11942,1030,1070,47.55,-122.356
870000,4,2.75,2840,4000,1960,880,47.5846,-122.291
225000,3,2.25,1470,6808,1160,310,47.2884,-122.365
1.387E+06,4,4.5,4490,24767,3800,690,47.5544,-122.147
177000,3,1.75,1150,8079,1150,0,47.3766,-122.18
465000,3,1.5,1460,9879,1460,0,47.6346,-122.127
750000,4,2.75,3150,6343,1810,1340,47.5424,-122.381
149000,3,1,1090,2800,1090,0,47.3162,-122.183
605000,3,2.5,2670,47480,2670,0,47.7443,-122.114
725000,3,2,2110,5800,1990,120,47.6645,-122.342
413900,4,2.25,1770,5236,1770,0,47.5137,-122.189
199950,3,1.5,1510,6600,1510,0,47.4821,-122.331
400000,1,1,530,13679,530,0,47.6422,-121.954
870000,3,1.5,2420,5000,2200,220,47.6744,-122.353
292000,5,2.5,2490,7666,1490,1000,47.4022,-122.171
225000,3,1,990,8012,990,0,47.4557,-122.181
466750,4,2,1730,9139,1730,0,47.7181,-122.316
330000,2,1.5,1440,11954,1440,0,47.2909,-122.219
770000,7,2.25,3260,8145,3260,0,47.6336,-122.115
802500,4,2.25,1950,7000,1450,500,47.5426,-122.262
378800,5,2.5,2740,5400,2740,0,47.4036,-122.205
795000,3,2.75,2940,12487,2940,0,47.5879,-121.973
460000,3,2,1200,7320,1200,0,47.6986,-122.286
567000,3,2.5,2070,10908,2070,0,47.5665,-122.023
209950,3,1.75,1570,15570,1570,0,47.3207,-122.362
415000,2,1,1050,60113,1050,0,47.3226,-122.287
424500,4,1.5,1830,6985,1080,750,47.7494,-122.236
261000,2,1,970,12500,970,0,47.5102,-122.33
365000,3,2.5,2200,9696,2200,0,47.4197,-122.205
631000,4,2,1930,3240,1930,0,47.6156,-122.299
3.8E+06,5,5.5,7050,42840,4320,2730,47.6229,-122.22
584000,3,2.5,1790,3962,1790,0,47.6894,-122.391
310000,3,1.75,1560,82328,1560,0,47.3674,-122.503
717000,4,2.5,2780,7985,2780,0,47.5608,-122.016
667000,3,1.5,1720,8100,1720,0,47.6746,-122.4
190000,3,1,1640,8100,1040,600,47.482,-122.34
430000,3,2,1730,9000,1370,360,47.5202,-122.047
213000,2,1,740,7380,740,0,47.4481,-122.278
475000,3,2.5,2280,3710,1550,730,47.735,-122.159
649000,2,2.75,2090,23962,2090,0,47.4145,-122.44
715000,3,2.5,2550,13458,2550,0,47.5586,-122.121
845000,4,3.5,3350,19487,2460,890,47.5796,-121.998
390000,3,2.5,2770,8820,1900,870,47.3685,-122.048
390000,4,3,2860,5724,1730,1130,47.5427,-122.302
328000,4,1.75,1990,7194,1400,590,47.4417,-122.135
239999,3,2.75,1740,8436,1140,600,47.3456,-122.305
225000,3,2,1460,7740,1460,0,47.3467,-122.306
920000,3,1.75,3670,11884,1950,1720,47.5604,-122.133
940000,4,2.75,3270,9231,3270,0,47.6539,-122.121
465000,3,1,1210,4872,1210,0,47.5551,-122.273
241000,3,2,1770,7000,1770,0,47.3321,-122.261
307550,4,2.5,1980,5909,1980,0,47.3913,-122.185
490000,4,2.5,2650,9627,1610,1040,47.7684,-122.254
647000,4,2.5,3040,6887,3040,0,47.6073,-122.015
780000,4,2.75,3640,231739,3640,0,47.5078,-122.018
517500,3,2.5,1810,4332,1810,0,47.5776,-121.996
295000,3,2,1380,8682,1380,0,47.4238,-122.322
560000,4,1.5,1810,3400,1810,0,47.6264,-122.302
319450,5,2,2250,5472,1750,500,47.3065,-122.219
1.5E+06,4,3.25,3860,7199,2870,990,47.6855,-122.269
340000,4,3,2380,20277,1500,880,47.3046,-122.392
249950,3,1,1370,11658,1370,0,47.4576,-122.182
499950,3,1,1830,3000,1430,400,47.6619,-122.351
1.038E+06,4,1.75,1440,13296,1440,0,47.634,-122.204
750000,4,2.5,2510,17200,1540,970,47.6287,-122.089
875000,4,2.5,3230,256132,3230,0,47.6544,-121.998
678000,3,1.75,1670,7210,1670,0,47.6344,-122.116
360000,2,1,780,4200,780,0,47.5381,-122.267
354900,3,1,1720,16552,1720,0,47.4772,-122.153
632000,5,2.5,2260,10087,1520,740,47.5982,-122.128
350000,3,1.75,1480,9375,1480,0,47.5076,-122.366
990000,3,4,2550,3900,2050,500,47.6415,-122.392
1.65E+06,4,3.25,3920,881654,3920,0,47.5385,-121.896
481000,4,2.5,2286,8269,2286,0,47.5174,-122.194
485000,3,2.5,1500,5412,900,600,47.5499,-122.394
477000,3,2.5,1740,4960,1740,0,47.5772,-121.998
560000,5,2.5,2880,9000,1440,1440,47.5456,-122.179
600000,6,3,2600,9350,1340,1260,47.6198,-122.105
622500,5,2.75,3320,23760,2190,1130,47.7498,-122.146
410000,2,2.25,1660,2128,1660,0,47.7528,-122.252
318200,3,2.5,1990,3644,1990,0,47.3531,-122.017
289000,3,2,1680,8424,1680,0,47.1969,-122.011
263000,3,1.75,1570,7775,1570,0,47.3876,-122.216
240000,3,1,1150,4825,1150,0,47.5321,-122.029
281500,3,1,1270,7500,1270,0,47.4921,-122.339
587206,3,3.5,1890,1710,1640,250,47.6592,-122.349
482000,2,2.25,1350,1248,1180,170,47.6399,-122.32
485000,3,1.75,1650,9500,1650,0,47.631,-122.098
309000,3,2.5,1450,11480,1450,0,47.672,-121.864
221000,3,2.25,1640,7350,1140,500,47.2625,-122.3
700000,3,2.5,2030,8398,2030,0,47.6272,-122.095
411500,5,3,2420,7740,1360,1060,47.536,-122.358
285000,4,3.5,2770,10505,2770,0,47.7412,-122.355
395000,4,3,1980,7931,1160,820,47.7513,-122.334
237950,2,1.75,1460,7926,1460,0,47.3665,-122.092
680000,3,2.5,1610,8064,1160,450,47.6818,-122.189
199950,2,1,1010,10057,1010,0,47.3286,-122.336
765000,4,3.5,2760,4000,2000,760,47.5687,-122.374
515000,2,1,1060,4960,1060,0,47.6896,-122.331
470000,3,1.5,1510,8000,1510,0,47.5865,-122.135
330000,2,1,880,4000,780,100,47.6931,-122.379
284000,3,2.5,2150,9375,1550,600,47.4578,-122.274
295000,3,2.5,1660,8125,1150,510,47.4373,-122.333
555000,4,2.5,2160,10987,1440,720,47.6333,-122.034
350000,3,1,1370,8162,1370,0,47.7263,-122.289
240000,3,2.25,1460,5818,1140,320,47.3113,-122.358
419900,3,1.5,1450,7000,1450,0,47.5983,-122.15
528000,3,2,1560,6300,1560,0,47.5407,-122.379
481000,4,2.5,2480,9869,1240,1240,47.7612,-122.229
304700,2,1,740,5995,740,0,47.7291,-122.337
715000,4,2.5,2927,12171,2927,0,47.5948,-121.983
738950,4,2.75,2260,12005,2260,0,47.6342,-122.171
215000,3,1.5,1240,9405,1240,0,47.3727,-122.162
300000,6,2,2040,10812,2040,0,47.4919,-122.181
346000,3,1.75,1270,8100,880,390,47.4828,-122.344
473000,4,3.5,4370,37193,2780,1590,47.241,-121.979
500000,3,1.75,1700,6120,1700,0,47.5807,-122.397
750000,2,1.5,1300,7632,1300,0,47.6134,-122.308
519900,4,2,1820,9350,1820,0,47.6288,-122.098
378500,2,1,880,6171,880,0,47.7262,-122.285
314500,3,1.75,1870,12381,1870,0,47.3358,-122.32
499950,3,1.5,1350,9315,1350,0,47.6587,-122.124
1.735E+06,5,3.5,4870,7700,3650,1220,47.5832,-122.29
630000,3,2.5,2460,38794,2460,0,47.7602,-122.022
360000,4,1.5,1720,6417,1720,0,47.7268,-122.311
460000,2,1.5,2730,19877,1570,1160,47.7698,-121.898
361000,3,1,1100,4046,1100,0,47.344,-122.331
713400,3,2.25,1810,9845,1810,0,47.5505,-122.221
445000,2,1,930,3150,930,0,47.6783,-122.298
305000,4,1.5,1590,131551,1590,0,47.2558,-122.024
1.43E+06,3,2.75,2710,9204,1480,1230,47.7039,-122.385
222000,3,1,1460,8400,1460,0,47.3086,-122.365
510000,5,3.25,3400,4499,2740,660,47.5385,-121.88
500000,5,3,2920,11440,2920,0,47.7607,-122.354
605000,2,1,910,3600,910,0,47.6341,-122.361
393000,3,2,1320,10720,1320,0,47.6203,-122.037
725000,4,2.5,2490,5170,2490,0,47.6836,-122.162
320000,3,1.75,2220,11646,1270,950,47.7762,-122.27
210000,4,1.5,1130,7840,1130,0,47.2986,-122.377
419900,4,2.5,2750,5767,2750,0,47.3595,-122.038
410000,4,2.5,2240,4447,2240,0,47.4868,-122.159
721000,3,2.25,2680,10440,1540,1140,47.561,-122.398
605000,2,2,1270,5500,1270,0,47.6121,-122.294
738000,3,1.75,1520,5500,1520,0,47.5839,-122.383
725000,6,3,2480,12000,2480,0,47.6131,-122.145
255000,2,1,960,20954,960,0,47.4485,-121.774
303000,3,2.25,1340,873,1340,0,47.7325,-122.343
394950,3,2.5,1090,7700,1090,0,47.607,-122.12
530000,4,3,2240,5580,1830,410,47.5598,-122.27
475000,4,2.5,3740,8700,2260,1480,47.4587,-122.117
250000,4,2.5,1800,8100,1800,0,47.3611,-122.047
180000,3,1,780,3540,780,0,47.565,-122.291
443500,2,1,1330,4140,930,400,47.6802,-122.306
390000,4,2,1900,76877,1900,0,47.3491,-122.113
430000,4,1.75,1570,7650,1100,470,47.6801,-122.106
460000,5,4.5,3100,7260,3100,0,47.5004,-122.162
660000,3,3.5,2740,3785,2190,550,47.7195,-122.182
515000,3,1.75,1570,10939,1200,370,47.6389,-122.102
482500,3,2,1330,6490,1330,0,47.7181,-122.308
305000,2,1.5,1140,2980,1140,0,47.5707,-122.018
835000,4,2.75,1550,4000,1550,0,47.6596,-122.28
237000,3,2,1290,7952,1290,0,47.3867,-122.19
445000,2,1.5,1510,2001,1510,0,47.6211,-122.153
710000,4,2.5,2720,8000,1360,1360,47.5237,-122.391
180000,3,1,840,5700,840,0,47.3948,-122.028
280017,3,2.5,1850,8770,1850,0,47.2091,-122.009
436500,4,2.5,2290,11173,2290,0,47.4314,-122.164
1.255E+06,4,2.5,3200,7535,3200,0,47.666,-122.276
420000,3,2.25,1800,9800,1300,500,47.7393,-122.244
205000,3,1,860,7467,860,0,47.4947,-122.237
570000,3,1.5,1980,10203,1680,300,47.3402,-122.046
565000,4,1.75,2140,7102,1070,1070,47.7042,-122.37
287000,2,2.5,2410,7500,1550,860,47.3078,-122.374
260000,4,1.75,1650,7276,1010,640,47.7721,-122.206
470000,4,1.75,1650,7276,1010,640,47.7721,-122.206
700000,3,2.5,2410,9916,2410,0,47.6911,-122.103
249000,3,1.75,1520,7500,1520,0,47.2646,-122.219
568000,3,1.75,2050,3520,1070,980,47.5536,-122.399
500000,4,1,1720,4011,1720,0,47.6719,-122.396
358000,5,2.5,2390,8775,1270,1120,47.4639,-122.17
225000,3,2.5,1680,6755,1680,0,47.3293,-122.17
275500,3,1,1060,7246,1060,0,47.4936,-122.165
495000,3,2.5,1860,3150,1860,0,47.719,-122.182
758800,5,2.25,1750,5000,960,790,47.6589,-122.276
280000,3,1.75,1480,8165,1480,0,47.3624,-122.079
380500,3,2.5,1900,7361,1900,0,47.4324,-122.191
3.2E+06,7,4.5,6210,8856,4760,1450,47.6307,-122.354
260000,3,1.75,1440,12888,1090,350,47.471,-122.262
630000,4,2.5,1910,1502,1910,0,47.6747,-122.393
875000,3,2,2010,4000,1210,800,47.6638,-122.329
457500,3,1,960,4600,960,0,47.5553,-122.286
900000,2,1,1240,5500,1240,0,47.6461,-122.317
235000,2,2,870,6450,740,130,47.5354,-122.278
410000,3,2,1400,45738,1400,0,47.3624,-122.455
355000,3,3,1850,9600,1230,620,47.7717,-122.25
1.3E+06,4,4,4270,6002,3180,1090,47.5443,-121.994
467500,3,1.75,2260,8512,1130,1130,47.7129,-122.304
500000,4,4.5,2690,7350,2690,0,47.7062,-122.311
995000,4,3.5,2780,9550,2530,250,47.454,-122.373
277000,3,1,1140,8144,1140,0,47.7464,-122.317
630000,4,2.25,2900,9680,1990,910,47.7037,-122.308
628000,5,2.75,2830,11795,1710,1120,47.5828,-122.118
655000,5,2.5,2560,46786,2560,0,47.7125,-121.915
170000,2,1,1240,9900,940,300,47.4862,-122.326
352500,4,2.5,2100,10750,2100,0,47.3338,-122.337
615000,4,2.75,3120,34040,3120,0,47.3431,-122.03
165000,3,1,970,6600,970,0,47.4836,-122.332
243500,4,2.5,2300,15188,2300,0,47.3683,-122.164
304000,2,1.5,950,676,850,100,47.6005,-122.306
369000,3,1.5,2110,5195,1210,900,47.5283,-122.286
779950,4,2.75,2990,4298,2990,0,47.7101,-122.108
605000,4,2.25,2940,48788,1520,1420,47.7422,-122.245
292500,4,2.5,1860,8709,1860,0,47.3289,-122.17
500007,2,1.75,1820,6050,910,910,47.6928,-122.323
449999,4,2.5,1950,4947,1950,0,47.5042,-122.193
355000,4,2.5,1890,7867,1890,0,47.3788,-122.031
258000,4,3,2710,7199,1710,1000,47.3789,-122.213
380000,4,2.25,2150,20181,1090,1060,47.7627,-122.245
650000,4,3,3720,57499,1880,1840,47.6469,-121.897
456500,4,2.5,2580,11780,2580,0,47.3658,-122.04
259950,4,2,1540,10212,1540,0,47.2056,-121.999
123000,2,1,1050,6600,1050,0,47.4828,-122.324
520000,3,2.25,1210,1250,1210,0,47.6722,-122.384
506000,4,2.25,2040,12000,1300,740,47.7362,-122.241
425000,3,1,980,4800,980,0,47.5663,-122.274
438000,5,2.5,1990,6840,1990,0,47.7162,-122.166
1.49E+06,4,2.5,2420,18480,2420,0,47.6214,-122.227
375000,4,2,1240,3000,1040,200,47.6076,-122.298
337500,3,2.25,1530,6600,1240,290,47.462,-122.188
300000,4,2.25,2080,7700,1450,630,47.4349,-122.17
627000,5,3.25,3570,5425,3570,0,47.5933,-122.007
1.4E+06,5,4.25,4230,6907,3450,780,47.6866,-122.205
674725,4,2.5,2700,10160,2700,0,47.5685,-122.012
325000,3,2.75,2200,7000,1280,920,47.4574,-122.169
230000,5,2,1210,12538,1210,0,47.2848,-122.361
485000,5,1.75,2140,43124,1220,920,47.5516,-122.085
315000,4,2.5,2740,8400,2740,0,47.1947,-122.008
560000,3,2.75,1370,1193,1370,0,47.67,-122.392
444000,4,3,2800,7198,2800,0,47.3538,-122.013
325000,3,1.5,1060,7488,1060,0,47.5549,-122.356
118125,2,1,790,7153,790,0,47.4869,-122.324
212000,2,1,790,7153,790,0,47.4869,-122.324
428900,4,2.5,2820,5056,2820,0,47.3591,-122.038
510000,3,2,1850,9600,1850,0,47.7671,-122.225
416000,3,1.5,1110,9762,1110,0,47.676,-122.15
950000,4,3,3230,438213,3230,0,47.4141,-122.47
204000,3,1.5,1460,7140,980,480,47.3954,-122.191
7.7E+06,6,8,12050,27600,8570,3480,47.6298,-122.323
878000,4,2.5,3480,13421,3480,0,47.5504,-122.097
1.045E+06,4,3,3560,4000,2970,590,47.6265,-122.3
350000,2,1,840,5551,840,0,47.5354,-122.28
659500,3,1.75,1820,5500,1620,200,47.6737,-122.283
395000,3,2.5,1630,15200,1120,510,47.7454,-122.103
308950,4,2.5,1920,8562,1920,0,47.1932,-122.008
410000,3,2,1750,2550,1750,0,47.7329,-122.343
710000,4,3,2750,7500,1630,1120,47.7134,-122.361
175000,1,1,620,8685,620,0,47.4095,-122.29
508800,3,2,1720,10098,1140,580,47.6231,-122.043
606400,3,3,1800,5000,1500,300,47.6475,-122.371
245100,3,1.75,1300,7958,1300,0,47.3162,-122.194
540000,3,2.5,1970,14876,1320,650,47.5031,-122.372
415000,3,1.5,1740,9046,1740,0,47.7402,-122.255
469500,4,2.75,1930,13041,1180,750,47.7502,-122.085
195000,3,1.75,1190,14777,1190,0,47.2933,-122.377
1.615E+06,4,3.25,4250,12281,3020,1230,47.5507,-122.113
1.45E+06,4,3.5,4360,24603,4360,0,47.6035,-122.005
1.2E+06,3,2.5,3420,16622,2410,1010,47.5638,-122.105
1.065E+06,4,3.75,4260,9800,4260,0,47.6739,-122.172
555500,2,1,920,10000,920,0,47.6938,-122.21
440000,3,1,1040,4000,1040,0,47.6178,-122.292
485000,3,1,1260,7250,960,300,47.6947,-122.311
693000,3,2.5,2460,12028,2460,0,47.691,-122.095
295000,3,1,830,3386,830,0,47.7027,-122.355
700000,3,2.5,2060,10650,1050,1010,47.5627,-122.137
767500,2,1.75,2210,9374,1560,650,47.6634,-122.359
800000,6,4.25,5480,189050,5140,340,47.412,-122.168
440000,3,2,1860,217800,1860,0,47.5157,-122.107
600000,3,2.5,1350,187313,1350,0,47.7369,-122.049
1.16E+06,4,2.5,2790,5450,1930,860,47.6453,-122.303
506000,2,1,1570,8210,1150,420,47.7221,-122.371
474950,4,1.75,2030,15400,1130,900,47.4603,-122.365
654000,3,2.5,2570,5500,1320,1250,47.6417,-122.397
710000,2,1,1210,6000,1000,210,47.6482,-122.402
620000,4,2.25,1530,7845,1030,500,47.5589,-122.082
390000,3,2,1510,10827,1510,0,47.654,-122.127
550000,3,2.25,1720,9600,1220,500,47.6581,-122.126
353000,3,1.75,2190,7021,1390,800,47.5033,-122.232
465000,4,2.5,3030,47958,1660,1370,47.4598,-122.004
279900,3,2,1410,6600,1410,0,47.3596,-122.089
700000,2,1.75,1679,577605,1679,0,47.463,-122.475
395000,4,1,1980,10350,1430,550,47.5226,-122.045
375000,4,2.5,1900,9428,1900,0,47.7628,-122.244
547000,4,1,1720,2800,1200,520,47.6743,-122.299
525000,5,3.25,2480,10277,1640,840,47.7726,-122.286
285000,3,1,1210,4731,1210,0,47.6865,-122.397
570000,2,1.75,1540,4025,1190,350,47.5876,-122.391
409000,3,2.5,2740,9168,2740,0,47.3835,-122.148
260000,4,2.5,1811,4381,1811,0,47.454,-122.19
348000,4,2.5,2720,7697,2120,600,47.4391,-122.161
389000,4,1,1520,9800,1520,0,47.7303,-122.236
445000,4,2.75,2160,7200,1220,940,47.7177,-122.224
400000,3,1.75,1390,4602,930,460,47.6944,-122.366
302000,4,2.5,1740,7895,1740,0,47.3401,-122.282
798000,3,2.5,2849,9588,2849,0,47.6487,-122.079
335000,2,1,1440,8842,840,600,47.7443,-122.325
585000,4,2.5,3000,6892,3000,0,47.7623,-122.165
2.5E+06,4,4,3330,24354,3330,0,47.5708,-122.192
555000,4,2.25,1720,2300,860,860,47.5762,-122.412
3.1E+06,3,3,3920,13085,3920,0,47.5716,-122.204
295000,3,2.5,1500,3060,1500,0,47.5605,-122.117
265000,4,1.5,2050,7100,1050,1000,47.3395,-122.28
330000,4,2,1180,7275,1180,0,47.7301,-122.2
286000,4,1.5,1600,5750,1600,0,47.5437,-122.28
305000,3,2.5,1260,895,1160,100,47.7072,-122.336
970000,2,1,1290,5376,1290,0,47.6966,-122.315
525000,4,2,2680,14157,1460,1220,47.4286,-122.292
355000,3,1.75,2370,9750,1280,1090,47.4459,-121.773
469950,5,2.5,2310,8303,1300,1010,47.7212,-122.211
435000,4,1,1450,8800,1450,0,47.5746,-122.135
363500,4,2.5,2680,7700,2680,0,47.4094,-122.17
595000,2,1.5,1030,4500,830,200,47.6455,-122.352
275000,3,1,1320,11090,1320,0,47.7748,-122.304
295000,2,1,670,7952,670,0,47.5124,-122.372
345000,3,2.25,2670,37089,2670,0,47.3347,-122.077
485000,3,2.25,2440,47916,2090,350,47.6347,-121.958
1.245E+06,5,2.5,3370,8113,3370,0,47.5812,-122.196
340500,2,1,940,5413,940,0,47.6956,-122.304
280000,3,1,1100,5132,840,260,47.7011,-122.336
449888,3,2.25,2520,78408,2520,0,47.3514,-122.279
483000,2,1.75,1400,4720,820,580,47.5705,-122.392
445500,3,1.75,1880,9360,940,940,47.7131,-122.283
379900,5,3.5,2800,7350,2800,0,47.5273,-122.345
599950,4,3.5,2500,3080,1810,690,47.6749,-122.14
215000,3,1,810,5240,810,0,47.4734,-122.35
263000,3,2.5,1720,6847,1720,0,47.3266,-122.272
565000,4,1,2170,12100,2170,0,47.6893,-122.164
950000,5,3,4530,258746,3200,1330,47.7702,-122.066
395000,4,1,1440,8320,1440,0,47.7529,-122.318
1.535E+06,4,3.25,2850,4100,1820,1030,47.6147,-122.285
922000,4,2.5,2620,14126,1620,1000,47.6983,-122.397
330000,3,2.5,1676,18778,1676,0,47.6521,-121.905
1.525E+06,4,3.75,5850,35070,4410,1440,47.5485,-122.124
323000,3,1.75,1910,8329,1910,0,47.19,-122.016
554000,2,2,1670,4996,1670,0,47.7141,-122.031
500000,3,2,2050,11454,2050,0,47.6389,-122.11
775000,5,3.5,3730,16679,2760,970,47.5987,-122.029
340000,4,1.75,1800,5210,1080,720,47.5298,-122.28
560000,4,1.75,2230,6838,1320,910,47.5742,-122.118
304000,3,2.5,1670,5298,1670,0,47.3925,-122.165
279900,3,1,1400,10800,1400,0,47.719,-122.202
315000,5,3,2110,10766,2110,0,47.3599,-122.176
849000,4,2,2160,6300,2160,0,47.5662,-122.404
325000,3,1.75,2420,14862,1380,1040,47.3301,-122.365
786000,4,3.5,3320,8808,3320,0,47.592,-121.989
384000,5,2.75,3220,8160,3220,0,47.3154,-122.254
907000,3,1.5,1340,6000,1340,0,47.66,-122.282
700000,3,2.5,2490,23891,2490,0,47.6716,-122.029
269500,3,2,1640,8395,1640,0,47.348,-122.035
269000,3,2.25,1420,7297,1130,290,47.4046,-122.194
749950,4,2.5,3340,123600,3340,0,47.6101,-121.955
325000,3,2.75,1580,4007,1580,0,47.7367,-121.969
1.15E+06,3,1.5,2170,16600,1130,1040,47.6307,-122.088
406000,3,1.5,1370,7853,1370,0,47.5409,-122.18
650000,4,2.5,2840,9354,2840,0,47.6274,-122.04
295000,3,1.75,1940,7500,1940,0,47.2062,-121.993
375000,4,2,1757,19370,1757,0,47.3974,-122.312
395000,2,1,980,5100,980,0,47.6824,-122.38
609000,6,3,2470,9267,2470,0,47.6025,-122.152
510000,3,1.75,1610,11950,1210,400,47.6705,-122.138
190000,3,2.25,1590,11745,1090,500,47.3553,-122.28
250000,1,1,780,1033,780,0,47.6155,-122.306
295000,3,1.5,720,7450,720,0,47.584,-122.375
740000,3,1.5,1630,4080,1630,0,47.6756,-122.308
323000,3,1,1590,7759,1590,0,47.5217,-121.819
713000,3,2.75,2310,1850,2020,290,47.5304,-122.073
1.07E+06,3,1.75,2320,6090,2040,280,47.643,-122.412
460000,3,1.75,1660,9900,1660,0,47.6704,-122.184
880000,3,1.75,2070,5000,2070,0,47.5828,-122.291
585000,4,1.75,2500,7000,1250,1250,47.648,-122.386
249950,2,1,940,8532,940,0,47.4814,-122.343
450000,3,2.5,1990,3478,1520,470,47.6361,-122.399
450000,3,2.5,2620,14096,2620,0,47.3513,-122.1
1.775E+06,4,3.25,3730,7071,3730,0,47.6292,-122.355
350000,3,3.25,1600,1298,1600,0,47.6954,-122.375
292500,3,2.5,2095,3438,2095,0,47.3523,-122.213
879000,4,2.75,4230,31747,4230,0,47.731,-122.132
1.184E+06,4,2.5,3200,7500,1860,1340,47.6826,-122.274
584999,4,2.75,2050,17859,1300,750,47.5945,-122.056
366000,4,2.75,2020,8093,1300,720,47.7685,-122.332
987500,4,2.25,3270,15760,2000,1270,47.5295,-122.229
300000,3,1,1320,7200,1320,0,47.5048,-122.19
299000,2,1.75,1270,7800,890,380,47.4438,-122.134
560000,4,1.75,1980,2700,1210,770,47.6865,-122.32
695000,3,2.5,2620,51354,2620,0,47.7211,-122.028
360000,4,1.75,1750,18810,1220,530,47.4719,-122.074
183500,3,1,1040,8892,800,240,47.3273,-122.349
311000,3,1.75,1900,3000,1070,830,47.5255,-122.265
263000,3,1.75,1660,7210,1660,0,47.3609,-122.274
269000,3,1.75,1530,7930,1530,0,47.3609,-122.05
1.6E+06,4,3.5,4280,9583,4280,0,47.5979,-122.197
564000,4,2.5,2870,6658,2870,0,47.5394,-121.878
425000,3,2.5,2540,5612,2540,0,47.4965,-122.157
679000,4,2.75,2100,4480,1780,320,47.6691,-122.294
410000,3,2,1740,9300,1740,0,47.4526,-122.357
340000,4,2.5,2441,7316,2441,0,47.3237,-122.337
360000,3,1.75,1810,7200,1030,780,47.4993,-122.364
450000,3,1.5,2060,44866,2060,0,47.7503,-122.051
552000,4,2.75,3160,8429,1620,1540,47.511,-122.251
294000,4,2,2930,12840,2930,0,47.2957,-122.187
663500,2,1,1310,5200,910,400,47.6784,-122.304
1.975E+06,6,4.5,4800,9097,3580,1220,47.6259,-122.291
175409,4,1.5,1450,5530,1450,0,47.3613,-122.087
459000,4,3,1900,9077,1900,0,47.7684,-122.304
339950,3,1,1050,5402,1050,0,47.5867,-122.311
393000,5,1.75,1610,15246,1610,0,47.5654,-121.894
275500,2,1,720,11400,720,0,47.7641,-122.341
485000,3,1,1020,9835,1020,0,47.5728,-122.179
250000,3,1,1250,7920,1250,0,47.4853,-122.126
935100,4,3.5,3200,8049,2700,500,47.5841,-122.172
245000,3,1,990,9599,990,0,47.2934,-122.215
670000,4,2.5,2850,25993,2850,0,47.5318,-122.17
1.393E+06,3,3.5,4240,21578,3500,740,47.5614,-122.215
440000,4,1.75,2800,49149,1400,1400,47.4649,-122.034
1.248E+06,2,2.5,2310,3313,2310,0,47.6318,-122.365
203000,3,1.75,1490,8000,1200,290,47.3187,-122.18
583000,4,2.5,1840,4011,1840,0,47.6662,-122.083
575000,3,1,1740,9163,1740,0,47.705,-122.299
2.575E+06,4,3.5,3280,3800,2880,400,47.6299,-122.28
1.6E+06,5,3.5,4050,20925,3020,1030,47.5348,-122.241
312500,4,2.5,2160,8755,2160,0,47.3585,-122.195
455000,3,2.75,2720,31314,2720,0,47.3689,-122.163
1.31E+06,5,3,3650,16600,1860,1790,47.56,-122.144
605000,4,2.25,1750,6120,1150,600,47.6958,-122.29
325000,3,2.25,2450,49658,1770,680,47.486,-121.726
630000,3,1.75,1940,7306,1470,470,47.6632,-122.153
928950,4,3.75,3280,6000,3280,0,47.554,-122.19
489950,3,1.75,2480,10804,1800,680,47.7721,-122.367
550000,3,2.25,2120,18255,1590,530,47.6279,-122.037
237000,3,2,1710,7920,1260,450,47.3473,-122.305
390000,3,2.5,1690,10113,1310,380,47.7381,-122.223
665000,3,2.5,2190,10370,2190,0,47.6218,-122.03
277000,4,3,1960,5160,1170,790,47.5313,-122.36
545000,3,1,1510,5000,1510,0,47.6708,-122.297
615000,3,2.5,1490,1410,1300,190,47.6478,-122.383
343000,3,1.75,2210,7920,1400,810,47.4968,-122.237
597000,4,2.5,2340,7877,2340,0,47.73,-122.315
600000,3,1,940,19000,940,0,47.5828,-122.19
479000,3,1.75,1470,6018,1470,0,47.6171,-122.044
292000,3,1.75,1650,14633,1650,0,47.4984,-122.176
265000,3,1.5,1400,6527,1110,290,47.4535,-122.358
623000,4,2.5,2710,49044,2710,0,47.774,-122.08
486000,4,2.5,2150,39449,1420,730,47.5531,-121.892
520500,3,2,1900,8100,950,950,47.6997,-122.319
1.3E+06,4,3.5,4380,74052,4380,0,47.6587,-122.009
825000,4,1,2290,6300,2150,140,47.5917,-122.29
259900,3,1.75,1690,7953,1690,0,47.3556,-122.175
1.17E+06,5,2.75,3090,12031,1600,1490,47.5342,-122.226
245000,2,1,1120,5650,720,400,47.5155,-122.255
830200,3,2.5,2680,4990,1440,1240,47.6538,-122.393
650000,4,2.5,2400,7351,2400,0,47.5707,-122.022
305000,4,2,1610,6250,1610,0,47.5293,-122.271
599000,5,2.5,3470,12003,3470,0,47.624,-122.048
272000,4,2.5,2070,6175,2070,0,47.3262,-122.174
415000,3,2.5,2420,10733,2420,0,47.3835,-122.035
319000,4,2.25,2380,7400,1760,620,47.3555,-122.149
425000,4,1.75,2120,15920,1060,1060,47.771,-122.258
297500,4,2.5,2190,8100,1250,940,47.3131,-122.392
725000,4,2.5,2740,12899,2740,0,47.5811,-122.028
325000,3,2.5,1830,7585,1830,0,47.3893,-122.154
460000,3,1.75,1370,8467,970,400,47.6644,-122.145
396480,3,1,1000,10800,1000,0,47.52,-122.03
1.025E+06,3,1,2050,4800,1950,100,47.6315,-122.311
370000,3,2.75,1750,9166,1170,580,47.7696,-122.325
260656,3,1,1620,13803,1620,0,47.3631,-122.028
431000,3,2.5,1710,12677,1710,0,47.75,-122.234
320000,3,1,1060,5000,1060,0,47.5294,-122.354
296500,3,2.75,2170,7900,1380,790,47.362,-122.277
679000,4,2.5,3080,8451,1540,1540,47.674,-122.154
359000,3,3,1320,1071,1080,240,47.5942,-122.296
330000,4,3,1920,12040,1920,0,47.4805,-122.301
350000,4,2.5,2440,4000,2440,0,47.3841,-122.036
242000,3,1.5,1640,8922,1640,0,47.495,-122.342
692500,3,2.5,2420,198198,2420,0,47.772,-122.022
441000,2,1.5,1190,3400,990,200,47.6726,-122.32
765000,4,2.5,2910,15016,2910,0,47.69,-122.097
375000,2,1,1010,4050,1010,0,47.5838,-122.382
365000,3,1.75,2080,7800,1220,860,47.4536,-122.355
580000,2,1.5,1990,6000,1430,560,47.6521,-122.398
1.605E+06,4,3.5,3920,19088,2240,1680,47.576,-122.214
841000,4,2.5,3080,13870,3080,0,47.6197,-122.149
515000,5,3,2670,11761,1370,1300,47.6895,-122.129
565000,5,2.5,4320,107157,2160,2160,47.4009,-122.059
365000,2,1.5,1200,6380,1200,0,47.697,-122.319
295000,3,1.5,1640,7222,1640,0,47.5215,-122.33
406500,2,1,870,5750,870,0,47.5637,-122.395
614905,3,2.5,2410,7225,2410,0,47.7211,-122.31
1.398E+06,5,2.25,2640,14959,1770,870,47.6191,-122.234
250000,2,1,990,10556,990,0,47.5118,-122.188
549000,5,1,1500,3978,1500,0,47.6811,-122.383
397000,4,2.5,1790,6590,1790,0,47.4829,-122.128
184000,3,1.75,1490,10125,1490,0,47.3075,-122.284
2.5E+06,4,3.25,3960,16224,3100,860,47.6701,-122.259
499100,3,1.5,1620,5108,1620,0,47.6978,-122.316
676101,4,1.5,2270,6010,1290,980,47.6743,-122.269
290000,3,1,1150,8145,990,160,47.7471,-122.317
390000,4,1.75,2180,7560,1560,620,47.757,-122.336
465000,3,1,910,4500,910,0,47.6828,-122.395
470000,3,2.75,2770,54707,2370,400,47.7555,-122.289
435000,3,1,940,7590,940,0,47.6231,-122.12
415000,3,1.75,2410,8944,1860,550,47.4494,-122.139
450000,3,2,1010,2820,1010,0,47.6066,-122.304
645000,3,2.5,2120,196995,2120,0,47.4089,-122.459
231000,4,2,1530,6375,1530,0,47.4692,-122.162
358000,3,1.5,1810,100188,1810,0,47.2175,-121.995
330000,3,1,1040,11900,1040,0,47.4332,-122.446
229950,2,1.5,1160,1848,1160,0,47.7366,-122.176
403250,2,1.5,1430,8137,1130,300,47.7307,-122.29
470000,3,2.5,2280,6134,2280,0,47.5335,-121.854
239000,3,1,1200,7810,1200,0,47.3631,-122.05
579000,4,1.5,2480,6000,1520,960,47.5233,-122.386
380500,3,2,1270,1348,1270,0,47.6929,-122.342
614285,5,2.75,2730,6401,2730,0,47.7685,-122.16
376000,2,2,1340,1635,1340,0,47.5476,-122.005
290000,3,1,1240,9300,1240,0,47.4363,-122.333
487000,4,2.25,2400,7000,1800,600,47.7207,-122.184
935000,4,2,1220,7489,1220,0,47.6133,-122.306
255000,4,2.5,2163,5882,2163,0,47.2736,-122.251
380000,2,2.5,1860,3504,1860,0,47.776,-122.239
450000,2,1,810,4368,810,0,47.6915,-122.312
622000,3,2.5,1950,7481,1950,0,47.564,-122.091
292500,3,2.25,1390,6004,1390,0,47.3536,-122.047
1.32E+06,4,3,2120,3600,1830,290,47.6344,-122.369
410000,4,2,1510,3240,870,640,47.5972,-122.296
160000,3,1.75,1010,5355,1010,0,47.5202,-122.351
809000,4,1.5,1840,4337,1840,0,47.6312,-122.307
183750,5,2.75,1650,5453,1650,0,47.5293,-122.285
411000,5,1.75,2860,12293,1430,1430,47.7385,-122.348
1.05E+06,3,1.75,2650,5512,2250,400,47.6265,-122.295
625000,2,1,1100,4160,1100,0,47.6352,-122.352
305000,3,2.25,1646,9519,1646,0,47.3646,-122.036
915000,4,4.5,5250,48352,5250,0,47.4858,-122.111
317000,3,1.5,1390,8300,1390,0,47.7383,-121.983
165000,2,1,780,6380,780,0,47.5423,-122.351
575000,2,1,1490,6000,1090,400,47.6296,-122.3
219900,3,1,970,7742,970,0,47.3173,-122.327
1.485E+06,4,3.25,3730,7200,2810,920,47.6824,-122.199
300000,3,1,1090,9900,1090,0,47.6755,-122.16
520000,3,1.75,1940,219527,1940,0,47.4214,-122.02
310000,4,2.25,1780,8820,1480,300,47.3618,-122.289
322500,3,2,1190,6445,1190,0,47.5057,-122.172
320000,4,2.25,2000,10374,2000,0,47.3342,-122.34
440000,3,2.5,1390,4997,1390,0,47.5303,-121.855
578000,3,1,1500,4500,1120,380,47.6873,-122.385
382000,2,1.5,1070,877,1070,0,47.6699,-122.393
535000,3,2.5,1720,4006,1720,0,47.569,-122.007
679000,4,2.5,3680,7236,3680,0,47.3543,-122.005
258900,3,2.25,1400,10436,1040,360,47.4261,-122.144
563000,3,1.5,1730,9509,1270,460,47.7067,-122.282
562000,5,3,2795,15101,2795,0,47.7301,-121.972
725000,4,1.75,2000,3750,1120,880,47.6816,-122.374
236775,3,2.5,1830,8372,1830,0,47.3116,-122.4
860000,4,3.5,3380,8098,1690,1690,47.6839,-122.19
270000,3,1.5,1500,6337,1500,0,47.7276,-122.312
621000,4,2.75,1950,6930,1250,700,47.616,-122.113
527900,3,2.5,2490,5928,2490,0,47.5385,-121.87
395000,4,2.25,1780,10748,1780,0,47.762,-122.11
320000,3,2,1110,10500,1110,0,47.4456,-121.773
300000,4,2.5,2500,4750,2500,0,47.3666,-122.122
320000,3,1.75,1480,7225,1480,0,47.513,-122.185
625000,3,2.25,2570,47480,2570,0,47.6854,-122.079
505000,2,1,810,5060,810,0,47.5635,-122.394
300000,4,2.5,2700,10814,1560,1140,47.369,-122.177
363000,4,2.5,2180,9281,2180,0,47.3673,-122.072
1.7E+06,4,3.5,4330,15335,3230,1100,47.5315,-122.231
1.1468E+06,4,3.5,4210,10308,4210,0,47.5905,-122.117
680000,4,2.5,2880,9202,1780,1100,47.6658,-122.139
678940,5,2.25,2610,4080,1750,860,47.6757,-122.309
299000,3,1.75,2010,8065,1090,920,47.4171,-122.202
379900,4,1.75,1500,11600,1000,500,47.7373,-122.241
205000,3,1,1290,6566,1290,0,47.3004,-122.377
387500,4,1,1320,4440,1320,0,47.6145,-122.295
256000,3,1,1290,4720,790,500,47.5186,-122.358
548000,4,2.5,2440,11005,2440,0,47.5318,-122.176
163000,3,1.75,1290,4811,1290,0,47.3912,-122.234
367500,2,2,1030,600,680,350,47.5788,-122.41
390000,3,2.25,1640,2875,1240,400,47.5686,-122.286
415000,4,2.5,1160,16008,1160,0,47.7643,-122.295
449000,4,2.25,2230,8440,2230,0,47.7558,-122.217
460000,5,2,1910,12264,1010,900,47.601,-122.134
395000,4,2,1980,15354,1980,0,47.638,-121.968
300000,3,2,1470,16500,1470,0,47.3617,-122.061
345000,3,1.75,1520,7439,1520,0,47.457,-122.208
825000,3,1.75,1930,8442,1930,0,47.6313,-122.204
539950,3,2.5,1330,2180,1330,0,47.6987,-122.365
410000,4,2,1580,9581,1580,0,47.692,-122.165
245000,3,1,1370,6000,1370,0,47.4879,-122.339
482000,4,2.75,3010,15750,1560,1450,47.7336,-122.183
270000,3,1.75,1390,9000,1390,0,47.4469,-121.772
475000,3,1.75,1330,14560,1330,0,47.6599,-122.135
445800,3,2,1320,6500,1320,0,47.7119,-122.319
518000,4,3,2430,11670,1330,1100,47.7307,-122.228
785000,2,0.75,1260,4800,1080,180,47.6843,-122.212
430000,3,2.5,1690,1310,1140,550,47.5404,-122.387
715000,4,1.75,3420,7200,1770,1650,47.7081,-122.277
560000,3,1.5,2790,6900,1700,1090,47.7328,-122.288
449000,3,1.75,1270,6600,1270,0,47.5976,-122.295
805000,4,2.5,2910,9000,2910,0,47.5451,-122.142
296000,3,2.5,1560,5845,1560,0,47.3851,-122.029
275000,2,1,770,4840,770,0,47.551,-122.376
419950,3,1.75,1770,16909,1770,0,47.4458,-122.134
285000,3,1.75,1100,1307,780,320,47.5601,-122.363
775000,3,2.5,2890,8470,2890,0,47.5785,-122.054
288250,3,1.75,2110,15400,1380,730,47.4861,-122.226
257000,2,1.75,1220,2268,610,610,47.592,-122.295
377000,1,1,950,10585,950,0,47.6968,-122.297
550000,2,1,1420,3100,820,600,47.6737,-122.365
339000,3,1,1100,4128,720,380,47.5296,-122.379
481500,3,1.75,2140,6000,1070,1070,47.6913,-122.366
224500,3,1.75,1300,7735,1300,0,47.1983,-122
260000,3,1,1790,11884,1790,0,47.3887,-122.22
865000,2,1,1470,5400,1470,0,47.6391,-122.36
730000,5,3,2500,11779,1550,950,47.5696,-122.127
550000,2,1,980,3080,980,0,47.6646,-122.339
645000,3,2,2130,4000,2130,0,47.6741,-122.323
250000,3,1.75,1360,16000,1360,0,47.7583,-122.306
507200,3,3.5,1630,1329,1360,270,47.6159,-122.306
380000,4,2.5,2500,11070,1300,1200,47.336,-122.334
540000,4,1.75,2260,19500,1450,810,47.6555,-122.086
738500,3,2.5,2300,6009,2300,0,47.7067,-122.013
206000,3,1,1060,10350,1060,0,47.365,-122.028
265000,2,1,940,9458,940,0,47.7523,-122.311
190000,1,0.75,780,77603,780,0,47.4396,-122.104
339900,3,1,1200,9087,1200,0,47.5234,-122.177
250000,6,2.5,2590,10890,1340,1250,47.4126,-122.165
416500,3,1,1100,4184,1100,0,47.5309,-122.382
575000,4,2.5,2890,9775,2890,0,47.5339,-121.854
385000,3,1.75,1230,7500,1230,0,47.7316,-122.224
253000,3,1,1030,6250,1030,0,47.4988,-122.168
460000,3,1,1140,4600,1140,0,47.6897,-122.337
1.445E+06,4,2.5,3200,3600,2600,600,47.632,-122.369
492000,2,1,950,6000,950,0,47.6897,-122.294
275000,4,2,1960,30480,1060,900,47.1924,-121.988
542500,5,3.25,3010,1074218,2010,1000,47.4564,-122.004
345000,2,1,1080,7775,1080,0,47.5447,-122.394
575000,4,2.75,2730,35075,1530,1200,47.7726,-122.139
275000,5,2.5,2570,17234,1300,1270,47.7753,-122.355
510000,6,4.5,3300,7561,3300,0,47.6795,-122.104
2.538E+06,4,3.5,4350,6000,2970,1380,47.6277,-122.286
830000,3,3.5,3820,145054,2870,950,47.4419,-121.736
640000,4,2.5,2260,5172,2260,0,47.7047,-122.128
702000,4,2.75,3880,15025,3880,0,47.6777,-122.035
960000,3,2.5,2010,6857,1450,560,47.6402,-122.314
190000,3,1,950,7610,950,0,47.3188,-122.174
500000,3,2.25,1730,13040,1290,440,47.6809,-122.119
529000,3,2.5,3070,22098,3070,0,47.4724,-122.147
435000,3,1.75,1500,8173,1500,0,47.7293,-122.227
670000,3,1.75,2160,5760,1260,900,47.5346,-122.391
365000,3,2.25,1960,1985,1750,210,47.5419,-122.289
1.27E+06,5,3,3950,9520,2250,1700,47.6363,-122.207
465000,3,1,1100,145490,1100,0,47.5697,-121.898
285000,3,1.5,1400,7582,1400,0,47.4536,-122.33
219950,3,1,1020,4960,920,100,47.5328,-122.275
220000,3,1.5,1600,10548,1600,0,47.2925,-122.284
1.465E+06,6,4.5,4230,6420,2360,1870,47.6301,-122.369
1.11275E+06,5,3.5,3090,3600,2060,1030,47.6217,-122.309
694000,2,2.5,2320,9311,2320,0,47.7226,-122.03
620000,3,2.5,2440,10363,2440,0,47.5634,-122.016
415000,3,1,2020,19210,1760,260,47.7552,-122.229
765000,3,3,3270,38088,3270,0,47.6692,-122.028
864000,4,1.75,2260,6600,1220,1040,47.6753,-122.278
385000,5,2,2020,4000,2020,0,47.5799,-122.305
725000,3,1,1000,19969,1000,0,47.6745,-122.197
545000,4,2.25,2030,11585,1590,440,47.6561,-122.13
299900,3,1.75,1730,9893,1730,0,47.3747,-122.164
639500,3,1.75,2010,8072,2010,0,47.6327,-122.097
345000,4,1.5,1540,7168,1160,380,47.455,-122.198
1.125E+06,6,4,5330,18116,3950,1380,47.5503,-122.137
345000,2,1,960,2700,780,180,47.6013,-122.299
600000,3,2,1460,2800,730,730,47.67,-122.295
355000,4,1.75,2160,7417,1360,800,47.5122,-122.181
698000,3,2.75,2640,11957,2260,380,47.6491,-122.12
566000,4,2.25,2170,7737,2170,0,47.637,-122.029
449950,3,2.5,1530,3840,1530,0,47.5691,-122.007
404600,3,1,1570,7727,1270,300,47.4821,-122.192
258000,3,1,1490,7435,1120,370,47.368,-122.314
415000,4,2,1960,10559,1960,0,47.7494,-122.337
320000,4,2.25,2190,9020,2190,0,47.3742,-122.284
295000,3,2.5,1690,4102,1690,0,47.3552,-122.015
389000,5,2,2330,10750,1190,1140,47.7325,-122.245
299900,3,1.75,1470,27000,1470,0,47.3943,-122.311
394000,3,2.5,2550,5349,2550,0,47.3504,-122.026
762000,4,2,2130,5500,2130,0,47.6807,-122.199
697000,4,2.75,3650,48351,3650,0,47.7632,-122.089
485000,3,2.5,3340,70131,2420,920,47.2666,-122.015
189900,2,1,800,5600,800,0,47.4959,-122.172
2.15E+06,3,2.75,3470,9610,3470,0,47.7205,-122.26
345000,3,1.5,1030,6969,1030,0,47.5492,-122.3
376500,3,2,1630,7800,1630,0,47.7326,-122.307
775000,3,2,2010,7017,2010,0,47.6828,-122.267
450000,3,1,1360,3737,1360,0,47.6751,-122.362
760000,4,2.25,2040,8315,1480,560,47.7077,-122.371
569000,4,2.5,2830,10954,2830,0,47.5396,-121.882
500000,3,1.5,2040,6750,1280,760,47.7013,-122.369
592500,2,2,1340,5350,1340,0,47.6384,-122.403
620000,4,2.5,2130,9139,2130,0,47.5648,-122.01
1E+06,5,4.25,3920,16258,2900,1020,47.5871,-122.192
815000,3,2.5,2415,2186,2415,0,47.6506,-122.202
775000,5,2.75,3750,12077,3750,0,47.3525,-122.002
340000,3,1,1010,7500,1010,0,47.6169,-122.062
458000,2,1.75,990,5850,990,0,47.7132,-122.321
250000,2,1.5,1200,5773,1200,0,47.4723,-122.19
151600,2,1,1060,16988,1060,0,47.4305,-122.157
515000,4,2.5,3200,6473,3200,0,47.5012,-122.15
216000,2,1,1810,10360,1010,800,47.5039,-122.266
245000,3,1.75,1670,24650,1670,0,47.1764,-122.026
645000,3,2.75,1850,16960,1850,0,47.7128,-122.365
249900,3,1,1100,5000,1100,0,47.5433,-122.283
410000,3,1.75,1660,6250,830,830,47.5859,-122.385
499000,6,1.75,2400,7500,1400,1000,47.7661,-122.313
790000,5,3.25,2900,12160,1890,1010,47.6154,-122.168
458000,1,2.25,2140,10350,1470,670,47.7352,-122.17
925000,4,2.5,2670,5100,1940,730,47.6768,-122.39
152000,3,1,1090,3264,1090,0,47.3155,-122.182
402000,3,2.5,1970,12205,1970,0,47.7397,-122.209
340000,2,2,1250,1178,980,270,47.5426,-122.387
1.25E+06,4,2.5,4040,11350,3690,350,47.559,-122.162
775000,4,2.5,3220,38448,3220,0,47.6854,-122.053
299800,2,1,1310,2814,810,500,47.5185,-122.376
340000,4,2.25,2060,8400,1300,760,47.4984,-122.23
626000,3,2.25,1750,1572,1470,280,47.6498,-122.321
324950,2,1,1150,9186,1150,0,47.5081,-122.33
535500,3,2.5,2050,4976,2050,0,47.5689,-121.995
817500,3,3.25,3230,7639,3230,0,47.6338,-122.063
810000,4,3.5,4170,4322,2940,1230,47.6136,-122.041
565000,5,1.5,1940,3430,1220,720,47.6853,-122.362
978000,3,1.5,2390,4000,1690,700,47.6604,-122.28
530000,3,1,1440,27505,1440,0,47.7553,-122.37
305000,4,2.5,2230,6487,2230,0,47.3287,-122.169
345000,3,2.5,1210,1420,1210,0,47.6977,-122.349
258000,2,2,750,6553,750,0,47.4982,-122.221
275000,4,1,1770,7345,1770,0,47.5393,-122.351
310000,3,1,1020,55756,1020,0,47.3836,-122.082
713250,3,2,2050,9000,2050,0,47.5885,-122.245
500000,3,1,2000,21780,1480,520,47.6064,-122.039
472000,3,1.75,2180,7200,1090,1090,47.5044,-122.235
250000,3,1,920,4429,920,0,47.5369,-122.291
725000,4,2.25,3440,14237,3440,0,47.7241,-122.065
345000,3,2,1610,15005,1610,0,47.6886,-121.911
460000,3,1.5,1870,15685,1470,400,47.723,-122.353
440150,2,1,1110,6800,1000,110,47.7184,-122.355
390000,3,1.75,2200,8036,1270,930,47.7763,-122.209
375000,2,1,790,5120,790,0,47.557,-122.395
224950,3,1.5,1630,9282,1630,0,47.2021,-122.002
480000,3,1.5,2100,67269,1220,880,47.7592,-122.23
721000,4,2.75,2690,5400,2210,480,47.6963,-122.367
174000,2,1,600,4854,600,0,47.4927,-122.28
170000,2,1,810,9882,810,0,47.4925,-122.239
658000,3,1.5,1660,3190,1660,0,47.6368,-122.351
860000,3,2,1880,8494,1200,680,47.6217,-122.192
407450,4,1.5,2310,68824,2310,0,47.3354,-122.031
615000,4,1.5,2650,34000,2650,0,47.7516,-122.237
920000,4,3,3130,12381,3130,0,47.5599,-122.118
195000,2,1,860,10400,860,0,47.3682,-122.096
269950,3,1,990,9950,990,0,47.5104,-122.171
855000,4,3.5,4030,1024068,4030,0,47.4619,-121.744
620000,3,2.25,1780,1429,1570,210,47.6413,-122.346
276000,2,2,1480,6075,740,740,47.5317,-122.276
329000,3,1,1140,5258,1140,0,47.5122,-122.383
270000,3,1.5,1230,7500,1230,0,47.4202,-122.331
440000,4,2.5,3080,10646,3080,0,47.3828,-122.148
639000,4,2.5,1990,8034,1990,0,47.561,-122.018
403500,1,1,700,5621,700,0,47.734,-122.353
585000,3,2.5,1700,1156,1320,380,47.6373,-122.369
216000,2,1,860,9000,860,0,47.4801,-122.315
1.15E+06,3,2.5,3160,24437,2160,1000,47.5531,-122.131
575000,3,2,2500,30056,1840,660,47.4468,-122.337
430000,4,2.5,3000,9460,3000,0,47.3959,-122.211
660000,2,1,1670,8195,1670,0,47.6627,-122.192
338000,2,1,690,6400,690,0,47.5287,-122.367
400000,4,2.75,1240,3867,800,440,47.7157,-122.284
210000,2,1,900,5000,900,0,47.2008,-121.995
305000,4,1.75,2200,8100,1400,800,47.4945,-122.303
365000,2,1,960,223898,960,0,47.6668,-121.892
325000,5,2.75,2130,6222,1300,830,47.5272,-122.276
245000,4,1.75,2020,8800,2020,0,47.3202,-122.384
182000,3,1,1060,7350,1060,0,47.3809,-122.287
440000,2,1,1230,6600,1130,100,47.5573,-122.282
225000,3,2.25,2510,12013,2510,0,47.3473,-122.314
358000,3,2.25,2510,12013,2510,0,47.3473,-122.314
580000,5,2.5,2720,5000,1530,1190,47.6827,-122.376
240000,3,1.5,1070,8886,1070,0,47.3516,-122.166
700000,4,3.25,3580,43093,3580,0,47.5595,-121.901
325000,4,2.5,2230,8500,2230,0,47.2082,-122.009
488000,4,2.25,2500,10890,1800,700,47.7318,-122.239
875000,4,1,1670,4600,1670,0,47.6838,-122.332
615000,4,2.5,2150,9070,2150,0,47.7279,-122.107
321000,3,2.5,2020,4183,2020,0,47.3658,-122.017
1.035E+06,3,2.5,2230,5750,2230,0,47.6938,-122.213
299500,2,1,740,6300,740,0,47.5158,-122.376
459000,4,1.5,2020,9583,2020,0,47.7283,-122.238
435000,3,2.5,1730,4065,1730,0,47.5668,-122.005
222000,3,1.75,1370,8280,1370,0,47.4096,-122.172
485000,4,1,1210,6380,1210,0,47.6924,-122.321
750000,5,3.5,2160,2323,2160,0,47.6726,-122.39
266000,3,2.25,1550,6022,1550,0,47.3525,-122.304
455000,2,1,1170,6000,970,200,47.6994,-122.354
490000,3,1.75,2020,215622,2020,0,47.4189,-122.499
280000,3,1.75,1740,8625,1240,500,47.3054,-122.38
1.45E+06,4,3.25,3100,3900,2090,1010,47.6385,-122.348
291000,4,1,1590,24330,1140,450,47.4906,-122.309
745000,5,3,2400,10126,2400,0,47.5726,-122.373
685900,3,2.5,2290,9142,2290,0,47.691,-122.387
160000,3,1.75,1610,7392,1610,0,47.3413,-122.28
650000,4,2.5,2240,9934,1490,750,47.6147,-122.166
250000,2,1,850,6370,850,0,47.5198,-122.373
265000,2,1.5,920,1458,920,0,47.7081,-122.342
599000,5,3.25,2590,6180,1330,1260,47.551,-122.272
199950,3,1,1340,7260,1340,0,47.4934,-122.237
712500,4,2.75,2420,11201,1420,1000,47.5459,-122.265
490000,2,1,1420,4305,920,500,47.6864,-122.311
511500,4,1,1360,6000,1360,0,47.6854,-122.288
299000,3,1,1510,6200,1010,500,47.5293,-122.274
685000,4,2.5,2650,25248,2330,320,47.7537,-122.373
597000,4,2,2120,4000,1720,400,47.688,-122.383
210000,3,1,1200,7200,1200,0,47.3746,-122.183
659000,4,2.5,3190,11375,2210,980,47.704,-122.3
540000,3,1,1050,4160,1050,0,47.6756,-122.3
469000,3,2,1300,22605,1300,0,47.5337,-122.187
1.065E+06,3,2.5,3970,263538,3970,0,47.6067,-121.952
575000,5,2.5,2990,7500,1800,1190,47.7707,-122.369
725000,4,2.75,2440,7042,1640,800,47.5731,-122.408
299950,4,1,1170,5400,1170,0,47.492,-122.172
375000,4,2,2270,18450,2270,0,47.3264,-122.262
342450,3,1.5,1280,5525,1280,0,47.7339,-122.336
315000,4,2.5,1950,3225,1950,0,47.5014,-122.226
328000,4,2.75,1930,3840,1170,760,47.5303,-122.346
323000,4,2.75,1970,7213,1170,800,47.4424,-122.126
320000,4,3,1820,3120,1000,820,47.5468,-122.274
550000,2,1,950,4080,950,0,47.6765,-122.384
1.646E+06,6,3.5,4010,16200,2090,1920,47.6322,-122.216
1.2125E+06,4,3.5,4560,16643,2230,2330,47.5521,-122.115
1.2E+06,4,3.5,4560,16643,2230,2330,47.5521,-122.115
120000,3,1,1150,8924,1150,0,47.3865,-122.217
175000,3,1,1150,8924,1150,0,47.3865,-122.217
169900,3,1,910,5800,910,0,47.2068,-121.992
508000,6,2.75,2890,7500,1830,1060,47.7099,-122.23
335000,2,1,1070,6678,1070,0,47.7315,-122.357
613200,3,2.75,2050,3320,1580,470,47.6719,-122.301
420000,2,1.5,1040,3500,1040,0,47.588,-122.304
1E+06,4,3.25,3320,8587,2950,370,47.691,-122.337
342000,2,1,740,6180,740,0,47.5517,-122.272
850000,4,2,3380,90968,1690,1690,47.5936,-122.077
582000,2,1.75,1210,4141,910,300,47.686,-122.382
475000,3,2.5,2480,6031,2480,0,47.772,-122.297
570000,3,2.25,2010,6000,1330,680,47.6912,-122.115
826600,4,3.25,3230,5000,1750,1480,47.6702,-122.3
387000,2,2.5,1170,1394,1170,0,47.6131,-122.297
330000,3,1,1250,9126,1250,0,47.7554,-122.076
653450,3,2.5,2070,49658,1540,530,47.5936,-122.013
285000,2,1,1050,3088,1050,0,47.5471,-121.996
217000,3,1,1400,7800,1400,0,47.4789,-122.159
615000,3,1,1120,12500,1120,0,47.6842,-122.2
580135,4,2.5,3150,5886,3150,0,47.4787,-122.122
1.15E+06,4,3.5,4540,19767,4200,340,47.5445,-122.137
231200,3,2,1400,8821,1400,0,47.1949,-121.989
680000,4,2.75,2500,4950,2500,0,47.6964,-122.017
267500,3,1.5,1390,2153,1390,0,47.5506,-122.29
942000,4,2.75,3160,37200,2310,850,47.7214,-122.285
435000,3,1.75,1310,8065,1310,0,47.701,-122.368
315000,2,1,1740,3622,950,790,47.5541,-122.29
354901,3,2.5,1490,1709,1490,0,47.7173,-122.299
439888,2,2,1300,6515,1300,0,47.7078,-122.013
360000,4,1,1460,3840,1340,120,47.533,-122.347
205000,4,1,1030,6621,1030,0,47.4857,-122.221
299995,3,2.5,1970,7500,1970,0,47.2658,-122.218
150000,2,1,790,7275,790,0,47.4771,-122.174
575000,3,2.25,3800,33825,3330,470,47.3797,-122.152
625000,3,2,2168,12616,2168,0,47.4933,-122.367
950000,4,3.5,4140,13392,4140,0,47.5261,-122.144
278800,4,2.5,2440,7797,1560,880,47.3895,-122.222
713500,3,2,1720,4200,1720,0,47.6285,-122.301
1.9E+06,4,2.25,3020,11489,2110,910,47.5395,-122.21
439000,5,2,2610,5009,1710,900,47.6969,-122.366
425000,3,2,1500,8086,1060,440,47.5584,-122.081
252500,4,2.5,2600,11280,1570,1030,47.336,-122.304
185000,3,1.5,1370,8470,1370,0,47.2874,-122.192
406550,5,2.75,2400,15781,1200,1200,47.622,-122.059
243000,2,1.5,1068,1758,1068,0,47.7527,-122.244
500000,3,1.5,2220,8994,1110,1110,47.5473,-122.172
204750,2,1,880,7575,880,0,47.3757,-122.304
222000,3,1.5,1310,9273,1310,0,47.3683,-122.147
200000,4,1,1350,11507,1350,0,47.4269,-122.197
367000,3,2.25,1400,1320,1400,0,47.7147,-122.356
183000,3,1,1170,7320,1170,0,47.4685,-122.282
300000,3,2.5,1020,1570,720,300,47.5871,-122.317
369000,3,1.75,1300,3844,1300,0,47.7024,-122.355
380000,3,2,2010,16736,2010,0,47.7643,-122.352
463000,3,2,1590,5009,1590,0,47.7012,-122.322
475000,3,1,1470,9750,1470,0,47.7155,-122.194
225000,3,1.75,1580,14400,1580,0,47.2598,-122.281
371000,3,1.75,1970,9512,1970,0,47.4545,-122.146
625000,3,2.5,2330,3141,2330,0,47.5622,-122.392
3.2E+06,6,5,7100,18200,5240,1860,47.6427,-122.408
329000,3,1.75,1230,10725,1230,0,47.4431,-121.772
634000,3,1.75,2570,13000,2570,0,47.7705,-122.371
616000,4,2.5,3440,6915,3440,0,47.3538,-122.004
1.8241E+06,3,2.25,3330,20053,3330,0,47.6395,-122.214
435000,4,2.25,1780,2684,1780,0,47.7642,-122.149
320000,4,2.5,2110,6295,2110,0,47.3641,-122.193
820000,4,3.5,2770,8049,2770,0,47.6469,-122.081
310000,3,2.5,1590,3359,1590,0,47.7349,-121.986
443750,3,2.25,1460,968,1140,320,47.6601,-122.4
795000,4,2.25,2070,13084,1700,370,47.5606,-122.222
475000,3,2.5,2420,36862,1530,890,47.3264,-122.308
585000,5,1.75,2000,3750,2000,0,47.6618,-122.355
315000,2,1,1010,7338,1010,0,47.5123,-122.19
635000,4,2.5,3050,7238,3050,0,47.5772,-122.013
305000,3,1,1160,11776,1160,0,47.7427,-122.074
785000,3,2,2180,5440,1100,1080,47.657,-122.345
525000,3,1.75,1560,6000,780,780,47.6501,-122.384
537000,4,1.75,1580,3635,790,790,47.6795,-122.371
279950,3,1.75,1660,8303,1380,280,47.4366,-122.171
659000,4,2,2350,9329,2350,0,47.583,-122.17
203000,2,1,1440,6650,970,470,47.2896,-122.369
782500,4,2.5,2930,7806,2930,0,47.6219,-122.024
250000,3,1.75,1590,7560,1130,460,47.4016,-122.18
279000,3,1,1400,9450,1060,340,47.5051,-122.194
664000,6,2.5,3190,12196,3190,0,47.6309,-122.103
2.9E+06,4,3.25,4580,4838,3080,1500,47.6305,-122.354
378500,4,2,1830,6000,1070,760,47.5453,-122.279
535000,3,1.75,2720,149410,2720,0,47.7092,-121.892
520000,2,1,1360,22508,1360,0,47.7101,-122.226
369950,3,2,1520,4000,800,720,47.531,-122.351
545000,3,2.25,2290,14585,2290,0,47.5874,-122.074
360000,3,2.5,2150,14092,2150,0,47.4621,-122.129
760000,3,1.5,1170,7645,1170,0,47.6077,-122.194
450000,3,1.75,1830,5488,1010,820,47.6914,-122.309
612500,4,2.5,2730,12261,2730,0,47.7419,-122.205
280000,3,1,1090,10710,1090,0,47.5,-122.169
750000,3,2.5,2560,9182,2560,0,47.5361,-122.051
237000,3,1,1160,6132,1160,0,47.5015,-122.173
441500,2,1.75,1010,4000,1010,0,47.6665,-122.287
251000,3,2,1650,7930,1650,0,47.3617,-122.05
200000,3,1,2120,31564,1220,900,47.4938,-122.298
332000,1,1,960,2640,760,200,47.6223,-122.294
401500,3,2.5,1509,1114,1509,0,47.7048,-122.34
585000,4,1.75,2270,27122,1300,970,47.7637,-122.281
340000,4,2.5,1954,4805,1954,0,47.4297,-122.19
920000,3,3.5,2800,7694,2800,0,47.7095,-122.022
153000,3,1,1270,6405,1270,0,47.4959,-122.241
299950,4,2.25,1810,7601,1080,730,47.2857,-122.358
440000,4,2.5,2410,7517,2410,0,47.4388,-122.142
293000,3,2.5,1690,17383,1690,0,47.3691,-122.031
203000,3,1.75,1190,6000,1190,0,47.5026,-122.236
193000,2,1.75,1280,6774,1280,0,47.2925,-122.219
305000,3,1.75,1460,7862,1460,0,47.7755,-122.299
495000,4,1.75,1600,6380,1130,470,47.701,-122.306
420000,3,1.75,1770,6000,1130,640,47.7135,-122.315
569500,4,2.5,2800,8190,1700,1100,47.7695,-122.368
620000,4,2.5,2680,9185,2680,0,47.5738,-121.992
466000,3,1.75,1680,9460,1680,0,47.5525,-122.182
355500,3,1,1120,10032,1120,0,47.7182,-122.194
687500,2,1,1040,7200,1040,0,47.6823,-122.203
432100,3,2.25,1790,2240,1790,0,47.6343,-122.106
500000,3,2.5,2410,34848,2410,0,47.5694,-122.12
690000,5,3.25,3370,7313,2140,1230,47.5632,-122.015
350000,2,1,800,5150,800,0,47.5525,-122.274
268000,2,1,1380,5000,870,510,47.5339,-122.293
120000,2,1,990,39964,990,0,47.3577,-122.085
285000,4,2.5,1800,9229,1800,0,47.1927,-122.015
365000,4,1.5,1820,12327,1380,440,47.5767,-122.144
635000,3,2.5,2620,6842,2620,0,47.6846,-122.037
630000,2,2.5,2290,3507,2290,0,47.5545,-122.002
450000,4,3,2200,4466,2200,0,47.7005,-122.339
590000,4,2.5,2940,12600,1850,1090,47.6294,-122.062
895000,2,1.75,1700,3618,1260,440,47.6336,-122.397
160000,3,1,860,11900,860,0,47.3574,-122.186
520000,2,1,910,5000,910,0,47.6733,-122.37
432000,4,3.25,2820,13059,2820,0,47.4508,-122.132
141800,2,1,930,4743,930,0,47.4966,-122.187
980000,4,2,2190,4560,2190,0,47.662,-122.329
1.29E+06,4,2.5,3430,7200,3430,0,47.6842,-122.196
740000,4,2.75,2560,6900,1480,1080,47.686,-122.297
230000,2,1,770,6450,770,0,47.531,-122.358
3.4E+06,3,4.5,5230,17826,3740,1490,47.5348,-122.243
954500,3,2.25,2440,9689,1830,610,47.6141,-122.111
622000,3,1.5,1650,3150,1650,0,47.6156,-122.297
90000,1,1,780,4000,780,0,47.5424,-122.321
342000,3,3,1260,1634,1260,0,47.697,-122.349
305000,4,2.5,2320,4683,2320,0,47.3349,-122.059
259900,4,2.75,1560,8820,1060,500,47.3382,-122.257
420000,3,2,2330,6346,1600,730,47.5135,-122.38
250000,2,1,1400,19570,1100,300,47.4724,-122.271
249950,3,1.5,1450,6875,1450,0,47.4205,-122.316
199000,2,1,1140,15120,990,150,47.4521,-122.196
355200,3,1,1120,7320,1120,0,47.5103,-122.382
425000,3,1.5,1970,13709,1680,290,47.7562,-122.277
379500,3,1,1110,7128,1110,0,47.6968,-122.124
860000,4,2.5,3070,6923,3070,0,47.669,-122.172
335000,3,2.5,1940,4927,1940,0,47.4479,-122.12
865000,3,2.5,3050,12558,3050,0,47.6549,-122.089
390000,3,1,1240,3600,1240,0,47.5986,-122.298
569950,5,4.25,3380,7805,3380,0,47.4349,-122.328
495500,3,2.5,3190,7828,3190,0,47.5047,-122.144
476500,4,1.75,1670,10200,1390,280,47.5524,-122.267
261000,3,1,1660,11200,1660,0,47.5121,-122.168
375000,4,2,2070,9822,2070,0,47.566,-122.14
550000,4,2,2070,9822,2070,0,47.566,-122.14
230000,2,1,1430,4000,930,500,47.5233,-122.284
526750,5,2.5,2270,10700,1570,700,47.741,-122.256
606000,3,2,1980,7680,1070,910,47.6839,-122.195
368500,4,2.75,2500,26400,1780,720,47.3444,-122.084
275000,3,1,1230,171190,1230,0,47.4397,-122.46
342000,4,1,1390,9023,1390,0,47.7754,-122.296
278100,4,1.75,2120,8520,1600,520,47.302,-122.373
450000,4,2.75,1540,4840,850,690,47.5491,-122.375
349950,4,2.5,2000,5006,2000,0,47.466,-122.147
425000,4,2.5,2400,6053,2400,0,47.3869,-122.033
435000,4,2.75,2110,8751,1510,600,47.7617,-122.215
460000,4,2.5,2550,19017,1300,1250,47.7682,-122.284
323000,4,1.75,1440,8114,1440,0,47.7639,-122.332
325000,2,1,810,6827,810,0,47.5495,-122.357
480000,2,1.75,1170,4635,690,480,47.6842,-122.359
1.325E+06,3,2.5,3590,8400,2950,640,47.595,-122.173
210000,4,1.75,2090,6485,1280,810,47.4958,-122.265
920000,5,4.5,3820,5750,2830,990,47.5581,-122.385
399000,3,1,1460,8290,1460,0,47.7246,-122.3
631750,3,1.75,2360,4063,1180,1180,47.6902,-122.382
184000,3,1,1100,8680,1100,0,47.3072,-122.363
333000,4,2.5,2100,7208,2100,0,47.4478,-122.128
218000,2,2,1310,2841,1310,0,47.3502,-122.022
258305,2,1.5,750,2964,750,0,47.5518,-122.277
775000,5,1.5,1720,5000,1720,0,47.6627,-122.355
515000,3,2.5,3370,19585,3200,170,47.7388,-122.339
455000,2,1.5,1200,1259,1000,200,47.6001,-122.298
440000,3,2.5,1830,6807,1830,0,47.7613,-122.322
1.44E+06,3,3.5,3870,3819,2760,1110,47.6452,-122.317
850000,3,2.25,2220,3707,1620,600,47.617,-122.286
480000,3,1.75,2920,21375,1850,1070,47.7666,-122.265
420000,5,2.75,2540,27007,1520,1020,47.4326,-122.155
408000,3,1.75,1970,7100,1590,380,47.7353,-122.172
278000,5,1.75,2170,9752,1100,1070,47.3355,-122.331
1.195E+06,3,3,2350,1620,1560,790,47.6308,-122.279
454000,4,2.25,2630,39000,2630,0,47.4089,-122.149
1.851E+06,4,2.5,4120,14866,2070,2050,47.5571,-122.193
499000,4,2.25,2440,5000,2440,0,47.5407,-121.89
590000,5,3,3480,6625,3480,0,47.4815,-122.153
385000,3,3.5,1900,4805,1560,340,47.5686,-122.315
1.25E+06,4,3.25,3160,10043,3160,0,47.7001,-122.238
202200,2,1.75,1330,2159,1330,0,47.3822,-122.32
450000,3,2.25,1420,13468,960,460,47.6693,-122.176
435000,3,2,2570,233481,2570,0,47.4199,-122.034
550000,2,1,1270,43560,1270,0,47.3651,-122.165
361000,3,2.25,2470,5650,1550,920,47.5072,-122.252
760000,4,2.25,2590,12600,2590,0,47.5566,-122.162
902000,4,2.5,3030,8507,3030,0,47.6675,-122.176
505000,3,1.75,1240,4550,1240,0,47.5803,-122.398
200000,3,1,1040,8925,1040,0,47.3265,-122.335
260000,5,2.25,2320,6375,1270,1050,47.3351,-122.282
417000,2,1,1190,5100,1190,0,47.6773,-122.382
287500,3,2.25,2030,8690,1360,670,47.3185,-122.391
450000,3,1.5,1390,10530,1390,0,47.7025,-122.196
825000,2,1.75,2050,4000,2050,0,47.6415,-122.373
1.475E+06,4,3,3050,6179,2330,720,47.6253,-122.284
319950,2,1,1240,5500,1240,0,47.5257,-122.263
682000,4,2.5,3030,30000,3030,0,47.7468,-122.112
560000,3,1.75,1930,6000,1130,800,47.6516,-122.375
350000,3,1.75,1490,10344,1490,0,47.7517,-122.326
270000,3,2,1510,10215,1510,0,47.2078,-122.003
284000,3,1.75,1320,35100,1320,0,47.312,-122.129
308000,4,2.5,2330,4606,2330,0,47.3934,-122.184
450000,4,2,2240,7725,1120,1120,47.5331,-122.365
540000,4,2.5,2050,34222,2050,0,47.7572,-122.022
380000,4,1.5,1680,11123,1130,550,47.7565,-122.361
522500,4,2.75,2200,122403,2200,0,47.6301,-121.911
118000,1,1,670,7957,670,0,47.3594,-122.056
280400,4,1.75,1730,7210,1010,720,47.354,-122.315
710000,4,2.75,2710,41811,1690,1020,47.5836,-122.046
720000,3,3.25,3410,25741,3410,0,47.6929,-121.868
787000,3,1.75,1330,7500,1330,0,47.6074,-122.195
537000,4,2.5,1990,2660,1990,0,47.732,-122.178
650000,2,1.5,1900,4450,1500,400,47.5834,-122.293
154200,4,1,1310,8640,910,400,47.5104,-122.342
238000,4,2.5,1690,7260,1080,610,47.3001,-122.368
285650,3,1,1040,8199,1040,0,47.7348,-122.302
485500,2,1.5,1340,1286,1190,150,47.617,-122.309
315000,2,1,1120,7350,1120,0,47.7648,-122.31
4.668E+06,5,6.75,9640,13068,4820,4820,47.557,-122.21
627000,3,2,2310,10525,2310,0,47.6727,-122.174
525000,3,2.5,2190,34528,2190,0,47.4594,-121.986
526000,3,3.25,1220,1281,930,290,47.67,-122.317
480000,3,1.5,1200,3060,1060,140,47.679,-122.315
970000,3,3.5,3840,53696,3840,0,47.7322,-122.035
640000,4,2.5,2460,9973,1560,900,47.7133,-122.361
279000,3,2.5,1630,7950,1320,310,47.4224,-122.159
303000,2,2,970,9750,970,0,47.5073,-122.372
315000,4,2,1780,5336,930,850,47.5094,-122.263
336500,4,1.75,1760,7268,1080,680,47.4267,-122.148
163250,2,1,770,8150,770,0,47.5324,-122.275
444950,3,1,1760,6927,1050,710,47.7623,-122.2
285000,2,1,990,2446,990,0,47.5919,-122.297
370000,2,1,1250,4960,940,310,47.6893,-122.325
330000,3,2.25,1440,5150,1440,0,47.5456,-122.356
395000,2,2,1960,4018,980,980,47.5629,-122.32
440000,6,3,2510,5310,1460,1050,47.5533,-122.304
625000,4,2.75,2920,6605,2920,0,47.4909,-122.144
435000,3,2.5,1730,46638,1730,0,47.4614,-121.709
299950,3,2.5,1570,2577,1570,0,47.7456,-121.984
560000,2,1.75,970,4233,970,0,47.6384,-122.4
380000,4,3,2800,9764,2800,0,47.3543,-122.012
333000,4,2,1580,7800,1580,0,47.5848,-122.302
499000,2,1,1220,3000,920,300,47.6823,-122.365
386000,3,1.5,1550,8000,1330,220,47.5536,-122.286
320600,3,2,1220,7620,720,500,47.4564,-122.352
285000,2,2,1651,18200,1651,0,47.4621,-122.461
450000,7,4,3150,7800,3150,0,47.5259,-122.279
175000,2,1,800,7150,800,0,47.3788,-122.224
544800,5,2.75,3190,5857,3190,0,47.4575,-122.119
220000,3,1.75,1720,7587,1140,580,47.3175,-122.182
374000,2,2.25,1100,1695,1100,0,47.5663,-122.289
200000,3,2,1010,7896,1010,0,47.4046,-122.181
259950,3,2,1010,7896,1010,0,47.4046,-122.181
255000,4,2.75,1760,9222,1140,620,47.3099,-122.362
447000,3,1.75,1400,6750,1040,360,47.717,-122.226
287000,3,2.5,1820,8722,1820,0,47.2137,-121.989
344950,3,2,1470,6950,1470,0,47.7619,-122.343
212000,2,1,770,7000,770,0,47.5654,-121.89
425000,5,2.75,1340,11583,1190,150,47.709,-122.214
170000,1,1,480,4560,480,0,47.5253,-121.826
565000,3,1,1260,4080,1260,0,47.6893,-122.354
234000,2,1,870,11100,870,0,47.5038,-122.364
1.51125E+06,3,2.5,4010,12105,2600,1410,47.554,-122.151
345000,3,2.5,2340,8414,1280,1060,47.4685,-122.265
415000,3,2.75,1770,3172,1770,0,47.5164,-121.878
760000,5,1.75,2660,10637,1670,990,47.6945,-122.292
484000,5,2.5,3600,20001,3600,0,47.4484,-122.339
360000,2,1.75,1230,1107,1230,0,47.5475,-121.999
875000,3,2.75,3270,39586,3270,0,47.731,-122.078
930000,3,2.5,3100,20553,3100,0,47.7635,-122.377
250000,3,2,1900,6660,950,950,47.3594,-122.054
394000,2,2,1750,2731,1750,0,47.5169,-121.878
865000,4,3.5,3380,11270,2160,1220,47.6124,-122.06
477500,2,2,2090,6000,2090,0,47.5732,-122.413
1.25E+06,4,2.75,4120,12500,2060,2060,47.5914,-122.385
270000,3,1.75,1260,7500,840,420,47.772,-122.323
567000,3,2.25,1800,6875,1230,570,47.6773,-122.11
635000,3,2.5,1960,7200,980,980,47.5655,-122.27
1.865E+06,6,2.75,4460,6952,3460,1000,47.6626,-122.269
183000,3,1.75,1330,9200,1330,0,47.2916,-122.185
309933,3,1.75,1820,78408,1220,600,47.3364,-122.128
945800,4,2.75,3360,9100,1760,1600,47.5641,-122.149
503000,2,1.75,2860,59612,1510,1350,47.3276,-122.389
220000,3,1,1460,10200,1460,0,47.4238,-122.197
335000,3,1.75,1900,36769,1900,0,47.3041,-122.066
650000,3,2.25,1790,9927,1240,550,47.5822,-122.077
511000,4,3.5,3100,7600,3100,0,47.3892,-122.215
275000,2,1,900,57063,900,0,47.4735,-121.786
576250,2,1.75,1530,5000,1260,270,47.6755,-122.37
1.452E+06,2,3.25,2070,3128,1760,310,47.5686,-122.06
186000,3,2,1340,4320,920,420,47.299,-122.228
655100,1,1,1220,4160,1220,0,47.6746,-122.315
328000,4,2.5,2370,6500,2370,0,47.3328,-122.173
441000,3,2.5,1890,11036,1460,430,47.7426,-122.354
370000,3,1.75,1480,7725,1480,0,47.483,-122.163
630000,2,1,1050,8382,1050,0,47.5627,-122.221
470500,4,2.25,2070,14000,1720,350,47.7484,-122.237
285950,2,1,1170,6000,1170,0,47.5033,-122.331
698000,3,1.5,1090,7200,1090,0,47.5817,-122.241
268000,3,2.5,1650,6684,1650,0,47.4051,-122.184
1.625E+06,4,3.75,4410,8112,3570,840,47.5888,-122.392
355000,4,2.5,1780,15000,1780,0,47.4239,-122.153
299000,3,1,1550,8778,1250,300,47.5413,-122.281
1.003E+06,4,2.75,2290,6120,2170,120,47.6746,-122.327
275000,4,2,2220,8229,2220,0,47.3722,-122.22
475000,3,1.75,1150,10240,1030,120,47.5222,-122.357
260000,4,2.5,2000,37045,2000,0,47.3398,-122.071
416000,2,1.75,1270,7560,1270,0,47.7083,-122.357
495000,5,1,1810,11205,1810,0,47.5099,-122.262
357500,3,1,1450,8100,1450,0,47.7027,-122.289
459500,2,1.5,1170,1079,1170,0,47.6607,-122.333
258000,3,2.5,1730,6930,1730,0,47.2621,-122.308
600000,3,2.25,2680,98445,2680,0,47.5015,-122.108
665000,3,1,1260,24550,1260,0,47.5442,-122.396
165000,3,1.5,1020,10152,1020,0,47.4971,-122.168
297000,5,2.5,1970,8605,1970,0,47.1944,-122.013
350000,2,1,830,5100,830,0,47.5259,-122.379
2.45E+06,4,4.5,5030,11023,3250,1780,47.5722,-122.236
180000,2,1,800,9450,800,0,47.4563,-122.184
339950,3,1.75,1330,12092,720,610,47.5102,-122.324
365000,3,1,1030,4700,1030,0,47.5118,-122.377
955000,4,4.25,5660,193593,4100,1560,47.7064,-121.981
732000,3,2.5,2330,1987,1410,920,47.6735,-122.405
500000,3,1.75,1540,10800,770,770,47.5763,-122.222
610000,6,2.75,2040,8560,1100,940,47.616,-122.115
525000,3,2,1540,7800,1540,0,47.7041,-122.288
170000,4,1,1920,13787,1220,700,47.4502,-122.277
300000,3,2.5,1870,3439,1870,0,47.3992,-122.163
389500,5,3.5,2960,12527,1940,1020,47.3134,-122.35
330000,3,1.5,1690,10250,1690,0,47.4531,-122.344
269950,3,2.25,1610,7187,1610,0,47.3764,-122.117
107000,2,1,670,4720,670,0,47.5243,-122.358
249000,3,1,1752,14626,1752,0,47.3755,-122.278
442500,4,2,1540,5920,1540,0,47.7148,-122.301
579000,3,2.5,3160,286181,3160,0,47.3401,-121.946
621500,3,1.75,2570,39634,2570,0,47.596,-122.08
203000,3,1.5,1370,7500,1080,290,47.4167,-122.322
222900,2,1,860,5800,860,0,47.4979,-122.183
453000,2,1.5,1680,17400,1680,0,47.3836,-122.006
190000,1,0.75,930,29258,930,0,47.4837,-122.236
320000,4,1.75,1820,7381,1150,670,47.4567,-122.171
733500,3,1.5,2120,4370,2120,0,47.606,-122.307
555000,4,2.25,3330,21785,3330,0,47.4725,-122.136
364950,3,2.25,2520,6170,1850,670,47.3522,-122.042
490000,3,1.75,1560,9247,1160,400,47.6954,-122.174
688000,5,1.75,2250,13526,1350,900,47.7108,-122.279
165000,2,1,640,7768,640,0,47.515,-122.359
506000,5,3.75,3880,8370,3880,0,47.4811,-122.179
2.193E+06,3,2.25,3360,7108,2770,590,47.6187,-122.284
754000,5,1.75,2350,7800,1510,840,47.6225,-122.107
949950,5,2.5,2340,1989,2340,0,47.5193,-122.257
443600,3,2.5,1430,1056,1430,0,47.684,-122.388
380600,3,2.5,1920,12244,1920,0,47.7256,-121.97
722800,3,3.25,4330,14600,3630,700,47.6341,-122.044
342888,2,1,790,5150,790,0,47.5528,-122.272
555000,4,1.75,2350,5946,1350,1000,47.6879,-122.298
613000,3,2.5,1350,3068,1350,0,47.6099,-122.293
480000,3,2,1470,10052,1470,0,47.726,-122.316
619500,6,1.5,1680,5202,1680,0,47.6798,-122.206
437000,4,2.5,1890,8505,1290,600,47.6796,-122.115
621000,4,2.5,2030,9905,2030,0,47.5518,-122.184
810000,4,1.75,1760,4080,1760,0,47.675,-122.331
415000,3,2.25,1950,8868,1350,600,47.7538,-122.312
250000,4,1,1440,7404,1080,360,47.5328,-122.379
585000,3,1.5,2230,6000,1260,970,47.5373,-122.395
220000,3,1,1180,5002,1180,0,47.7529,-122.324
580000,5,2.5,2500,11900,1400,1100,47.5915,-122.132
1.32E+06,3,2.75,2680,20104,1820,860,47.6304,-122.234
675000,4,2.5,2040,9225,1610,430,47.636,-122.097
695000,4,2.75,2660,7389,2660,0,47.5993,-121.977
915000,5,2.75,2580,7630,1730,850,47.6226,-122.205
375000,3,1,1000,6947,1000,0,47.7142,-122.319
500000,3,1.5,1330,1265,1140,190,47.5773,-122.409
335000,2,2,1420,5185,1420,0,47.3543,-122.022
170000,2,1,1280,21750,1280,0,47.3096,-122.241
320900,5,2.5,2200,8500,1400,800,47.3073,-122.006
508000,3,1.75,1800,8462,1440,360,47.6623,-122.141
228950,3,1.75,1200,9085,1200,0,47.2795,-122.353
433000,4,2,1840,4760,1080,760,47.5297,-122.349
267500,2,1,960,5150,960,0,47.5201,-122.372
910000,4,1.5,2890,9000,2090,800,47.5682,-122.274
370000,3,1.75,1290,10117,1290,0,47.7598,-122.146
320000,2,1,1140,3834,1140,0,47.5642,-122.378
660000,3,1.75,1750,5200,1750,0,47.6995,-122.383
787888,4,2.25,2580,21115,2580,0,47.5566,-122.219
329000,4,2.5,2650,5880,2650,0,47.3509,-122.165
602000,2,1,1470,6398,970,500,47.6716,-122.279
375000,3,2,1640,9750,1640,0,47.7425,-122.241
212000,1,1,620,7620,620,0,47.4697,-122.349
224000,3,1.5,1440,8370,1440,0,47.5418,-122.275
315500,3,2,1160,10079,1160,0,47.7341,-121.976
350000,2,1,1070,2880,1070,0,47.6261,-122.324
389000,6,4.5,3560,14010,3560,0,47.3244,-122.217
285000,3,1.75,1720,13104,1720,0,47.4709,-122.26
425000,3,1.75,1530,9800,1530,0,47.7655,-122.336
190000,3,1.75,1270,7875,1270,0,47.3696,-122.17
374000,3,1.75,1510,18439,1510,0,47.5491,-122.046
292000,2,1,880,5500,880,0,47.5573,-122.289
475000,5,1.75,2020,5100,1320,700,47.6915,-122.345
546500,3,2.5,1410,2675,820,590,47.6786,-122.371
82000,3,1,860,10426,860,0,47.4987,-122.341
219900,3,1,860,10426,860,0,47.4987,-122.341
440000,3,1,1210,5750,1210,0,47.5403,-122.391
400000,3,2.5,2090,32718,1550,540,47.3338,-122.511
453000,3,1.75,1430,20193,1430,0,47.5619,-122.183
330000,6,3.25,2120,6893,1060,1060,47.5508,-122.355
359950,3,2.75,2540,8604,2540,0,47.3209,-122.185
616000,4,2.5,2490,12929,2490,0,47.6161,-122.021
245000,2,1,670,2356,670,0,47.5918,-122.295
296000,2,2,1320,2040,1320,0,47.7224,-122.291
193000,2,1,950,9000,950,0,47.5219,-122.361
456000,3,2,1870,8442,1060,810,47.6964,-122.365
480000,4,1.75,1840,9250,980,860,47.708,-122.337
382000,3,3.25,1410,1253,1410,0,47.6981,-122.34
650000,2,1,1050,2542,880,170,47.6172,-122.298
431750,2,2,1400,10052,1400,0,47.7262,-122.316
419900,3,2.5,1630,1755,1320,310,47.691,-122.176
315000,3,2,1900,9513,1900,0,47.2843,-122.357
597500,4,3,1890,35280,1510,380,47.7112,-122.099
615000,3,2.5,2980,43301,1930,1050,47.7631,-122.093
605000,4,3.25,2885,33671,2885,0,47.5174,-122.046
220000,3,2.5,1980,11900,1980,0,47.2656,-122.217
340000,4,2.5,3020,8750,1710,1310,47.4298,-122.29
620000,4,2.5,2980,210395,2980,0,47.4575,-121.707
602000,5,1.75,3290,11900,3290,0,47.6626,-122.141
575000,3,1.75,1580,11750,1180,400,47.5368,-122.265
285000,3,2.5,2090,10834,1360,730,47.3537,-122.303
306500,3,1.5,1100,8140,1100,0,47.5004,-122.162
325000,3,2.5,1870,3480,1870,0,47.4831,-122.183
623000,3,2.75,2390,21804,1450,940,47.7339,-122.183
256500,3,2,1320,8568,1320,0,47.3904,-122.164
473000,5,3.5,3430,6872,2830,600,47.4065,-122.207
549000,3,2.5,2250,9235,2250,0,47.7268,-122.105
305000,3,1,1710,19115,1710,0,47.656,-121.913
317000,4,2.5,2160,8049,2160,0,47.3337,-122.26
450000,3,1.75,1400,13775,1400,0,47.7413,-122.259
225000,2,2.5,1560,5333,780,780,47.4749,-122.213
500000,5,2,2300,7897,2300,0,47.7556,-122.356
207000,2,1,820,4860,820,0,47.5298,-122.271
474900,3,1,1630,8308,1630,0,47.5075,-122.378
515000,3,2.5,2010,7200,2010,0,47.7372,-122.223
542000,4,1,1540,5000,1090,450,47.6754,-122.294
725000,4,2.75,2420,10962,1530,890,47.6218,-122.152
314950,3,2.5,1690,4533,1690,0,47.3575,-122.016
375000,3,2,1410,10078,1410,0,47.7587,-122.144
500000,3,1.75,1640,47044,1640,0,47.654,-121.94
689000,3,1.75,2200,9840,1500,700,47.559,-122.136
525000,3,2.25,1290,1182,1000,290,47.637,-122.327
360000,3,1.5,1060,6232,1060,0,47.5329,-122.271
425000,3,1,1240,5750,1240,0,47.564,-122.398
239950,2,1,1280,5500,1280,0,47.5179,-122.264
577500,2,2.5,2330,3000,2330,0,47.5953,-122.294
615000,3,1.75,2360,7291,1360,1000,47.5274,-122.384
516000,4,2.75,2210,10800,1170,1040,47.6086,-122.059
1.218E+06,4,2.75,3670,15400,3670,0,47.5581,-122.156
1.655E+06,4,3.5,3080,4815,2300,780,47.6417,-122.411
315000,2,1,770,6731,770,0,47.7505,-122.312
250000,4,2,2600,9000,1410,1190,47.381,-122.299
250000,4,1.5,1220,4900,1220,0,47.5292,-122.269
925000,4,2.5,2910,48351,1910,1000,47.6495,-122.164
358000,3,1,1150,4681,1150,0,47.7284,-122.336
262000,3,2.5,1700,6200,1700,0,47.2621,-122.221
500000,3,1.75,1220,7370,1220,0,47.6334,-122.12
1.3E+06,5,1,1670,6400,1670,0,47.6542,-122.373
500000,3,1.75,2420,65501,2420,0,47.6525,-122.087
675000,3,2.25,2610,9002,2610,0,47.6909,-122.104
235000,3,1,960,5030,960,0,47.5611,-122.28
545000,3,1,960,5030,960,0,47.5611,-122.28
350000,3,1,1010,9360,1010,0,47.6874,-122.168
320000,2,2.25,1550,1827,1550,0,47.5394,-122.368
452000,5,2.5,5067,13315,3154,1913,47.3391,-122.325
875000,3,2,2350,6000,1990,360,47.6476,-122.32
325000,3,1.5,1310,2998,1310,0,47.5873,-122.299
756000,4,2.25,2160,5600,1080,1080,47.6442,-122.372
319000,4,2.5,2510,7992,1610,900,47.3715,-122.285
455000,3,1.75,890,3800,750,140,47.6803,-122.291
330000,2,1,1129,3840,1129,0,47.5313,-122.351
510000,4,3.25,1980,9988,1340,640,47.6883,-122.111
532000,3,1,2360,5012,1560,800,47.5705,-122.384
775000,3,2.5,2480,5007,1960,520,47.6974,-122.369
410000,3,1.75,2160,4000,1080,1080,47.5721,-122.309
205000,2,1.75,1740,5100,580,1160,47.5211,-122.33
585000,4,2.5,2430,6766,2430,0,47.7294,-122.358
255000,2,1.75,1950,8200,1950,0,47.3161,-122.382
415000,2,1,910,3750,910,0,47.6772,-122.369
459000,4,2,2360,7080,1180,1180,47.5261,-122.376
354000,3,1,1130,11250,1130,0,47.7254,-122.227
587000,3,2.5,2150,5193,2150,0,47.6952,-122.187
782000,4,3.5,5270,53428,3440,1830,47.4358,-122.085
570000,3,1.5,1300,7287,1300,0,47.6889,-122.187
414500,3,1,1050,6002,840,210,47.6988,-122.316
185000,4,1,1380,6700,1190,190,47.4871,-122.281
262500,3,1.5,1610,10291,1610,0,47.2025,-121.999
370000,4,2.75,3150,67518,2250,900,47.3382,-122.196
362500,3,1,1520,9507,1520,0,47.7162,-122.324
536000,3,2.5,1990,7397,1990,0,47.7703,-122.165
425000,5,2,2500,7804,1570,930,47.5031,-122.348
435000,3,2.25,1890,7200,1230,660,47.7156,-122.317
435000,5,2,1840,9240,1540,300,47.7308,-122.34
400000,2,1,1220,6300,760,460,47.5299,-122.387
446000,2,1.5,1370,1221,1080,290,47.6039,-122.307
1.25E+06,3,2.5,2710,13120,2710,0,47.6718,-122.256
300000,3,2.25,1760,5421,1760,0,47.3484,-122.037
404500,2,1,800,5080,800,0,47.6978,-122.314
910000,4,2.5,3530,49222,3530,0,47.7285,-122.112
771000,3,2.25,1780,6120,1390,390,47.6025,-122.286
335000,4,2.5,2610,4781,2610,0,47.2649,-122.292
390000,3,1.75,1850,15170,1850,0,47.4991,-121.774
288000,3,2.25,1560,9706,1560,0,47.3191,-122.213
403000,3,1.75,1270,10790,1270,0,47.6647,-122.177
510000,3,2.25,1420,1309,1420,0,47.6534,-122.346
751000,6,3,2880,6800,2880,0,47.5873,-122.299
408000,3,1,1420,8000,1420,0,47.5169,-122.255
1.01425E+06,3,1,1640,12855,1500,140,47.6169,-122.212
575000,3,2,1730,9030,1730,0,47.5875,-122.134
330000,3,1.75,1250,8100,1250,0,47.5016,-122.348
565000,3,2.25,1520,1221,1520,0,47.674,-122.377
456000,3,2.5,1820,2935,1820,0,47.6018,-122.021
652500,4,2.5,2700,9122,2700,0,47.5771,-121.994
582000,3,1.75,1820,3140,1820,0,47.5271,-122.384
700000,4,2.5,2770,5686,2770,0,47.5997,-121.973
235000,2,1,1270,9182,1270,0,47.5365,-122.378
460000,3,1.75,1400,12155,1400,0,47.5926,-122.047
475000,3,2.25,1820,8008,1240,580,47.7206,-122.11
579000,2,2,1870,6275,1870,0,47.7108,-122.031
507000,4,2,1360,2746,1360,0,47.6736,-122.39
210000,3,2.5,1040,2643,720,320,47.5165,-122.268
359500,4,2.75,2140,10316,2140,0,47.3537,-122.274
248000,3,1.75,1330,9831,1330,0,47.3304,-122.277
239300,3,1,1070,5750,1070,0,47.5071,-122.255
315000,3,2.25,1370,1533,1370,0,47.7326,-122.343
970000,4,3,3510,12410,3510,0,47.6381,-122.166
510000,3,1.5,1730,6240,1000,730,47.5282,-122.391
418000,4,1.5,1550,9176,1000,550,47.6005,-122.129
699000,4,2.5,3280,27441,3280,0,47.6711,-122.012
871000,4,2.5,2150,8536,1400,750,47.5663,-122.163
515000,3,1.75,1580,9147,1210,370,47.6069,-122.112
400000,3,1,1460,43000,1460,0,47.4434,-122.347
445000,3,1.75,1410,5100,1110,300,47.7026,-122.29
1.11E+06,4,2.75,3090,6600,1800,1290,47.6339,-122.396
212000,3,1.5,1690,9600,1210,480,47.3857,-122.079
710000,4,2.5,2870,11304,2870,0,47.5547,-122.154
225800,4,1,1100,7110,880,220,47.3858,-122.227
520000,3,1.75,2310,36665,1580,730,47.7697,-122.274
1.295E+06,5,3.75,3490,15246,1940,1550,47.5479,-122.212
248000,4,2,2080,13510,1040,1040,47.4918,-122.258
556000,4,2.5,2230,7200,1220,1010,47.589,-122.156
319950,5,1.75,1710,11900,1070,640,47.506,-122.365
320000,4,2.75,1640,3000,1000,640,47.5625,-122.283
245000,3,2.5,1600,2788,1600,0,47.4034,-122.187
700000,3,2.5,2850,36585,2850,0,47.7376,-122.102
628000,5,2.75,2600,8160,2600,0,47.7348,-122.34
640000,3,2,1380,4800,1380,0,47.651,-122.369
420000,4,1.75,1320,4978,940,380,47.5266,-122.379
349950,3,2.5,1420,1162,1420,0,47.6982,-122.349
307999,4,2.75,2420,8438,2420,0,47.2091,-122.009
749950,4,2.75,2600,6050,1960,640,47.5656,-122.4
290000,2,1,840,3844,840,0,47.7048,-122.347
235000,3,1.75,1420,7920,1420,0,47.2931,-122.188
225000,3,1,1790,6120,1790,0,47.508,-122.337
302100,3,1,1790,6120,1790,0,47.508,-122.337
520000,2,1,1340,6380,890,450,47.697,-122.313
285000,2,1,1010,7200,1010,0,47.7651,-122.291
525000,3,2,1640,15258,1640,0,47.6301,-122.037
374900,5,2.75,2980,8500,1540,1440,47.3641,-122.278
377500,3,2,1370,7200,1130,240,47.7329,-122.308
587450,3,2.25,2190,8775,2190,0,47.7303,-122.287
245000,3,2.25,1530,12000,1070,460,47.2715,-122.338
200000,3,2,1290,5757,1290,0,47.3175,-122.17
2.14E+06,4,3.75,5150,453895,4360,790,47.6795,-121.991
607000,3,2.5,2470,9226,2470,0,47.7439,-122.17
1.247E+06,1,1.25,1810,5070,1230,580,47.5814,-122.081
549950,4,2.5,2230,14694,1180,1050,47.6305,-122.034
250000,3,3,2300,7701,2300,0,47.5102,-122.18
525000,3,2.5,2030,6970,2030,0,47.5718,-121.999
440000,3,1.75,2000,9900,1480,520,47.4436,-122.339
425000,3,2.75,3610,107386,3130,480,47.3351,-122.362
739900,5,2.5,3290,5029,3290,0,47.5773,-122.056
315000,3,2,1300,3731,900,400,47.5374,-122.27
340000,5,1,1880,3774,1360,520,47.566,-122.37
366000,4,2.75,2170,9743,2170,0,47.3814,-122.024
315000,3,1.75,1680,7250,930,750,47.7201,-122.35
299000,3,1.5,1190,9135,1190,0,47.5164,-122.189
350000,2,1,940,5000,940,0,47.7518,-122.279
340000,2,1.75,1010,1461,670,340,47.6515,-122.4
460000,3,1.75,1290,8580,1290,0,47.6707,-122.174
224000,3,1.5,1480,10588,1480,0,47.2872,-122.212
140000,2,1,900,6400,900,0,47.5287,-122.281
246000,4,2,1400,7632,1400,0,47.4625,-122.345
330000,3,2.5,2040,14071,2040,0,47.7278,-121.963
306000,3,1,1450,7200,1010,440,47.7311,-122.199
324950,3,1,1210,7440,1210,0,47.7402,-122.323
345000,2,1.5,1800,26615,1240,560,47.302,-122.123
207000,3,1,1490,8995,1490,0,47.4901,-122.303
238000,3,1,1240,5700,1240,0,47.4927,-122.169
695000,3,2,2632,18743,2632,0,47.3743,-122.421
649950,3,2.5,2150,15304,2150,0,47.5573,-122.136
515000,3,2.75,1710,9448,1010,700,47.6693,-122.267
452000,3,2.5,1530,5032,1530,0,47.6985,-122.349
236000,4,2.5,1630,3060,1630,0,47.5072,-122.336
1.285E+06,4,3.5,4080,14450,3210,870,47.5519,-122.106
563000,3,2.75,2340,16500,1500,840,47.5952,-122.051
410988,3,1.75,1000,14061,1000,0,47.7417,-122.093
339950,0,2.5,2290,8319,2290,0,47.3473,-122.151
1.2E+06,4,2.5,3180,13118,3180,0,47.5382,-122.23
340000,4,2.5,2170,19785,2170,0,47.4034,-122.167
808100,4,3.25,3020,13457,3020,0,47.7174,-122.336
236000,3,1.75,1330,6301,1330,0,47.3411,-122.219
330000,4,1.75,1720,8300,1720,0,47.4654,-122.194
799990,4,3.5,2540,5808,1820,720,47.6857,-122.376
240000,0,2.5,1810,5669,1810,0,47.3493,-122.053
343000,3,1,1410,18600,1410,0,47.5031,-122.152
332000,3,2.5,1530,9406,1270,260,47.4852,-122.162
945000,5,3.5,4380,14925,4380,0,47.5848,-121.969
239950,3,1,1140,8366,1140,0,47.4768,-122.177
674000,5,1.75,2110,5000,1250,860,47.6745,-122.287
200000,3,1,1050,5000,1050,0,47.4923,-122.165
453000,3,1.75,1600,7232,1600,0,47.6293,-122.121
330000,3,1.75,1430,8865,1430,0,47.7331,-122.299
285000,4,2.5,1996,4547,1996,0,47.3365,-122.051
338000,4,1.75,1530,8152,910,620,47.7557,-122.328
264950,2,1,1000,6000,1000,0,47.5208,-122.372
880000,4,2,2530,10800,1350,1180,47.5705,-122.225
209500,3,1.5,970,5488,970,0,47.5366,-122.359
380000,4,2.5,2400,9398,1310,1090,47.4952,-122.178
336500,3,2,1830,12891,1830,0,47.3924,-122.192
360000,3,2.25,2130,8466,1290,840,47.4537,-122.211
911100,4,3.25,3330,33826,3330,0,47.7596,-122.275
249900,2,1,560,7560,560,0,47.5271,-122.375
175000,4,1,1210,6250,1210,0,47.5008,-122.333
549950,3,2.5,2380,2500,2380,0,47.5734,-122.375
225000,3,1.75,1370,10866,1370,0,47.6774,-122.164
270000,3,1.75,1370,10866,1370,0,47.6774,-122.164
400000,3,2.25,1740,11040,1740,0,47.7376,-122.242
299800,2,1,790,5240,790,0,47.5303,-122.288
555000,3,2.5,2480,8676,2480,0,47.53,-122.172
230000,3,2.5,1920,9180,1920,0,47.4818,-122.231
360000,4,2.5,2750,6259,2750,0,47.3304,-122.179
415000,2,1,880,3200,880,0,47.6575,-122.402
355000,4,1.75,2160,8000,1660,500,47.3165,-122.382
635000,4,2.5,2570,27972,2570,0,47.6343,-121.969
353000,5,2.75,2130,5000,1100,1030,47.5271,-122.274
999000,7,4,3150,34830,3150,0,47.6029,-122.147
265000,3,1.5,1780,10196,1270,510,47.3375,-122.291
250000,4,1.75,1910,8250,1910,0,47.6131,-122.123
225000,2,1,1170,7142,1170,0,47.7497,-122.313
553000,2,1,900,5000,900,0,47.6883,-122.395
565000,5,2.5,2650,11455,1400,1250,47.6141,-122.116
312000,2,1,1170,5150,980,190,47.5503,-122.283
475000,3,2.5,2630,185130,2630,0,47.7035,-121.894
320000,4,2.75,2150,9163,1340,810,47.266,-122.307
453000,3,2,1430,9583,1430,0,47.7206,-122.197
320000,3,1,960,6180,960,0,47.5518,-122.279
610000,4,2.75,2640,8400,1440,1200,47.5882,-122.29
385000,3,1.5,1490,9630,1490,0,47.7623,-122.256
215000,3,1.75,1210,8075,1210,0,47.2666,-122.254
215000,4,1.5,1860,5040,1860,0,47.2077,-121.993
415000,3,2.5,1980,4274,1980,0,47.7767,-122.239
350000,1,1,900,6380,900,0,47.7019,-122.311
395000,1,1,900,6380,900,0,47.7019,-122.311
898000,2,1.75,1490,9874,1490,0,47.6246,-122.199
480000,3,2.5,2980,7338,2980,0,47.437,-122.207
1.24E+06,3,2.5,2660,1973,1870,790,47.6264,-122.364
599000,4,2.5,2790,230868,2790,0,47.7647,-122.019
770000,4,3,2800,9127,2800,0,47.6123,-122.007
1.208E+06,3,2.25,1590,8520,1590,0,47.6477,-122.216
1.59E+06,4,2.25,3240,11131,2080,1160,47.6182,-122.215
880000,3,2,2130,35169,2130,0,47.7489,-122.123
332000,3,2,1510,7884,1510,0,47.4683,-122.348
445000,3,1.75,1750,7200,1750,0,47.6289,-122.119
849000,4,2.75,4010,87555,4010,0,47.4299,-121.998
752000,4,1.5,1650,2970,1650,0,47.6233,-122.319
450000,9,7.5,4050,6504,4050,0,47.5923,-122.301
420000,3,1,1320,5500,1320,0,47.5705,-122.398
330000,4,2.5,2310,6320,2310,0,47.3287,-122.167
409000,3,1.75,1440,9065,1440,0,47.7163,-122.333
350000,5,1.75,2330,14322,1180,1150,47.4768,-122.155
570000,4,2.5,2430,44001,2430,0,47.7125,-121.916
315000,3,1,1390,8333,1390,0,47.7652,-122.31
224000,2,1,1150,15000,1060,90,47.4935,-122.316
293550,4,1.75,2120,9706,1370,750,47.4939,-122.297
350000,4,2.75,2300,3175,1340,960,47.5732,-122.305
1.108E+06,4,2.5,3320,9380,3320,0,47.5655,-122.114
442500,4,2.5,2400,7092,2400,0,47.7522,-122.338
616500,3,2.5,3580,118047,3240,340,47.4453,-121.98
506400,3,2.5,2100,9040,1700,400,47.5329,-122.173
324000,3,2.25,1550,4411,1550,0,47.7373,-121.966
169000,3,1.5,1570,6450,1570,0,47.2021,-121.996
595000,3,2,1480,5000,750,730,47.6859,-122.37
299900,3,2.5,2720,6014,2720,0,47.3344,-122.174
332000,3,2.25,2270,8876,1380,890,47.4653,-122.176
432000,4,1.75,2410,8400,1600,810,47.7341,-122.2
510000,4,2.75,2730,9112,1740,990,47.4005,-122.312
270000,3,2.5,1540,7739,1540,0,47.3511,-122.169
750000,5,2.5,3120,15593,3120,0,47.6142,-122.065
509250,2,1.5,1480,3120,930,550,47.6684,-122.323
189000,3,1,860,5200,860,0,47.3677,-122.078
726500,4,2.5,2180,3893,2180,0,47.6886,-122.388
287000,3,2,1300,11374,1300,0,47.4839,-122.302
679000,4,3.5,3420,49223,3420,0,47.3534,-121.992
316000,3,2.25,2130,8721,1570,560,47.4202,-122.204
498000,4,2.5,2300,22445,2300,0,47.6454,-121.902
448000,4,1.75,2560,8270,1480,1080,47.7572,-122.147
535000,2,1,1040,5527,1040,0,47.6774,-122.284
560000,4,3,3080,9601,3080,0,47.334,-122.332
437850,4,2.25,2670,14255,1610,1060,47.5623,-122.175
435000,4,2.75,3270,50994,2720,550,47.347,-122.087
510000,4,2.5,2610,8031,2610,0,47.7717,-122.27
520000,3,2.5,2460,54885,2460,0,47.4996,-122.146
509000,2,1.5,1930,3521,1930,0,47.6092,-122.146
575000,3,1,1220,5652,1220,0,47.5767,-122.408
365000,4,2.5,2030,7210,1330,700,47.5067,-122.16
795000,3,2,2420,17859,1500,920,47.7074,-122.246
285000,3,2.5,1870,4060,1870,0,47.3986,-122.163
955000,3,2.25,3020,43560,2720,300,47.6456,-122.173
775000,4,2.5,2880,8400,2050,830,47.7704,-122.386
400000,4,3,1810,5012,1810,0,47.5691,-122.292
570000,4,2.5,2590,8483,2590,0,47.738,-122.221
955990,5,3.25,3830,6507,3830,0,47.6843,-122.016
1.15E+06,3,2.25,3250,34848,2260,990,47.6077,-122.158
459950,4,2,2760,21465,2120,640,47.3818,-122.165
245000,2,1.75,1220,8382,1220,0,47.5033,-122.359
281000,3,1.5,1280,974,1280,0,47.7162,-122.293
205000,3,0.75,770,7000,770,0,47.5661,-121.887
290000,3,1.75,1520,15090,1520,0,47.398,-121.964
635000,4,2.5,2080,11176,2080,0,47.7107,-122.289
310000,1,1,570,6000,570,0,47.5517,-122.385
470000,4,2,1500,3659,830,670,47.6088,-122.293
600000,2,2.5,2510,14878,2510,0,47.7525,-122.205
279000,4,2,1980,10051,1980,0,47.3231,-122.103
538500,3,3.5,2500,4270,2500,0,47.536,-121.877
594950,4,2.5,2720,10006,2720,0,47.6295,-122.042
533050,2,1,910,295772,910,0,47.3752,-122.11
510000,3,1.75,1480,7040,1480,0,47.6723,-122.169
360000,4,2.25,2470,8686,1270,1200,47.4371,-122.166
435000,2,1,1650,5106,1090,560,47.6992,-122.309
559000,3,1.75,1700,6500,1700,0,47.6837,-122.284
645000,2,1.5,1995,115670,1995,0,47.4022,-122.464
340000,2,1,1280,9690,640,640,47.5341,-122.279
565000,4,2.5,2980,10459,2980,0,47.7354,-121.974
575700,3,1.75,1730,6130,1480,250,47.6978,-122.316
1.01E+06,3,3.25,2420,1923,1840,580,47.637,-122.341
540500,3,2,2800,185130,2320,480,47.4133,-122.006
265000,5,4,1400,8580,900,500,47.456,-122.292
699950,4,2,2070,7830,1180,890,47.7058,-122.278
355000,1,1.75,750,20339,550,200,47.4756,-122.09
381000,3,1.5,1460,11407,1460,0,47.746,-122.294
564000,5,2.25,2140,8700,1220,920,47.6969,-122.31
114975,2,1,740,6250,740,0,47.506,-122.335
325000,1,0.75,410,8636,410,0,47.5077,-122.357
299990,2,1,1570,125452,1570,0,47.2077,-122.016
751000,5,2.75,2860,5280,2860,0,47.707,-122.102
425000,3,2.25,1400,6970,1400,0,47.542,-122.184
665000,3,1.75,2700,5040,1560,1140,47.5834,-122.29
833450,5,4,4460,269345,3330,1130,47.4992,-122.06
575000,7,1.5,2670,11250,2320,350,47.7121,-122.332
190000,3,1.75,1520,9600,1520,0,47.473,-122.149
314950,3,1.75,1520,9600,1520,0,47.473,-122.149
601150,2,2,1660,5200,1120,540,47.6871,-122.334
315000,2,1,860,8308,860,0,47.508,-122.378
545000,2,1.5,2340,13380,1280,1060,47.5017,-122.377
565000,4,2.25,2110,10698,2110,0,47.5614,-122.082
175000,3,1,1010,7034,1010,0,47.49,-122.22
530000,3,2,2330,26571,2330,0,47.6009,-122.158
4.489E+06,4,3,6430,27517,6430,0,47.6208,-122.219
430000,3,1.75,1610,7900,1310,300,47.7588,-122.36
225000,3,1.75,1460,8372,1460,0,47.3683,-122.087
312000,5,4,2900,9779,1950,950,47.5003,-122.306
380000,3,1,1260,7980,1260,0,47.7013,-122.373
222200,2,1,1210,10000,1210,0,47.4402,-122.333
1.43889E+06,5,3.5,3420,8000,3420,0,47.5736,-122.212
329950,4,2.5,2120,4558,2120,0,47.3795,-122.022
995000,3,2.5,2460,10300,2460,0,47.6999,-122.391
929950,3,3.5,3790,10829,3790,0,47.5525,-122.098
692000,4,2.5,2350,9779,2350,0,47.6411,-122.065
402000,2,1,620,2475,620,0,47.6655,-122.371
510000,3,1.75,1920,43560,1340,580,47.6052,-122.044
249000,3,1,1050,8498,1050,0,47.4043,-122.202
244900,3,1.5,1360,9980,1360,0,47.4143,-122.206
289900,3,1,1180,7068,1180,0,47.4947,-122.238
552500,4,1,1560,7980,1170,390,47.5093,-122.387
760000,4,2.5,3300,165528,3300,0,47.7657,-122.028
440000,2,2.75,1100,1088,750,350,47.6405,-122.324
286000,3,1.75,1770,9000,1090,680,47.4997,-122.326
260000,3,1,1200,4592,800,400,47.519,-122.352
355000,2,2.25,1330,10838,1330,0,47.7689,-122.241
318000,3,1.75,1570,12506,1570,0,47.3365,-122.319
255000,2,1,1610,19965,1610,0,47.5095,-122.313
139000,3,1,1100,17334,1100,0,47.3003,-122.27
485000,4,2.25,1810,7068,1810,0,47.7319,-122.204
549950,3,1.75,2930,266587,2440,490,47.6991,-121.947
588000,3,1.5,1780,4200,1780,0,47.662,-122.349
975000,3,2.5,3050,7410,1950,1100,47.6772,-122.296
402000,3,2,1540,1827,1540,0,47.5479,-121.998
245000,3,1,1380,9875,1380,0,47.5131,-122.334
445000,3,1.75,1890,32340,1890,0,47.4137,-122.439
195000,3,1.75,1570,8459,1570,0,47.2016,-122.006
385000,5,2,2540,11750,1480,1060,47.7754,-122.291
450000,3,1.5,1520,7903,1000,520,47.5659,-122.141
1.09E+06,4,2.5,2780,6837,2780,0,47.666,-122.201
396675,2,1,1730,6375,1730,0,47.5357,-122.368
242000,5,2.25,2340,7494,1170,1170,47.448,-122.28
380000,3,1.75,1300,12378,1300,0,47.4996,-121.778
496000,2,1,1420,4635,1420,0,47.68,-122.304
399950,3,2.5,1470,4488,1470,0,47.723,-122.162
895000,4,2.5,2850,8526,2850,0,47.6747,-122.191
690000,3,2,2360,6149,1560,800,47.5433,-122.384
270000,3,1.5,1610,8375,1610,0,47.7527,-122.306
349900,3,2,2420,38781,1210,1210,47.4511,-121.976
454280,3,2.5,1470,1741,1170,300,47.5464,-121.999
390000,3,2.5,1410,26375,1410,0,47.7432,-122.076
275000,3,1.75,1840,14005,1840,0,47.3124,-122.345
300000,4,2.5,2450,8932,2450,0,47.3093,-122.345
700000,3,1.75,1500,6000,850,650,47.6474,-122.402
520000,3,1.75,2080,6609,1280,800,47.6883,-122.3
715000,3,2.5,2770,39529,2770,0,47.6495,-122.042
404000,3,2.5,2370,4324,2370,0,47.3515,-121.999
490500,3,2,3000,21883,1970,1030,47.7599,-122.214
1.485E+06,6,2.75,4430,6440,2680,1750,47.5462,-122.265
557800,4,1.75,1550,6000,1550,0,47.6567,-122.399
571000,4,2.25,2290,9900,1550,740,47.4434,-122.343
410000,4,2.5,2560,4020,2560,0,47.3533,-122.027
225000,3,1.5,1240,5506,1240,0,47.5294,-122.285
700000,4,2.5,2590,4498,2590,0,47.7047,-122.128
500000,3,1,1370,3500,1370,0,47.6857,-122.348
536500,2,2,1360,1860,680,680,47.6727,-122.396
330000,3,2.5,2060,25046,1600,460,47.184,-121.959
249950,3,1.75,1120,15210,1120,0,47.3659,-122.113
249000,4,1.75,1630,8410,1630,0,47.4538,-122.288
249000,3,1.75,1590,7535,1590,0,47.3769,-122.234
780000,4,1.75,2480,9195,1390,1090,47.584,-122.195
1.2E+06,4,2.5,2700,4275,2700,0,47.6725,-122.327
434500,3,1.75,1930,7210,1110,820,47.735,-122.174
590000,4,2,2490,339332,2490,0,47.2725,-121.929
417200,2,1,1000,4000,1000,0,47.6742,-122.396
649990,4,2.25,2130,11900,2130,0,47.6408,-122.058
506000,2,1,1060,3588,960,100,47.6721,-122.395
348000,3,2.5,1730,4004,1730,0,47.4317,-122.328
301000,4,2.5,2810,6146,2810,0,47.4045,-122.208
427550,2,1,880,4000,880,0,47.6848,-122.386
361000,3,1,1040,6720,1040,0,47.7444,-122.294
460000,2,2.5,1830,8107,930,900,47.701,-122.305
958000,4,3.5,1800,6400,1800,0,47.625,-122.3
445000,5,1.75,2460,6846,1340,1120,47.5445,-122.321
373000,3,2.5,1670,3565,1670,0,47.7623,-122.161
525000,4,2.25,2660,7957,1750,910,47.7351,-122.199
364988,3,2.5,2850,12593,2850,0,47.2848,-122.345
324000,2,1,820,8370,820,0,47.7256,-122.361
625000,4,3,2350,5627,1490,860,47.5514,-122.268
237500,3,1.75,1480,7830,1480,0,47.1967,-121.998
429300,6,2.25,2930,15949,1730,1200,47.7188,-122.185
155000,3,1,1250,6250,1030,220,47.5292,-122.323
614000,4,2.75,2760,8160,1780,980,47.7248,-122.365
650000,3,2.5,2380,3332,2380,0,47.7194,-122.199
625000,3,2,1730,12219,1730,0,47.5825,-122.189
587100,3,2.25,1670,6414,1670,0,47.6921,-122.386
380000,4,2.5,2150,37647,2150,0,47.3117,-122.083
479500,2,1,930,5760,730,200,47.5598,-122.266
382888,1,1,620,2380,620,0,47.6746,-122.326
540000,4,4.25,1960,3565,1960,0,47.5849,-122.384
691000,4,2.75,2550,8632,1700,850,47.6477,-122.197
760500,3,2,1990,3990,1130,860,47.6572,-122.333
685000,4,2.5,3550,10968,3550,0,47.5431,-121.886
199129,3,1,860,33664,860,0,47.295,-122.275
335000,3,3,2031,7702,2031,0,47.3058,-122.348
305100,3,2,1590,35988,1590,0,47.4365,-122.106
830000,4,2.25,3010,12202,3010,0,47.6387,-122.174
810000,3,2.5,2610,8481,2610,0,47.5535,-122.115
500000,3,2.25,1440,15661,1180,260,47.6225,-122.038
490000,3,1.75,1920,5405,960,960,47.5583,-122.38
490000,2,1.75,1670,4200,1670,0,47.5862,-122.387
272000,4,1.75,1390,10660,1030,360,47.4128,-122.323
280000,3,2.25,2140,7200,2140,0,47.3913,-122.191
233000,3,1,1250,6180,1250,0,47.7474,-122.327
275000,3,1,1080,6000,1080,0,47.7579,-122.33
375000,3,3.25,2760,6420,2110,650,47.3895,-122.221
445000,3,2.75,2180,3703,2180,0,47.776,-122.169
437500,3,2.5,1260,1125,1260,0,47.6706,-122.381
426250,4,1,1610,6000,1510,100,47.5261,-122.266
358000,3,1.5,2450,12497,2450,0,47.5317,-121.834
1.175E+06,4,3.5,4150,49503,4150,0,47.6746,-122.018
305000,2,1,960,8276,960,0,47.5322,-122.033
415000,2,1.75,1340,4664,1340,0,47.7182,-122.034
520000,11,3,3000,4960,2400,600,47.556,-122.363
733000,4,3.5,3080,5974,3080,0,47.6007,-121.974
411500,3,1,1130,8159,1130,0,47.7362,-122.333
540000,3,1.75,2280,16671,1760,520,47.7096,-122.219
270500,3,1.5,1952,8613,1652,300,47.3715,-122.29
422250,2,1.5,1280,1256,1200,80,47.6741,-122.375
655000,5,3.25,3690,12353,3690,0,47.7672,-122.292
1.2E+06,5,3.25,4610,10576,3310,1300,47.5373,-122.07
550000,3,2.5,2920,169448,2920,0,47.2492,-121.975
460000,2,2.25,1230,929,1020,210,47.6191,-122.301
159075,4,1.5,1580,6200,790,790,47.4971,-122.24
470000,2,1,1220,4000,1220,0,47.6801,-122.354
235000,2,1,1020,7920,1020,0,47.5558,-122.31
309950,2,1.5,1510,9843,1510,0,47.4419,-122.27
433000,4,1.75,1830,9600,1010,820,47.5728,-122.125
895000,3,2.5,2750,10000,1650,1100,47.5644,-122.153
291000,3,1.5,1860,60960,1140,720,47.3796,-122.102
835000,3,2.5,2720,13124,2720,0,47.6371,-122.094
640000,2,1,1360,5000,1200,160,47.6372,-122.392
438000,3,2.25,2340,14279,1340,1000,47.5715,-122.124
540000,4,2.5,2600,9935,2600,0,47.4865,-122.142
325000,4,2.5,2090,7434,1090,1000,47.4962,-122.349
380000,4,1.75,2260,7200,1360,900,47.5122,-122.186
510000,2,1,1390,5544,930,460,47.6696,-122.267
380000,4,2.5,2300,7707,2300,0,47.3497,-122.044
825000,4,2.5,2810,9800,1710,1100,47.5657,-122.149
880000,4,3.25,4060,52707,4060,0,47.7615,-122.041
1.8E+06,3,3,2790,13295,2370,420,47.5466,-122.197
790000,3,1,1290,6380,1290,0,47.6951,-122.319
287000,2,1.5,720,4346,720,0,47.5225,-122.351
509000,3,3,2130,5000,1570,560,47.5451,-122.284
270000,3,2.25,1750,8400,1350,400,47.4571,-122.272
210000,3,2,960,9380,960,0,47.4852,-122.343
415000,3,1,1570,11752,1570,0,47.7686,-122.348
550000,3,2.5,3070,14400,1720,1350,47.3716,-122.321
1.25E+06,4,2.5,2920,5500,2030,890,47.6406,-122.412
499950,3,1,1870,4984,1120,750,47.5771,-122.391
659000,3,1.5,1540,5040,1540,0,47.6138,-122.299
265000,2,1.5,1440,22081,1440,0,47.7698,-121.896
492000,4,3.75,2810,10840,2070,740,47.4861,-121.804
715000,4,2.5,2450,7700,1250,1200,47.5731,-122.212
175000,2,1,1330,28270,1330,0,47.4824,-122.274
975000,4,3.5,3130,52322,2430,700,47.5932,-122.159
306950,1,1,730,5005,730,0,47.6992,-122.364
630000,4,2,2480,3680,1470,1010,47.5686,-122.392
367500,3,1,1270,8792,1270,0,47.5351,-122.174
699950,3,3.25,2230,5460,1430,800,47.53,-122.388
1E+06,3,3,2880,3750,2220,660,47.6155,-122.29
285000,4,2.5,2434,4400,2434,0,47.2874,-122.283
215000,2,1.5,1120,1312,1000,120,47.534,-122.364
1.05E+06,4,2.5,4080,11054,4080,0,47.5188,-122.151
1.37E+06,4,2.75,3720,9450,1960,1760,47.5627,-122.156
235000,3,1,1430,7599,1010,420,47.4783,-122.265
604000,3,2,1560,2589,790,770,47.6587,-122.344
750000,3,1.75,1700,8400,1460,240,47.6534,-122.415
800000,4,2.25,2510,9963,2200,310,47.5973,-122.177
580000,5,2,2600,3750,1400,1200,47.6691,-122.299
350000,1,1,790,4590,790,0,47.5677,-122.285
353750,4,2,1710,7490,1320,390,47.4544,-122.357
1.1E+06,5,2.75,2660,8737,1470,1190,47.5667,-122.155
465000,4,2,1470,10291,1470,0,47.6316,-122.121
568000,3,2,2350,5080,1780,570,47.5516,-122.263
1.005E+06,5,2,2440,3080,2440,0,47.6242,-122.306
213500,3,1.5,1150,11571,1150,0,47.4931,-122.298
250000,3,2.5,1510,10384,1030,480,47.758,-122.071
357000,2,1,870,4600,870,0,47.5274,-122.379
425000,2,2,1280,4095,1280,0,47.5501,-122.393
571000,3,2.5,2600,7465,2600,0,47.7387,-122.217
588000,3,2.25,2030,7350,1190,840,47.6939,-122.126
275000,4,1.5,1930,15531,1930,0,47.345,-122.296
565000,3,2.75,3210,15939,3210,0,47.3357,-122.351
460000,3,1.75,1970,9135,1370,600,47.7603,-122.215
603500,4,2.5,4060,9734,2150,1910,47.7678,-122.254
490600,3,2.5,3316,11447,3316,0,47.3036,-122.34
1.01E+06,2,2,1460,9052,1460,0,47.6857,-122.208
500000,4,2,2100,12620,2100,0,47.7239,-122.173
249000,4,2.25,1830,6136,1830,0,47.367,-122.181
235000,3,2,1530,8700,1530,0,47.4529,-122.207
410000,4,2,1490,13736,1490,0,47.712,-122.281
370000,2,1,860,6050,860,0,47.5697,-122.4
360000,5,2.5,2130,7111,1330,800,47.5071,-122.16
1.40689E+06,5,2.25,3580,16789,3580,0,47.5364,-122.239
298000,4,2.5,2420,3825,2420,0,47.3687,-122.126
485000,4,2.25,1900,7200,1370,530,47.5033,-122.372
400000,3,1.75,1330,9143,1330,0,47.5538,-122.176
580000,3,2.5,2150,4604,2150,0,47.5893,-122.019
355000,2,2.5,1370,1140,1080,290,47.7055,-122.342
650000,3,2.5,2430,12997,2430,0,47.744,-122.194
261490,4,1,1640,8467,1220,420,47.4894,-122.188
347000,3,1,1010,7200,1010,0,47.7225,-122.179
485000,3,1,1500,4100,1370,130,47.6689,-122.367
601000,3,2.5,1740,1251,1180,560,47.644,-122.385
380000,3,3.25,2090,51212,1510,580,47.3097,-122.099
565000,3,3,1850,12556,1850,0,47.6286,-122.053
750000,3,2.5,2790,21043,2790,0,47.673,-122.03
291000,3,2.25,1480,7200,1190,290,47.3037,-122.375
560000,3,2.5,2280,12498,2280,0,47.5688,-122.014
725000,4,2.25,3180,9600,3180,0,47.6313,-122.045
539000,3,2,2350,209088,2350,0,47.6527,-121.949
470000,5,3.25,3910,7077,2710,1200,47.3766,-122.027
264950,2,1,770,7434,770,0,47.7606,-122.32
200000,4,1.5,1780,8000,1080,700,47.3124,-122.003
453500,5,2.5,2300,23345,1170,1130,47.4739,-122.114
811000,2,2.5,2510,17986,2510,0,47.6832,-122.164
425000,3,3.25,1410,1350,1410,0,47.698,-122.34
1.53E+06,4,2.25,4250,16940,2380,1870,47.5453,-122.234
562000,4,2.75,2560,83200,1860,700,47.7511,-122.111
281000,3,2.5,1760,7601,1760,0,47.2672,-122.313
270000,3,2.25,2100,14027,2100,0,47.3833,-122.1
205950,3,1,1490,8239,1490,0,47.306,-122.37
310000,2,1,870,5400,870,0,47.52,-122.374
350000,3,1.75,1260,1111,1260,0,47.5476,-122.005
843500,4,2,2630,16475,2630,0,47.639,-122.219
370000,4,2,1950,3757,1160,790,47.5372,-122.269
279000,4,2,2200,7700,1100,1100,47.464,-122.18
408000,3,1.75,1600,313672,1600,0,47.4129,-122.08
392000,3,1,1230,9600,1230,0,47.5553,-122.288
455000,2,1,1030,5000,1030,0,47.6585,-122.363
310000,2,1.5,1040,83199,870,170,47.4222,-122.443
323500,3,3,2240,11536,2240,0,47.4886,-122.245
364500,3,1,1600,4489,800,800,47.5686,-122.378
280000,4,2,2190,14439,1180,1010,47.2702,-122.29
289900,3,1.75,1899,11325,1899,0,47.3987,-122.3
585000,3,1,1870,2807,1580,290,47.6674,-122.358
269000,3,2.5,1730,6653,1360,370,47.3588,-122.088
280000,3,2.25,1860,9210,1860,0,47.3864,-122.03
287000,3,1.75,1940,9000,1290,650,47.4361,-122.189
183000,2,1,670,5140,670,0,47.5387,-122.371
309000,3,1,1820,8142,1040,780,47.505,-122.316
920000,4,2.5,3810,13579,3810,0,47.6006,-122.153
815241,5,2.25,2060,4800,2060,0,47.66,-122.282
405000,3,1.75,1520,7252,1140,380,47.7358,-122.175
525000,5,3.5,3450,19080,3450,0,47.2123,-122.005
150000,2,1,830,4045,830,0,47.5293,-122.351
240000,4,1.75,1880,9600,1020,860,47.2633,-122.281
698000,4,2.25,2200,11250,1300,900,47.6845,-122.201
440000,3,2,1800,10950,1800,0,47.557,-122.163
204000,3,1,1200,12500,1200,0,47.4162,-122.329
875000,3,2,2220,6641,1220,1000,47.6426,-122.388
650000,3,1.5,1380,4500,1380,0,47.5866,-122.25
392500,3,1,1660,8839,1660,0,47.7485,-122.3
400000,4,1,2320,4000,1310,1010,47.573,-122.312
653000,3,2.25,2800,17300,1420,1380,47.5716,-122.128
452000,4,1,1210,3760,1210,0,47.6872,-122.344
345000,4,2.5,2331,3826,2331,0,47.4444,-122.182
350000,4,1.75,1820,6930,1320,500,47.5053,-122.242
650000,4,2.5,2860,5576,2860,0,47.745,-122.224
525000,5,3,2750,3800,1750,1000,47.6845,-122.313
840000,5,3,2750,3800,1750,1000,47.6845,-122.313
1.325E+06,3,2.5,2280,5000,2280,0,47.6574,-122.278
259950,4,2,1610,6650,1610,0,47.3085,-122.358
998000,5,3.5,3760,10207,3150,610,47.5605,-122.225
1.07E+06,3,3,2940,4622,2230,710,47.6641,-122.293
1.91E+06,4,3,4460,6833,3140,1320,47.6342,-122.289
190500,3,1.5,1110,1150,940,170,47.5929,-122.306
465000,3,2.25,2560,117176,1280,1280,47.4655,-122.033
370000,3,1,1060,7419,1060,0,47.7712,-122.392
290000,6,4.5,2810,11214,2010,800,47.4045,-122.197
350000,3,1.75,1380,4590,930,450,47.6841,-122.293
740000,3,1.75,1380,4590,930,450,47.6841,-122.293
460000,3,1.75,2560,8400,1970,590,47.7668,-122.197
290000,3,1,1010,10800,1010,0,47.4483,-121.773
475000,3,1.5,1790,229125,1790,0,47.2309,-122.009
214000,3,2.5,1600,2231,1600,0,47.3314,-122.29
455000,2,1,910,5759,910,0,47.7153,-122.284
275000,3,2.5,2497,4400,2497,0,47.2873,-122.283
305000,3,1.5,1800,12196,1800,0,47.333,-122.345
449000,5,2.5,2570,61855,1470,1100,47.3013,-122.109
366000,3,2.5,1320,4320,660,660,47.5327,-122.347
348000,3,2.5,1670,5090,1670,0,47.4799,-122.18
515000,4,2.5,2800,21370,2800,0,47.776,-122.246
950000,4,2.5,3360,11548,3360,0,47.6534,-122.182
815000,3,2.5,2590,21494,2590,0,47.6139,-122.061
199950,3,3,1530,2132,1530,0,47.3746,-122.056
386000,3,2,1330,8100,1330,0,47.7251,-122.175
273000,3,2.25,2160,7964,2160,0,47.3622,-122.074
284000,4,2.5,1830,6360,1830,0,47.4184,-122.18
399950,3,1,1470,7930,1070,400,47.7013,-122.368
285000,3,1.75,1150,6423,590,560,47.6973,-122.297
315000,3,2.5,1790,6452,1790,0,47.3841,-122.042
250000,3,1,1700,7700,1120,580,47.5114,-122.318
290000,4,2,1630,7618,1630,0,47.3658,-122.317
725000,4,2.5,3420,30410,3420,0,47.7745,-122.088
410000,3,2,1650,9641,1650,0,47.7145,-122.231
855000,4,2.5,2810,52062,2810,0,47.5941,-122.029
399900,4,2.5,2710,8127,2710,0,47.379,-122.032
852600,4,2.5,3320,11901,2650,670,47.554,-122.16
235000,2,1,720,6321,720,0,47.551,-122.289
230950,2,1,930,12724,930,0,47.6567,-121.909
230000,3,2.25,1490,8722,1490,0,47.3648,-122.185
404763,3,2.5,1690,1609,1150,540,47.5521,-121.998
245000,3,2.5,1720,3407,1720,0,47.4034,-122.188
188000,3,1.5,1140,8500,1140,0,47.2093,-122.005
626100,4,2.5,2280,7219,2280,0,47.5719,-122.021
428750,3,1,1100,4080,900,200,47.6872,-122.351
522000,4,2.25,1800,8623,1360,440,47.692,-122.184
684000,4,2.5,2500,8434,2500,0,47.6915,-122.101
1.0655E+06,3,2.25,2950,7232,1520,1430,47.5257,-122.382
611206,1,1,1940,6300,1940,0,47.5782,-122.4
350000,2,1,1280,5250,1140,140,47.5258,-122.377
894000,4,2.5,3800,22029,3800,0,47.6734,-122.026
420000,2,1,930,5368,930,0,47.6952,-122.275
400000,5,2,1930,9747,1020,910,47.7743,-122.235
675000,3,3,2980,28000,1820,1160,47.7318,-122.139
426000,4,2.5,2800,8494,2800,0,47.3521,-122.009
750000,4,2.25,3190,11597,2300,890,47.6323,-122.039
368000,3,1.75,1710,10800,1710,0,47.7391,-122.241
342000,3,1,1980,6450,1120,860,47.5291,-122.356
700000,3,1.75,1910,4800,1080,830,47.6844,-122.332
848750,6,3.75,3160,5000,3160,0,47.6748,-122.384
720000,3,2,1590,5200,1320,270,47.6864,-122.341
525000,4,2.25,1890,8549,1890,0,47.6328,-122.117
397900,3,2.75,2500,35245,1580,920,47.3414,-122.117
405000,3,2,1740,18000,1230,510,47.7397,-122.242
392800,3,2,1080,11856,1080,0,47.6955,-122.175
394999,3,1.5,1730,7800,1330,400,47.7365,-122.337
340000,3,2.5,2480,6112,2480,0,47.4387,-122.114
482500,3,2.25,1450,1445,980,470,47.6184,-122.301
812500,4,2.5,2750,10159,2750,0,47.5426,-122.135
450000,3,2.5,2820,10208,1410,1410,47.7609,-122.26
398000,3,1.75,1830,27468,1830,0,47.7754,-122.233
1.075E+06,2,3.25,1550,1767,1550,0,47.5684,-122.06
540000,2,2,1640,3021,840,800,47.666,-122.358
275000,4,2,1720,5472,860,860,47.5299,-122.288
780000,5,2,2880,12000,2880,0,47.5861,-122.295
225000,3,1.5,1220,8345,1220,0,47.5038,-122.266
503045,3,3,1560,2250,1560,0,47.6929,-122.333
249000,2,2,1090,1357,1090,0,47.7526,-122.244
569950,4,1,1140,5940,1140,0,47.6795,-122.354
450000,2,2.25,1040,1377,1040,0,47.6692,-122.279
1.0995E+06,4,2,2580,6000,1300,1280,47.6514,-122.413
700000,4,2.5,2310,3570,1490,820,47.6889,-122.347
454000,3,2.5,1590,4094,1590,0,47.61,-122.293
555000,3,1.75,1270,9170,1270,0,47.6706,-122.151
214000,3,1.5,1240,5200,1240,0,47.3683,-122.079
590000,3,2.5,2210,8622,2210,0,47.5715,-122.02
459900,3,1.75,2340,51836,1510,830,47.4846,-122.035
205000,3,1.5,1420,5000,920,500,47.4192,-122.33
390000,3,1.75,1430,9857,1140,290,47.4964,-121.771
970500,3,2.75,2470,10125,2470,0,47.5651,-122.223
790000,3,2.5,2390,15084,2390,0,47.3389,-122.048
320000,3,1,1120,10576,1120,0,47.7575,-122.072
552500,3,2.25,2700,4025,1760,940,47.6074,-122.294
1.05E+06,3,3,3490,4500,3170,320,47.6394,-122.321
230000,3,1,1640,7187,1640,0,47.455,-122.182
680000,3,1.75,1620,5500,1110,510,47.6393,-122.308
985000,3,1.75,1670,5400,1670,0,47.635,-122.284
375000,4,2.5,1870,7471,1870,0,47.4314,-122.204
431000,2,1.5,1300,4000,1300,0,47.5937,-122.301
463000,3,2.5,2190,17108,2190,0,47.7321,-121.964
350000,3,1.75,1320,10500,1320,0,47.7267,-122.226
485000,3,1,1250,7200,1250,0,47.6342,-122.12
355000,4,1.75,2040,15000,1360,680,47.3107,-122.189
603500,3,1.75,2140,7280,1070,1070,47.6993,-122.377
860000,5,1.75,2510,6000,2010,500,47.5798,-122.292
259875,5,2.5,2200,6250,2200,0,47.3675,-122.021
685000,4,2.5,2170,8680,1220,950,47.6078,-122.192
382500,4,2.5,2980,8786,2980,0,47.378,-122.03
490000,3,1,1180,2250,1180,0,47.6779,-122.377
229000,3,2,1540,6000,1540,0,47.7372,-122.307
430000,3,2,1540,6000,1540,0,47.7372,-122.307
580000,5,2.5,3110,15783,1720,1390,47.6301,-122.103
510000,3,1.75,1370,6700,1370,0,47.6982,-122.362
489990,5,2.25,2440,20828,2440,0,47.3762,-122.158
440000,3,2.25,1760,1800,1330,430,47.6579,-122.394
479950,3,2.5,2810,4984,1750,1060,47.4461,-122.209
806000,4,2.5,2500,206474,2500,0,47.6778,-121.994
875000,4,2.5,3220,22588,3220,0,47.7311,-122.055
710800,3,2.5,2880,36820,2880,0,47.766,-122.044
565000,3,2.5,2700,6037,2700,0,47.5376,-121.879
359999,5,3,2680,9624,1870,810,47.3279,-122.006
625000,3,1.75,1780,4500,920,860,47.6827,-122.362
349950,3,2.5,2240,7565,2240,0,47.3485,-122.301
415000,4,2,1610,9600,1610,0,47.5327,-122.186
435000,2,2,1440,1170,960,480,47.5592,-122.385
225000,3,1.75,1550,9060,1550,0,47.5093,-122.345
770000,3,1.75,1720,5000,1720,0,47.6157,-122.29
340000,3,1.75,1740,10800,1740,0,47.7717,-122.351
965000,5,2.75,3280,12673,2050,1230,47.5504,-122.146
667000,3,2.75,2216,31215,2216,0,47.3164,-122.199
250000,1,1,1100,4373,820,280,47.4653,-122.338
397990,3,1,1180,11862,1180,0,47.7153,-122.363
535000,3,1.75,2020,10031,1370,650,47.7487,-122.319
265950,3,1.5,1150,8450,1150,0,47.4927,-122.224
258000,3,1.75,2090,7461,1200,890,47.3764,-122.184
505500,3,2.5,1300,1187,1300,0,47.6704,-122.391
455000,5,2.5,2240,7770,1340,900,47.7198,-122.171
1.348E+06,5,3.25,3540,5971,2000,1540,47.6643,-122.202
600000,4,2.25,2840,31720,1780,1060,47.7505,-122.375
329800,4,2.5,2080,7047,2080,0,47.2627,-122.215
222000,2,1,1550,38449,1550,0,47.4315,-122.199
450000,4,2.5,1900,9240,1900,0,47.6167,-122.137
952000,3,3.5,2760,4500,2120,640,47.6529,-122.372
625000,4,2,1410,4480,1410,0,47.6385,-122.344
226800,2,1,1240,11393,1240,0,47.3714,-122.207
1.205E+06,5,4.25,4420,13497,3510,910,47.5262,-122.143
350000,4,2.75,3390,16153,1970,1420,47.3954,-122.184
395000,3,1.75,1400,8640,1400,0,47.7659,-122.204
285000,5,3,2110,5260,1670,440,47.5449,-122.272
553000,3,1,1310,18135,1310,0,47.6065,-122.113
254000,3,1,1270,16800,1270,0,47.4599,-122.276
348140,2,1.5,2060,10880,1190,870,47.515,-122.362
354950,4,2.75,2530,7350,1280,1250,47.313,-122.374
706000,3,2.75,1900,6400,1410,490,47.6697,-122.281
499000,4,2.5,2910,6479,2910,0,47.5402,-121.887
427500,3,1.5,1900,43186,1300,600,47.4199,-121.99
439000,5,3.5,2880,10000,1980,900,47.4874,-122.223
545000,4,2.5,2820,25995,2820,0,47.3415,-122.029
842000,3,1,1620,4774,1620,0,47.659,-122.339
685000,4,2.5,3320,38043,3320,0,47.6504,-122.004
665000,4,3.5,3770,47480,3770,0,47.3552,-121.99
255000,2,1,1200,9000,1200,0,47.4039,-122.323
565000,5,2.25,2130,4360,1240,890,47.6586,-122.395
274000,5,1.75,1950,8720,1050,900,47.3381,-122.289
260000,3,2,1920,8075,1510,410,47.3092,-122.375
581000,4,2,2510,13695,1280,1230,47.7005,-122.174
625000,3,1.5,1990,5978,1990,0,47.3449,-122.329
220000,3,1,1230,9720,1230,0,47.3266,-122.138
765000,3,2.25,3190,324086,3190,0,47.5477,-121.93
1.325E+06,6,4.25,5720,10213,4170,1550,47.5464,-122.116
700000,8,2.5,2280,3000,1210,1070,47.6675,-122.316
351000,4,1,1550,7260,1550,0,47.6229,-122.121
413565,3,2.5,1690,1613,1150,540,47.5524,-121.998
363000,3,3.25,1651,1779,1341,310,47.7076,-122.346
679000,4,1.75,2260,41236,1690,570,47.5528,-122.034
473000,2,1.75,1510,4555,1510,0,47.7136,-122.031
585888,3,2,1490,7431,1490,0,47.6697,-122.162
405000,4,2.5,2220,4652,2220,0,47.4902,-122.154
650000,3,1.75,2800,19386,1400,1400,47.3554,-122.324
415000,4,2.5,2210,213008,1210,1000,47.4039,-121.98
575000,3,2,2150,3880,1080,1070,47.6814,-122.392
220000,3,2.25,1400,7205,1140,260,47.349,-122.166
610000,4,3,2450,10117,1580,870,47.5694,-122.132
499950,3,1,980,6380,760,220,47.692,-122.308
883000,4,2.5,2800,6874,2170,630,47.6215,-122.29
436000,2,1,1240,8100,1240,0,47.7326,-122.288
320000,3,2.5,1610,1356,1240,370,47.5257,-122.361
425000,3,1.75,1510,44000,1240,270,47.4851,-121.716
204700,4,2,1670,9987,1670,0,47.3406,-122.284
384000,6,3,2320,4502,1200,1120,47.5552,-122.3
314000,3,2.75,1900,8200,1900,0,47.402,-122.183
535000,3,2.5,2390,6263,2390,0,47.7379,-122.248
568000,4,1.75,2110,265716,2110,0,47.657,-122.026
426000,4,1.5,1470,5850,810,660,47.7,-122.129
675000,4,2.75,2670,6780,1630,1040,47.5131,-122.256
380000,4,2.5,2540,6365,1870,670,47.4608,-122.215
685000,3,2.5,3450,8000,2970,480,47.5605,-122.402
429000,3,2,1700,52826,1700,0,47.4164,-122.092
799000,4,1.5,1810,6583,1500,310,47.7273,-122.351
318500,5,1.75,1550,6986,1030,520,47.5503,-122.356
925000,3,3.25,4110,20900,2630,1480,47.5506,-122.187
420000,3,1.5,2080,5000,1300,780,47.5322,-122.29
570000,2,1,1100,4000,1100,0,47.6388,-122.35
1.0525E+06,4,2.75,3950,12840,3950,0,47.5489,-122.219
333000,3,1,1250,8450,1250,0,47.503,-122.364
1.36E+06,2,1.75,2620,14138,2120,500,47.7142,-122.277
660000,3,2.5,2290,2798,2290,0,47.641,-122.315
350000,6,4.5,3500,8504,3500,0,47.7351,-122.295
682500,6,4.5,3500,8504,3500,0,47.7351,-122.295
399990,5,2.75,1690,4000,970,720,47.5312,-122.354
860000,5,3.25,4500,9648,3000,1500,47.7262,-122.282
216180,2,1,1120,7797,1120,0,47.4871,-122.22
300000,4,2.25,1740,9613,1740,0,47.463,-122.125
145000,3,1,1010,11880,1010,0,47.3762,-122.219
255000,3,1,1010,11880,1010,0,47.3762,-122.219
250000,3,1.75,1200,24805,1200,0,47.4236,-122.195
245000,3,1,1020,8625,1020,0,47.4465,-121.77
445000,3,1.75,1850,7056,1850,0,47.6602,-122.13
562000,3,1.5,1830,8000,1830,0,47.6017,-122.122
501000,4,1,2070,7519,1160,910,47.632,-122.119
190000,3,1.75,1160,5850,1160,0,47.5064,-122.356
862500,4,2.75,3280,24440,3280,0,47.7073,-122.07
1.085E+06,5,2.5,2340,6000,2340,0,47.5764,-122.287
575000,5,3,3690,49709,2690,1000,47.3908,-122.32
250000,1,1,720,123710,720,0,47.2893,-122.084
310000,7,1.5,2660,15111,2660,0,47.4644,-122.066
1.4E+06,5,3.25,4300,9270,2910,1390,47.5717,-122.409
284850,3,1.5,1590,8256,1090,500,47.3488,-122.304
570000,4,2.5,2590,7910,2590,0,47.7378,-122.248
304000,3,1.75,1720,6000,1000,720,47.4999,-122.223
560000,4,2.5,1790,9787,1240,550,47.5344,-122.189
325000,3,1,1590,8160,1090,500,47.4013,-122.321
557510,4,2,1580,4800,1580,0,47.5454,-122.383
305000,4,2.25,2580,8820,1620,960,47.3122,-122.376
320000,5,1,1740,27350,1740,0,47.4809,-122.153
455000,5,2.25,3470,28212,2790,680,47.3342,-122.108
383001,3,1,1180,7210,1180,0,47.7267,-122.241
545000,3,1.75,1700,51649,1700,0,47.4704,-122.076
487500,2,1,1190,5000,1190,0,47.5717,-122.382
345000,5,2.5,2450,6994,2450,0,47.3572,-122.192
583000,6,2.75,2630,16411,1650,980,47.6309,-122.093
534950,3,2.25,2130,12286,2130,0,47.6471,-122.114
403504,4,1,1060,5750,950,110,47.6562,-122.389
500000,3,1.75,1480,6120,1480,0,47.6858,-122.295
319502,3,1.75,1610,38707,1610,0,47.3778,-122.001
525000,4,2.75,2440,5080,1750,690,47.5547,-122.379
563000,4,3,3100,15480,2400,700,47.7466,-122.241
898500,4,2.75,2890,5000,1990,900,47.6768,-122.363
651000,3,2.5,3240,108366,3240,0,47.327,-122.094
450000,4,2.75,2900,6400,2040,860,47.5563,-122.393
665000,4,2.25,2650,8149,1610,1040,47.5624,-122.176
825000,4,2.5,2560,4000,1610,950,47.6885,-122.386
200000,3,1,1150,4800,1150,0,47.3101,-122.212
295000,3,2,1760,6092,1760,0,47.3838,-122.184
748000,4,2.5,3220,8379,3220,0,47.7043,-122.192
580000,3,2.5,3200,18750,2660,540,47.5717,-122.12
275000,3,1,1250,10744,1250,0,47.4226,-122.327
196000,3,1,1000,8470,1000,0,47.3056,-122.37
235750,2,1,740,11250,740,0,47.5036,-122.362
315000,3,2.25,2170,8480,2170,0,47.4562,-122.33
338000,4,2.5,2370,10631,2370,0,47.3473,-122.302
353000,4,2.5,2300,4249,2300,0,47.3516,-122
235000,3,1.75,1400,6300,1400,0,47.2074,-122.001
569999,3,2.5,3080,13880,3080,0,47.3726,-122.025
505000,4,2.25,2350,12540,2350,0,47.7732,-122.382
1.234E+06,4,3,2660,4600,1820,840,47.6258,-122.305
299000,2,1.75,1250,34395,1250,0,47.2802,-122.316
240000,3,2,1100,6360,1100,0,47.3878,-122.052
1.955E+06,3,1.75,3330,12566,1940,1390,47.5287,-122.22
1.265E+06,4,3.25,3640,3604,1960,1680,47.6145,-122.284
405000,2,1.75,1350,2653,1350,0,47.6934,-122.184
304000,4,2,1310,8454,1310,0,47.7572,-122.318
272000,4,2.25,1800,5555,1800,0,47.3498,-122.052
412000,2,1,1260,3960,690,570,47.6899,-122.391
698000,4,2.5,2990,7231,2990,0,47.5623,-122.032
400000,2,1,1140,5100,1140,0,47.5323,-122.383
305000,3,2.5,2100,6825,2100,0,47.4314,-122.189
585000,4,2,2400,12753,2400,0,47.6947,-122.177
190000,2,1.5,1400,9031,960,440,47.2915,-122.368
760000,4,2.5,2990,12788,2990,0,47.5601,-122.037
570000,3,1.75,1930,36210,1930,0,47.7692,-122.128
144000,3,1,980,6800,980,0,47.4411,-122.186
139000,2,1,690,5280,690,0,47.4953,-122.187
525000,4,1.5,1430,6380,1130,300,47.6942,-122.319
293000,1,1,1110,5421,1110,0,47.7322,-122.359
267100,2,2.5,1250,1580,1030,220,47.5243,-122.36
1.5E+06,4,3.25,3470,5222,2830,640,47.6845,-122.209
240000,3,2.25,1500,15334,1500,0,47.3719,-122.091
975000,3,2.5,2530,7000,2530,0,47.5465,-122.398
279950,5,1.75,2150,7171,1460,690,47.3952,-122.176
405000,3,1.75,1260,7373,1260,0,47.7296,-122.233
400000,3,2.5,2740,83199,2740,0,47.3581,-122.266
225000,3,1,960,6500,960,0,47.497,-122.171
250000,3,1,1520,7800,1120,400,47.3784,-122.29
272950,3,2.25,1570,9096,1180,390,47.1937,-121.99
625000,5,1,3240,5324,3240,0,47.523,-121.875
670000,3,1.75,1280,2147,1280,0,47.6362,-122.324
1.065E+06,3,2.5,2130,3545,2130,0,47.6389,-122.349
540000,3,1.75,1970,8200,1420,550,47.7602,-122.363
525000,3,2.5,2990,6725,2990,0,47.4928,-122.142
425000,2,1,1160,17700,1160,0,47.7244,-122.331
465500,3,1.75,1890,7004,1290,600,47.5557,-122.28
443500,3,2.5,2170,5866,2170,0,47.5403,-121.889
350000,4,2.25,1570,499571,1570,0,47.1808,-122.023
850000,3,2.5,3260,91911,3260,0,47.737,-122.074
205000,3,2.25,1250,952,1250,0,47.7098,-122.333
315000,4,2.5,1940,10200,1140,800,47.4157,-122.161
470000,3,2.5,2150,8221,2150,0,47.5085,-122.15
1.1E+06,4,2.25,3310,8540,1660,1650,47.5603,-122.158
340000,3,1.75,3400,46382,2050,1350,47.6458,-121.955
310000,4,2.5,2660,12672,1740,920,47.3334,-122.323
305000,3,1,950,13475,950,0,47.7543,-122.306
307150,3,1.5,1480,6752,1480,0,47.4993,-122.176
729032,4,2.5,2840,12866,1780,1060,47.6388,-122.167
750000,5,2.5,3240,9960,2020,1220,47.5858,-122.112
289000,4,2.5,1961,3207,1961,0,47.3507,-122.16
480000,3,1,1100,5700,1100,0,47.6883,-122.282
529000,3,1.75,1500,7367,1500,0,47.6722,-122.167
585000,3,1.75,1480,4800,1140,340,47.6567,-122.397
704000,4,2.75,2510,12500,2050,460,47.6278,-122.11
607000,4,2,1490,4054,1490,0,47.6744,-122.301
580000,3,2.25,2190,8188,1810,380,47.6883,-122.113
875000,5,2.5,2530,8564,2530,0,47.5622,-122.153
610000,4,2.5,2440,9350,1560,880,47.5614,-122.13
230000,3,0.75,1040,15000,1040,0,47.7639,-122.234
510000,4,2.25,2450,62290,2450,0,47.7603,-122.074
733000,4,2.5,2210,5002,1370,840,47.6637,-122.401
169100,3,2,1050,18304,1050,0,47.3206,-122.269
250000,3,2,1050,18304,1050,0,47.3206,-122.269
500000,4,2.25,2730,35100,2730,0,47.5913,-122.012
700000,2,1,1620,9855,1320,300,47.5264,-122.384
379000,4,2.75,2410,5225,2410,0,47.4244,-122.151
650000,4,2.5,3420,222156,3420,0,47.3608,-121.97
412133,2,1,920,4400,920,0,47.6903,-122.332
480000,4,2.25,2330,14190,1740,590,47.718,-122.242
650000,3,1.75,1940,10245,1940,0,47.5833,-122.241
505000,2,2.5,1900,5065,1900,0,47.7175,-122.034
931088,4,2.5,3510,17400,1930,1580,47.5963,-122.171
570000,4,1.75,1860,7700,1860,0,47.626,-122.112
475000,3,1,1380,4635,1380,0,47.57,-122.285
240000,6,1.75,2210,8594,1310,900,47.4594,-122.273
462000,4,2.5,2640,47480,1590,1050,47.4258,-122.021
1.115E+06,3,2.5,4530,22873,3220,1310,47.4567,-122.369
243000,3,1,1500,6600,1500,0,47.4845,-122.33
660000,4,2.25,2010,15375,2010,0,47.5956,-122.174
1.19E+06,2,1.75,2080,8112,1040,1040,47.7134,-122.277
1.68E+06,4,4.25,5584,68257,5584,0,47.6113,-121.952
6.885E+06,6,7.75,9890,31374,8860,1030,47.6305,-122.24
368000,3,2.5,2080,4307,2080,0,47.53,-121.848
811500,5,4.25,3970,4500,2860,1110,47.5402,-122.069
275000,2,1,770,8149,770,0,47.7406,-122.302
650000,4,2.5,2500,6005,2500,0,47.6922,-122.174
485000,3,2,2410,50654,2410,0,47.4154,-122.458
425000,3,2.5,1340,10018,1340,0,47.6366,-122.094
530000,3,2.5,2640,13775,1550,1090,47.5875,-122.177
657000,4,1.75,2740,8520,1370,1370,47.5445,-122.263
315000,4,2.75,1580,3770,1080,500,47.7368,-121.968
273000,4,1.5,2180,22870,1280,900,47.3187,-122.081
550000,3,2.75,1960,13252,1240,720,47.5582,-122.139
347000,2,2.25,1560,1705,1270,290,47.5482,-122.374
525000,5,2.75,2440,8000,1240,1200,47.7283,-122.17
490000,3,1.5,990,1343,840,150,47.6236,-122.306
500000,3,2.25,2210,7916,2210,0,47.7175,-122.339
585000,3,2.75,3080,7282,3080,0,47.4826,-122.149
926500,4,2.75,2900,17802,1750,1150,47.7004,-122.229
465000,1,1,1020,3200,1020,0,47.6361,-122.343
200000,4,2,1900,8160,1900,0,47.2114,-121.986
1.68E+06,6,4.75,5770,16747,4500,1270,47.5512,-122.11
220500,2,1,990,57499,990,0,47.4145,-122.463
329000,2,1,990,57499,990,0,47.4145,-122.463
715000,3,4,2080,2250,2080,0,47.6598,-122.355
780000,3,4,2080,2250,2080,0,47.6598,-122.355
410000,2,1,1480,4080,1050,430,47.6842,-122.393
778100,2,1,1480,4080,1050,430,47.6842,-122.393
406000,3,1,1090,11292,1090,0,47.7429,-122.358
665000,4,2.5,2800,5900,1660,1140,47.6809,-122.286
305000,2,1,1000,8212,1000,0,47.7444,-122.341
265000,3,2.5,1640,7668,1640,0,47.3505,-122.027
485000,4,1,1620,4080,1620,0,47.6696,-122.324
600000,3,2.5,2460,108900,1860,600,47.4824,-122
510000,2,1.5,1860,5100,1060,800,47.5573,-122.392
195000,2,1,1080,3899,1080,0,47.3792,-122.321
432500,3,1.75,1980,5100,1270,710,47.6911,-122.347
490000,3,1.75,1510,8433,1220,290,47.6226,-122.103
270000,3,2.5,1690,7165,1690,0,47.3498,-122.058
370000,2,1.5,1010,2102,1010,0,47.6374,-122.375
327500,3,2.5,2090,12027,2090,0,47.4084,-122.213
826000,2,1,1060,6120,1060,0,47.6739,-122.329
510000,3,1.75,1750,7020,1750,0,47.3264,-122.038
587750,2,1,890,4730,890,0,47.6876,-122.341
449228,5,2.5,3020,24750,1650,1370,47.5897,-122.179
565000,3,2.5,2030,217805,2030,0,47.3942,-122.515
660000,4,2.5,3170,186436,3170,0,47.4475,-122.034
400000,5,2.75,2470,19200,1250,1220,47.4496,-122.083
612500,4,2,2060,5000,1030,1030,47.6992,-122.379
560000,4,1.75,2120,6250,1060,1060,47.5506,-122.385
727000,3,2.25,2180,4200,1520,660,47.6412,-122.302
224000,4,3,2300,7609,2300,0,47.2943,-122.227
1.08E+06,4,2.5,4200,35267,4200,0,47.7108,-122.071
439000,3,2.25,1480,7565,1220,260,47.7288,-122.191
335000,3,1.5,2240,87625,1480,760,47.3043,-122.094
779000,4,1.5,2740,4912,1370,1370,47.6523,-122.412
452000,5,1.75,1830,47916,1830,0,47.4881,-121.777
775000,4,3,2000,5304,2000,0,47.6762,-122.285
235000,3,1.75,1380,8362,1380,0,47.3121,-122.323
370000,3,1.75,1620,37913,1620,0,47.2875,-122.289
790000,4,3,3180,12070,3180,0,47.6371,-122.058
903000,2,1.5,1140,7800,1140,0,47.6142,-122.209
209950,3,1,970,9583,970,0,47.3044,-122.366
309000,3,2.5,1780,7859,1780,0,47.3772,-122.045
440000,3,1.75,2240,8153,1120,1120,47.7303,-122.329
571500,4,2.25,2810,25990,1860,950,47.2993,-122.293
514000,2,1,920,4000,920,0,47.6711,-122.328
323000,3,1.75,1830,12500,1200,630,47.5087,-122.25
290000,2,1.75,1560,7575,1560,0,47.3776,-122.228
2.575E+06,4,4.25,5540,15408,4280,1260,47.6071,-122.212
1.3625E+06,3,2,2310,21318,2310,0,47.6381,-122.224
551000,4,1.5,1470,5100,1470,0,47.6769,-122.381
960000,4,2.5,3430,43560,3430,0,47.6426,-122.18
720000,5,2.5,2900,9525,2900,0,47.5442,-122.138
218000,3,1.75,1850,7684,1320,530,47.2975,-122.37
334950,4,2.5,2190,7000,2190,0,47.3718,-122.109
605000,4,2.25,2510,31584,2510,0,47.6153,-122.054
825000,4,3.25,3200,4477,2390,810,47.664,-122.402
268500,4,1.75,1670,8000,1670,0,47.3193,-122.383
230000,3,1.75,1010,9600,1010,0,47.3828,-122.09
1.335E+06,4,4,5050,202554,3260,1790,47.5269,-121.922
245500,2,1.5,1430,9782,1430,0,47.441,-122.282
440000,3,2.25,1880,7989,1280,600,47.7077,-122.299
571500,4,2.75,2180,5799,2180,0,47.5702,-121.995
182500,3,2.25,1830,4744,1830,0,47.2734,-122.248
217000,2,1,970,5600,970,0,47.5297,-122.277
335000,2,1.5,1170,5248,1170,0,47.5318,-122.374
501000,2,1,1010,4320,1010,0,47.6846,-122.317
339950,3,2.5,2140,7641,1290,850,47.5053,-122.186
340000,3,1.75,2230,10403,1630,600,47.4092,-122.295
582500,2,1,1140,23779,1140,0,47.6948,-122.172
298800,2,1,860,8189,860,0,47.735,-122.306
317500,6,1.75,2540,8400,1340,1200,47.4414,-122.129
598000,4,2.5,2420,5118,1550,870,47.5671,-122.378
375000,2,2.25,1640,2240,1640,0,47.7154,-122.341
465000,4,2.25,2550,7650,2550,0,47.5296,-122.342
551870,3,2.5,2507,18400,2507,0,47.2867,-122.27
295000,3,2.5,1920,7229,1920,0,47.2659,-122.31
263500,4,1.75,2210,6375,1640,570,47.3268,-122.328
1.095E+06,4,4,3530,8400,2630,900,47.6402,-122.395
300000,2,1,1100,4010,1100,0,47.5296,-122.351
780000,4,1,3390,4500,2190,1200,47.5824,-122.293
325000,3,1.5,1590,7936,1590,0,47.5201,-122.366
370000,2,1,820,6550,820,0,47.5478,-122.381
715000,4,2.5,2370,10000,1660,710,47.6383,-122.099
356000,4,2,1600,12500,1600,0,47.4713,-122.355
329950,4,1.75,1740,7208,1740,0,47.4483,-122.13
490000,3,2.25,1470,2500,1080,390,47.6762,-122.36
429000,3,3.25,1410,1246,1410,0,47.6981,-122.34
510000,4,2.5,1620,8125,1620,0,47.6255,-122.059
550000,3,2.5,2360,4080,2360,0,47.6825,-122.038
467500,3,1,1830,6453,1830,0,47.7139,-122.288
615000,5,2,2130,4180,1270,860,47.575,-122.388
325000,2,1,990,15120,990,0,47.7669,-122.206
219950,2,1,1010,4120,1010,0,47.488,-122.2
950000,3,1,1720,9830,1720,0,47.5905,-122.245
925000,3,1,1630,3200,1630,0,47.6351,-122.352
251200,4,1.5,1310,8250,1060,250,47.425,-122.332
215000,3,1.5,1610,5304,1610,0,47.3632,-122.087
245000,3,2,1850,8208,1180,670,47.3109,-122.362
259000,3,1.75,1270,4815,980,290,47.5495,-122.31
349950,4,1.5,1420,6720,1420,0,47.5518,-122.311
1.565E+06,5,4.5,5220,67319,5220,0,47.7666,-122.128
600000,2,1,1410,4500,1020,390,47.6883,-122.384
405000,2,1.5,1170,1274,1170,0,47.6719,-122.381
625000,3,2.5,1860,10027,1860,0,47.6775,-122.165
430000,4,1,1620,37075,1620,0,47.5654,-121.929
533000,3,3,1280,1085,1280,0,47.6569,-122.346
1.05E+06,4,2.5,2750,9949,2750,0,47.6595,-122.147
230000,3,1.75,1420,3000,710,710,47.4928,-122.274
275000,4,1.75,2000,8700,1010,990,47.374,-122.141
403000,2,1,1100,3598,1100,0,47.5738,-122.313
550388,3,3,1720,70567,1720,0,47.4936,-122.069
415500,3,1.5,1240,12400,1240,0,47.607,-122.132
913000,3,1.75,2170,4000,1110,1060,47.6546,-122.337
334998,2,1,1800,5182,900,900,47.5508,-122.3
201500,3,1,1160,8320,1160,0,47.3831,-122.288
820000,3,2.5,3030,46538,3030,0,47.664,-122.041
371000,3,1,890,7200,890,0,47.71,-122.286
229950,4,2.5,2150,7670,1240,910,47.3942,-122.189
344900,4,2.5,2150,7670,1240,910,47.3942,-122.189
840000,3,2.5,2060,9715,2060,0,47.6961,-122.316
285000,3,1.5,1380,12196,1380,0,47.3204,-122.322
475000,4,2.25,1800,7200,1230,570,47.7717,-122.376
420000,2,1,1460,7832,1460,0,47.4617,-122.346
685000,3,2,2210,5000,1710,500,47.6754,-122.357
879000,4,3,3590,89640,3590,0,47.7557,-122.036
197200,3,1,1140,8775,990,150,47.4824,-122.336
529950,3,1,1240,5000,1240,0,47.6755,-122.367
1.09E+06,4,2.5,4340,141570,4340,0,47.6805,-122.048
792000,3,1.5,1570,1050,1570,0,47.6358,-122.356
262000,3,2.5,1680,10300,1680,0,47.314,-122.001
353900,3,1.75,1560,5760,780,780,47.5272,-122.359
380000,1,1.5,1200,44866,1200,0,47.7205,-121.93
305000,3,2.5,1690,5175,1690,0,47.3564,-122.016
440000,4,2,2310,5004,1430,880,47.5471,-122.298
1.008E+06,4,3.5,2650,3060,2060,590,47.6735,-122.332
549900,5,3,3610,7555,3610,0,47.3534,-122.012
678500,4,3,2620,214750,2620,0,47.4239,-122.068
270000,3,2.25,1760,8287,1160,600,47.4501,-122.274
430000,3,1,940,12521,940,0,47.7169,-122.331
1.925E+06,5,4.25,4830,8050,3710,1120,47.5789,-122.286
790500,4,2.75,3350,5416,3350,0,47.6849,-122.016
447450,3,2.25,1570,7200,1570,0,47.7332,-122.232
375000,3,2,2240,5200,1630,610,47.6191,-122.296
565000,4,2,1950,9940,1950,0,47.6332,-122.118
400000,2,1,1010,3916,810,200,47.5728,-122.306
246000,3,1.5,1630,10200,1300,330,47.3155,-122.364
329922,3,1.75,1420,6289,1100,320,47.7398,-122.314
1.249E+06,5,3.25,3950,44431,2100,1850,47.6451,-122.173
375000,3,1,1210,7425,1210,0,47.7125,-122.33
385000,3,1.75,1890,9920,1230,660,47.7327,-122.306
591500,4,2.5,1690,4080,1140,550,47.6825,-122.379
255000,4,2,2560,12155,1350,1210,47.3326,-122.323
275000,3,1.5,1350,7800,1350,0,47.4805,-122.158
800000,4,2.75,3120,5000,3120,0,47.594,-122.062
327000,2,1,1140,7435,1140,0,47.73,-122.31
355000,4,1.5,2230,11536,1220,1010,47.4409,-122.348
310000,2,1,1050,8220,780,270,47.7598,-122.316
869000,5,3.25,4180,49222,2880,1300,47.5488,-122.094
272000,3,2,1200,5700,1200,0,47.5031,-122.242
665000,5,2.25,3320,60984,3320,0,47.4862,-121.718
225000,3,2.5,1590,8449,1590,0,47.3493,-122.177
375000,3,2.5,2750,37096,2750,0,47.3732,-122.023
375500,3,1.5,1530,7200,1530,0,47.7691,-122.297
550000,3,1.75,1570,6500,920,650,47.565,-122.398
248000,3,1,1470,7680,1220,250,47.5276,-122.359
546940,3,1,1470,7680,1220,250,47.5276,-122.359
680000,4,3,3150,6175,3150,0,47.5968,-122.017
350000,4,2.5,2380,6124,2380,0,47.3662,-122.175
593000,2,2.5,2000,2500,1810,190,47.5788,-122.396
390000,2,1,1140,8147,1140,0,47.7278,-122.289
297000,3,1,1340,18000,1340,0,47.4443,-122.509
355000,2,1,1450,9150,1450,0,47.4689,-122.277
309900,3,2.5,2020,26670,2020,0,47.2597,-122.31
257000,3,2.25,1810,12000,1810,0,47.3476,-122.3
1.698E+06,4,3,3600,9687,3600,0,47.6257,-122.208
300000,3,2,1260,2550,1260,0,47.6821,-122.378
500000,3,2,1560,1156,1560,0,47.605,-122.304
900000,8,4,4020,7500,2010,2010,47.6732,-122.363
695000,4,3,3150,9130,3150,0,47.5974,-122.017
213400,4,2.5,1680,6655,1680,0,47.3867,-122.191
425000,2,1,1320,8830,1020,300,47.6433,-122.404
420000,3,3,2700,47050,1570,1130,47.4446,-122.104
411000,1,1,1080,5000,1080,0,47.6603,-122.394
762500,4,2.25,3130,41382,3130,0,47.6683,-122.034
569950,5,4.5,4850,40902,4850,0,47.3181,-122.344
258000,4,1,1220,8500,1220,0,47.4792,-122.277
499000,3,2.25,1780,3665,1780,0,47.5495,-121.997
310000,3,1,1250,10723,1250,0,47.4894,-122.135
398500,2,2.5,1780,1311,1350,430,47.6962,-122.34
250600,4,2.5,1930,8660,1120,810,47.3261,-122.26
352000,4,2.5,2470,6116,1420,1050,47.3792,-122.047
600000,2,1,1180,2160,940,240,47.6313,-122.368
645000,3,1,2270,4182,1170,1100,47.688,-122.32
291500,4,2.5,1770,5000,1770,0,47.3503,-122.005
350000,4,1.75,2250,13515,2150,100,47.3789,-122.229
279000,3,2.5,1540,7280,1080,460,47.3102,-122.322
320000,2,1,820,5400,820,0,47.6976,-122.375
495000,2,2,1580,5203,1580,0,47.7174,-122.032
490000,4,2.5,2430,42646,1450,980,47.6164,-121.953
770000,5,1.5,2160,5000,2160,0,47.6645,-122.36
215000,3,1.75,1770,29004,1770,0,47.3204,-122.364
665000,3,3.5,3580,95832,3580,0,47.4239,-122.015
423500,3,2.25,1890,7498,1190,700,47.73,-122.297
850000,3,3,1910,4800,1910,0,47.6572,-122.346
155000,2,1,910,6232,910,0,47.5328,-122.272
505000,3,2.25,1460,7210,1460,0,47.6316,-122.119
780000,3,3.5,3310,5558,3310,0,47.5553,-122.003
165000,3,1.5,1630,22764,1630,0,47.3611,-122.293
707000,2,2.5,2130,5001,1330,800,47.6573,-122.399
497000,3,2.5,1220,1475,1220,0,47.6909,-122.395
349170,4,1.75,1670,8856,1070,600,47.5056,-122.251
287000,4,1.5,1300,10050,1300,0,47.4899,-122.116
2.375E+06,4,2.5,3220,20251,3220,0,47.5692,-122.192
645000,4,2.5,2430,14400,1670,760,47.6202,-122.138
238000,5,2.25,2240,9652,2240,0,47.4249,-122.211
328000,5,2.25,2240,9652,2240,0,47.4249,-122.211
365000,2,1.5,790,1123,700,90,47.651,-122.368
380000,3,1,1380,8147,1380,0,47.7407,-122.3
525000,4,1.5,1680,10500,1680,0,47.6806,-122.166
402000,4,2.25,2000,3672,1650,350,47.6769,-122.383
308000,2,1,1680,9250,860,820,47.7618,-122.162
405000,3,2.5,1960,6997,1960,0,47.5415,-121.887
808000,3,1.75,2590,32380,2590,0,47.7539,-122.37
875000,4,3.5,3790,6874,3790,0,47.6956,-122.022
860000,3,2.5,2370,55321,2370,0,47.6148,-122.057
367500,4,2.25,1930,7925,1300,630,47.7626,-122.312
604000,6,3.5,2580,13572,1290,1290,47.6796,-122.113
230000,2,0.75,890,19703,890,0,47.4922,-121.783
435000,4,2.75,2160,8148,1410,750,47.7261,-122.306
347500,4,2.5,1970,7098,1970,0,47.3576,-122.058
525000,4,1.75,1570,16697,1030,540,47.671,-122.135
280000,2,1.5,1480,15641,1480,0,47.5008,-122.366
490000,2,1.5,1480,15641,1480,0,47.5008,-122.366
265000,4,1.75,1430,5490,1430,0,47.494,-122.184
645000,4,2.25,2720,18295,2000,720,47.5851,-122.073
390000,3,2.25,2420,31497,1750,670,47.4422,-122.151
267500,3,2.5,1400,7629,1120,280,47.3788,-122.179
1.275E+06,4,3.5,5844,10766,5844,0,47.3293,-122.364
404000,4,1.75,1840,10720,960,880,47.6074,-122.125
380000,3,2.25,2530,12042,2530,0,47.3742,-122.125
812500,4,2.75,2810,10300,1810,1000,47.5626,-122.149
265000,3,1,1020,8610,1020,0,47.4974,-122.169
480000,5,2.75,2550,7725,1390,1160,47.5388,-122.171
264000,1,1,710,4725,710,0,47.7328,-122.34
1.35E+06,5,3,5530,38816,5530,0,47.7352,-122.116
550000,4,1.75,2150,9000,1110,1040,47.6812,-122.113
615000,2,1.5,880,2400,880,0,47.6144,-122.295
464000,3,1.75,1630,28600,1630,0,47.7742,-122.14
365000,3,1,1380,30940,1380,0,47.334,-122.106
490000,4,2.25,2800,10800,1680,1120,47.7448,-122.177
280927,4,2.25,2070,7350,2070,0,47.3615,-122.274
282613,2,1,830,6017,830,0,47.7466,-122.334
675000,3,2.25,2770,15886,2770,0,47.7464,-122.362
575550,4,2.5,2060,7475,1440,620,47.7272,-122.105
259900,3,2,1490,7770,1490,0,47.3686,-122.09
450000,4,2.25,2120,8267,2120,0,47.4885,-121.779
487500,4,2.5,2810,6296,2810,0,47.5019,-122.151
275000,4,2.25,2400,17842,2400,0,47.2866,-122.217
305000,3,2.5,2460,5027,2460,0,47.372,-122.102
395000,3,1.75,2030,217800,2030,0,47.2618,-122.12
215000,3,1,880,7648,880,0,47.1963,-121.997
410000,3,2,1320,6000,1320,0,47.5752,-122.304
440000,4,2.5,2160,7826,1390,770,47.7754,-122.276
1.16E+06,4,3.5,4190,15724,4190,0,47.5518,-122.096
500000,4,2,2280,7200,2280,0,47.7132,-122.355
961000,5,2.75,2590,6120,2590,0,47.6667,-122.327
825000,4,2.25,2770,9340,2770,0,47.5628,-122.081
734000,3,1.75,2145,3840,2145,0,47.6875,-122.357
490000,4,4.25,4480,5715,3680,800,47.373,-122.179
175000,4,2.5,1780,6000,1780,0,47.3828,-122.302
190000,1,1,720,4800,720,0,47.5303,-122.27
305000,4,2.25,2050,12581,2050,0,47.3215,-122.204
1.3E+06,3,1,2040,7936,1680,360,47.7028,-122.385
417000,2,1,920,6600,920,0,47.5452,-122.27
275000,2,1,680,4190,680,0,47.6901,-122.358
661000,3,2.5,1940,8196,1940,0,47.6786,-122.151
435000,4,2.75,2230,9640,1320,910,47.7269,-122.325
788000,5,2.25,2910,9454,1910,1000,47.5871,-122.173
1.795E+06,5,3.25,5270,17232,4010,1260,47.5536,-122.228
408000,5,3.25,2820,6589,2320,500,47.5357,-122.273
570000,2,1,1790,3760,1490,300,47.5926,-122.293
1.54E+06,5,3.25,2920,6960,2120,800,47.6712,-122.272
400000,2,1,840,5510,840,0,47.5247,-122.391
247000,3,1.75,1820,8740,1820,0,47.3074,-122.385
453000,3,1.75,1550,7200,1100,450,47.7071,-122.314
235000,2,1,1270,3008,650,620,47.5351,-122.279
675000,4,1.75,2460,5750,1620,840,47.5601,-122.378
516200,3,2,2110,5150,1080,1030,47.5521,-122.271
650000,1,1,920,91476,920,0,47.448,-122.472
257100,3,1.5,1500,10227,1000,500,47.2043,-121.996
457000,2,2,1440,9985,1440,0,47.7217,-122.03
540000,3,1.75,1610,3478,1060,550,47.6774,-122.372
268000,3,1.75,1970,10270,1970,0,47.3619,-122.285
300000,3,1,1150,7314,1150,0,47.6246,-122.113
380000,2,2.5,2110,114127,1590,520,47.4137,-122.212
725000,3,2.5,3580,54450,3580,0,47.4026,-122.033
249000,3,1,1000,19204,1000,0,47.3167,-122.081
274000,5,1,1680,9383,1400,280,47.7523,-122.311
1.78E+06,4,3.25,3950,10912,3950,0,47.5877,-122.196
396500,3,1.75,2390,7149,1350,1040,47.7244,-122.326
460000,2,1.5,1820,7800,1240,580,47.7513,-122.357
277000,3,1,1100,8536,1100,0,47.5162,-122.261
449500,6,4,2280,5275,1270,1010,47.5556,-122.294
785950,4,3,2530,4560,1540,990,47.6287,-122.3
545000,3,2.5,1940,9775,1440,500,47.7142,-122.222
244000,3,2,1360,9688,1360,0,47.2574,-122.31
165000,3,2.5,1660,2415,1660,0,47.3763,-122.148
435000,2,1,800,5000,800,0,47.6751,-122.372
642000,3,2.5,2670,10082,2670,0,47.6359,-122.045
340000,3,2.5,1720,4120,1720,0,47.4319,-122.328
730000,4,2.5,3550,35689,3550,0,47.7503,-122.074
563250,3,1.75,1370,2800,800,570,47.6157,-122.291
675000,5,2.5,2820,67518,2820,0,47.5794,-122.025
620000,3,1.5,1620,6630,1280,340,47.6948,-122.394
275000,2,2,1290,9041,950,340,47.5346,-122.291
270000,3,1,1830,8209,1830,0,47.7439,-122.228
325000,4,2.5,2040,5472,2040,0,47.3337,-122.189
476100,4,2.5,1850,1836,1600,250,47.5529,-121.996
700000,2,1,1300,12000,1300,0,47.6366,-122.229
220000,4,2,1620,5200,1620,0,47.3629,-122.091
236000,3,1.75,1560,10919,1560,0,47.2917,-122.366
790000,3,2.5,2600,4750,1700,900,47.6833,-122.4
350000,3,1,2010,6000,1210,800,47.5515,-122.298
130000,2,1,780,5300,780,0,47.513,-122.354
283200,4,2.5,1982,6406,1982,0,47.3636,-122.192
273000,3,1,1500,6250,890,610,47.5365,-122.368
599000,5,2.25,2460,8710,1330,1130,47.6651,-122.15
460000,4,2.5,2680,11998,1510,1170,47.337,-122.321
1.1572E+06,4,4.25,5860,52889,4910,950,47.7245,-122.095
385000,4,1.75,1720,8750,860,860,47.726,-122.21
264250,3,1,1420,7420,1420,0,47.4949,-122.239
608000,3,2.5,1760,1472,1640,120,47.6473,-122.374
450000,3,2.5,2790,48994,2790,0,47.3487,-122.088
1.755E+06,3,2,2360,4800,2360,0,47.6317,-122.312
339950,5,2,1890,6050,1890,0,47.5018,-122.242
760000,6,3.75,3810,6150,3810,0,47.694,-122.34
350000,2,1,1160,5395,860,300,47.7007,-122.354
541500,3,1.75,2320,55847,2320,0,47.3121,-122.253
730000,6,2.75,3280,16449,1910,1370,47.5914,-122.134
215000,3,1,980,5600,980,0,47.5308,-122.361
420000,3,2,1640,9972,1640,0,47.5812,-122.002
655000,4,2.25,2060,8470,1440,620,47.5605,-122.124
240000,3,2.5,1500,10652,1500,0,47.4015,-122.176
730000,4,2,2360,6000,1260,1100,47.6534,-122.41
390000,4,1.5,1940,12100,1940,0,47.6892,-122.164
473000,3,1,1280,10000,1280,0,47.5716,-122.139
698000,4,3.5,3630,5670,3630,0,47.5189,-122.206
511000,3,2.5,1820,4883,1820,0,47.7355,-122.224
358000,2,1.5,960,1808,960,0,47.6183,-122.298
499990,3,1.75,1630,8400,1060,570,47.5983,-122.149
322000,4,2.25,1940,10200,1360,580,47.4253,-122.283
201000,3,1,980,9682,980,0,47.4136,-122.207
765000,4,2.5,3140,16200,2570,570,47.4363,-122.342
920000,4,2.75,2880,5750,1710,1170,47.5874,-122.387
360000,4,2,1650,7552,860,790,47.7765,-122.324
297300,3,1.75,1980,9220,1980,0,47.2602,-122.219
399000,3,1,860,9403,860,0,47.6815,-122.173
400000,3,1,1430,10005,1430,0,47.7181,-122.338
230000,3,1.75,1260,10164,1260,0,47.4752,-122.133
290000,3,1,960,4560,960,0,47.5539,-122.365
323800,3,2.5,2060,7658,2060,0,47.2923,-122.36
574500,4,1.5,1430,6380,1430,0,47.7014,-122.313
505000,3,2.25,1670,1596,1220,450,47.6474,-122.396
372500,2,1,880,10950,880,0,47.7332,-122.352
425000,3,1.5,1300,19163,1300,0,47.6686,-122.153
446250,3,2.5,2380,214315,2380,0,47.4525,-121.748
330000,2,0.75,520,6862,520,0,47.326,-122.037
608095,3,2.5,2680,17707,2680,0,47.7031,-122.224
550000,3,2.5,2140,10136,1320,820,47.5602,-122.184
265000,4,2.5,1820,16103,1820,0,47.3553,-122.196
399888,4,2.25,1820,8255,1320,500,47.723,-122.337
430000,2,1,1050,2570,850,200,47.6764,-122.366
554990,3,2.5,2100,6092,2100,0,47.7508,-122.239
359950,3,2.5,2210,6280,2210,0,47.35,-122.043
405000,2,1,860,2599,860,0,47.675,-122.379
280000,2,1,870,4025,870,0,47.7243,-122.161
479950,4,2.25,2570,11070,2570,0,47.4507,-122.152
575000,5,1.75,2980,53578,2230,750,47.4908,-122.059
392000,4,2.25,2360,7733,2360,0,47.4403,-122.137
760500,4,2.25,2310,36136,2310,0,47.7506,-122.122
435000,3,2.5,2300,9521,2300,0,47.7447,-121.976
1.565E+06,4,2.75,2810,8570,2810,0,47.6159,-122.211
261000,4,1.5,2040,10488,1190,850,47.4557,-122.269
1.4825E+06,3,2.25,3290,5000,2730,560,47.6582,-122.28
853800,7,4,2960,2665,1950,1010,47.5835,-122.313
657500,3,2.5,2670,10496,2670,0,47.6272,-122.026
331950,4,2.5,2530,9933,2010,520,47.2654,-122.216
514000,3,1.75,1720,5899,1220,500,47.5399,-122.385
496000,3,3.5,3090,27598,2020,1070,47.3541,-122.453
1.093E+06,4,2.5,3930,21894,3930,0,47.7209,-122.128
195700,3,1,1120,5200,1120,0,47.3638,-122.088
1.39571E+06,4,2.25,3960,8640,2630,1330,47.6317,-122.304
1.175E+06,4,3.25,4060,20822,4060,0,47.7213,-122.055
643403,3,2.5,2350,9648,2350,0,47.6156,-122.108
357000,4,2.5,2380,7066,2380,0,47.3982,-122.172
865000,3,1.75,1480,8163,1040,440,47.638,-122.206
905000,3,2.5,2930,9280,2930,0,47.6335,-122.151
265000,3,1.5,1290,7100,1290,0,47.4227,-122.332
535000,2,2.5,2730,7246,2730,0,47.512,-122.175
450000,3,1,1290,5440,790,500,47.6951,-122.367
460500,4,2.5,2170,7533,2170,0,47.5057,-122.149
315000,4,1.75,1850,8580,1140,710,47.4877,-122.24
607500,4,2.5,2110,13939,1270,840,47.6431,-122.113
432000,2,1,960,3235,960,0,47.661,-122.344
1.695E+06,3,4,3910,5350,2610,1300,47.6393,-122.408
479000,4,2.5,2590,6139,2590,0,47.3883,-122.035
475000,5,2.75,3080,6600,3080,0,47.4501,-122.122
415000,3,1,1630,8146,1630,0,47.7293,-122.29
450000,2,1,910,5000,910,0,47.683,-122.374
1.14E+06,3,2.5,2780,33503,2110,670,47.5844,-122.081
430000,5,3,3880,8432,3880,0,47.4806,-122.176
296000,3,1.75,1360,10742,960,400,47.4351,-122.173
303000,4,2.25,2560,8927,1790,770,47.34,-122.271
641000,4,2.5,2600,6015,2600,0,47.5971,-122.031
280000,3,2.25,1220,5739,790,430,47.6952,-122.326
260750,3,2,1560,9635,1260,300,47.341,-122.309
601000,4,2.5,2080,5191,2080,0,47.5978,-122.017
255000,3,1.5,1490,6604,1490,0,47.4683,-122.351
555000,4,2.75,2020,10720,1420,600,47.6373,-122.104
865000,3,1.5,1530,10827,1530,0,47.6354,-122.234
1.388E+06,4,2.5,3450,17400,2180,1270,47.5969,-122.206
315000,3,2.25,1400,31626,1140,260,47.3029,-122.069
200000,2,1,1730,9610,1380,350,47.2956,-122.285
357000,3,1,1370,6450,1370,0,47.7195,-122.288
390000,2,1.5,1050,934,960,90,47.6029,-122.309
462000,5,1.75,2840,10220,2210,630,47.764,-122.36
174500,2,1,1010,5200,1010,0,47.4166,-122.323
305000,2,1,1210,7140,1210,0,47.7225,-122.349
449000,5,1.75,1720,14040,1150,570,47.7365,-122.339
260000,3,2,2710,5000,2710,0,47.5188,-122.373
751000,4,2.5,3110,6142,3110,0,47.701,-122.111
370037,2,1,1250,9270,1250,0,47.7284,-122.339
229950,3,1.75,1900,8910,1900,0,47.2769,-122.145
349000,3,1.75,1740,7682,1330,410,47.4451,-122.126
348000,4,2.5,2070,3808,2070,0,47.4498,-122.12
1.22E+06,3,3.25,3030,5600,2220,810,47.5978,-122.292
510000,4,3,3610,18948,3610,0,47.2911,-122.342
265000,3,1.5,1520,6805,1040,480,47.2907,-122.367
1.25E+06,3,2.75,2780,4815,2780,0,47.6569,-122.286
937500,4,4,5545,871200,3605,1940,47.676,-121.882
485000,3,1.75,2590,8384,1590,1000,47.7739,-122.199
489000,4,1,1150,5217,1150,0,47.6806,-122.287
400000,2,1,920,5120,920,0,47.5569,-122.394
638000,3,2.5,2110,3600,2110,0,47.665,-122.082
440000,3,1.75,1170,8740,1170,0,47.6849,-122.117
305000,6,2,1900,8240,1200,700,47.7037,-122.296
649950,6,2,1900,8240,1200,700,47.7037,-122.296
680000,4,2.5,3290,6012,3290,0,47.5961,-121.98
629000,4,2.5,2660,22050,2660,0,47.4911,-122.125
555000,3,2.5,2160,7584,2160,0,47.5751,-122.014
669000,4,2.75,2700,35362,2700,0,47.7628,-122.094
272000,3,2.5,1980,6608,1980,0,47.2642,-122.213
270000,4,2.25,2600,9900,1600,1000,47.4881,-122.237
215000,3,1,1280,9775,1280,0,47.3262,-122.334
690000,3,1.5,1710,17707,1180,530,47.5393,-122.216
256000,4,1.75,1270,6825,1270,0,47.5051,-122.242
255000,3,2.25,1890,7314,1100,790,47.4121,-122.172
550000,7,4,3440,8100,3440,0,47.6981,-122.349
410000,3,1,1190,5280,1190,0,47.5131,-122.383
410000,2,1,1030,4366,1030,0,47.5311,-122.384
259000,3,1.75,1240,4000,1240,0,47.4728,-122.191
292000,3,1,1730,21183,1030,700,47.5024,-122.332
1.648E+06,4,3.5,4610,12500,4610,0,47.6508,-122.203
518000,5,1,1590,5000,1190,400,47.5752,-122.381
485000,3,2.5,1760,3097,1760,0,47.5764,-121.996
259500,3,2,1330,35060,1330,0,47.3128,-122.13
354000,4,2.5,2340,5420,2340,0,47.3773,-122.029
999950,3,2.25,3740,22464,2330,1410,47.6354,-122.196
464500,3,1.75,1150,10466,1150,0,47.5531,-122.177
300000,3,2.5,1750,4200,1750,0,47.3605,-122.04
1.08E+06,3,2.75,3890,7216,3260,630,47.5445,-122.266
309950,4,2.5,1770,6666,1770,0,47.2877,-122.349
315000,3,1,1160,3700,1160,0,47.5651,-122.359
499950,3,1,1440,5580,1440,0,47.6898,-122.326
780000,4,2,2600,4800,1400,1200,47.637,-122.371
885000,3,3.25,2640,16090,1960,680,47.5374,-122.213
500000,2,1,1010,3885,1010,0,47.6224,-122.304
329000,3,2,1840,6755,1840,0,47.3512,-122.305
246000,4,1.75,1720,7455,1020,700,47.4669,-122.182
405000,3,1.5,1280,9600,1280,0,47.6922,-122.163
349000,4,1.75,1700,7800,1120,580,47.4801,-122.158
374950,4,2.5,1980,12062,1980,0,47.4038,-122.167
306000,3,2,1160,7217,1160,0,47.7279,-122.227
416000,4,1.75,1980,7840,990,990,47.6226,-122.115
560000,3,2.5,1960,12476,1960,0,47.5315,-122.172
260000,3,1.5,1270,20700,1150,120,47.7576,-122.296
306500,3,2.25,2060,38377,1560,500,47.2752,-122.319
299950,3,1.75,1980,11274,1480,500,47.4474,-122.167
265500,3,2.5,1450,8977,1450,0,47.2576,-122.214
219000,3,1.5,1200,12000,1200,0,47.268,-122.245
365000,3,1.75,1830,17349,1230,600,47.7427,-122.109
499000,3,2,2090,42689,2090,0,47.3497,-121.944
366000,3,1.75,1510,8301,1510,0,47.7243,-122.222
514950,3,2.25,1310,1264,1310,0,47.6987,-122.366
875000,4,2.75,3790,10669,3790,0,47.5976,-121.983
831000,3,2.25,2240,8800,2240,0,47.5937,-122.172
689900,4,3.25,2740,7266,2060,680,47.5346,-122.066
315000,3,2.5,1660,10763,1660,0,47.3812,-122.029
355000,0,0,2460,8049,2460,0,47.4095,-122.168
336500,3,1,1480,7284,970,510,47.7757,-122.353
1.1E+06,3,2.75,2640,4050,1750,890,47.6332,-122.281
375000,6,2,1900,8057,1170,730,47.762,-122.335
289275,3,2,2860,24046,1700,1160,47.7718,-121.904
455000,4,3.5,3440,6000,3440,0,47.4077,-122.331
505000,3,1.75,1640,10695,1640,0,47.7145,-122.222
450000,3,1,1450,3350,1450,0,47.5607,-122.378
567500,3,2.5,2300,7398,2300,0,47.5369,-121.876
265000,3,1.5,1460,8505,1460,0,47.4402,-122.195
340000,3,2,1570,14992,1570,0,47.6965,-121.922
375000,3,2,1540,8885,1540,0,47.7403,-121.984
920000,6,3,3300,4218,2200,1100,47.6557,-122.344
850000,4,2.25,2130,11843,2130,0,47.5358,-122.225
202000,3,1,1010,9750,1010,0,47.3244,-122.144
725000,4,3,2420,12000,2420,0,47.7267,-122.063
900000,3,3.25,3870,33980,3150,720,47.5589,-122.117
680200,2,1.5,1960,6000,1210,750,47.6849,-122.333
216500,3,1,1170,9000,1170,0,47.2109,-121.987
325000,3,1.5,1890,7650,1890,0,47.3454,-122.314
675000,3,2.5,2250,4134,2250,0,47.6651,-122.084
435000,2,0.75,750,16321,750,0,47.6985,-122.229
263500,3,1.75,1610,14000,1050,560,47.3429,-122.036
550000,4,2.25,2590,36256,2590,0,47.769,-122.094
875000,3,2.5,2520,3750,2520,0,47.5671,-122.404
246600,4,1,1340,8400,1340,0,47.3313,-122.343
337000,3,2.25,1460,941,1460,0,47.7145,-122.356
240000,3,1.75,1380,7500,1380,0,47.3628,-122.045
490000,3,1.75,1510,11120,1510,0,47.5931,-122.158
510000,5,2.5,2510,83231,1260,1250,47.4576,-121.984
305000,3,1,910,8008,910,0,47.726,-122.22
350000,3,2.5,1970,3655,1970,0,47.7453,-121.984
284200,3,1.75,1540,6632,1070,470,47.4973,-122.252
357000,4,2.5,1980,9757,1980,0,47.3675,-122.019
854000,4,2.75,3150,38865,2480,670,47.7302,-122.106
1.175E+06,4,2.5,4700,49658,4700,0,47.5878,-122.022
1E+06,3,2.25,2300,15952,1150,1150,47.6322,-122.232
616500,4,2.25,1880,3000,1760,120,47.6864,-122.349
750000,4,2.75,2640,3750,1840,800,47.6783,-122.363
650000,6,4.5,3900,9100,2870,1030,47.6612,-122.137
275000,4,2.25,2670,10050,1420,1250,47.3792,-122.28
540000,4,1.75,1840,4280,920,920,47.6681,-122.32
225000,3,1,1120,10665,1120,0,47.2886,-122.274
845000,4,2.5,2970,9072,2970,0,47.562,-122.114
490000,3,2.25,1410,7740,1410,0,47.523,-122.371
753000,4,2.5,3060,8167,3060,0,47.5521,-121.989
475000,3,1.75,2490,7210,1290,1200,47.726,-122.198
124000,1,0.75,840,7203,840,0,47.4756,-122.301
224000,1,0.75,840,7203,840,0,47.4756,-122.301
485000,2,1,1130,3800,1130,0,47.6862,-122.378
230000,4,1.75,1850,6000,1270,580,47.4923,-122.247
372000,4,2.75,2330,14175,1800,530,47.4193,-122.194
306000,4,2.5,1880,9426,1880,0,47.3584,-122.089
905000,4,3.5,2980,3000,2340,640,47.6768,-122.326
440000,4,1,1440,6678,1040,400,47.571,-122.392
280000,3,1.75,1630,10001,1100,530,47.3605,-122.12
435000,3,2.5,1778,147823,1778,0,47.6811,-121.915
425000,3,2.5,1930,4500,1930,0,47.5791,-122.001
204950,2,0.75,1130,11429,1130,0,47.4526,-122.284
670000,2,1.75,1650,7500,1000,650,47.6871,-122.207
475000,2,1,820,2723,820,0,47.6623,-122.339
352000,5,2.5,2900,6650,1450,1450,47.4935,-122.332
575000,4,1.75,2330,8800,1260,1070,47.6148,-122.113
1.73E+06,4,3.5,4440,20668,3240,1200,47.5472,-122.235
491000,3,2,1660,5070,1660,0,47.5552,-122.296
750000,4,2.5,3020,7465,3020,0,47.5982,-121.98
830000,4,2.5,1850,50662,1430,420,47.6535,-122.119
1.14E+06,6,3.75,5960,20197,3900,2060,47.5398,-121.869
137124,3,1,960,27442,960,0,47.4676,-122.134
225000,4,1,1150,6000,1150,0,47.562,-122.283
732600,4,2.5,2130,7300,1230,900,47.605,-122.167
818000,4,2.25,2460,8001,2460,0,47.548,-122.154
431000,3,2.25,2360,14950,2360,0,47.3856,-122.158
304000,2,2.25,1320,1034,1320,0,47.7039,-122.344
650000,5,2,1910,4667,1010,900,47.6236,-122.306
450000,2,2,1610,6160,1610,0,47.6644,-122.13
269000,4,1,1610,8401,1610,0,47.5104,-122.165
875000,3,1,1160,10732,1160,0,47.6391,-122.205
890000,4,2.25,2870,8393,1480,1390,47.5787,-122.245
565000,4,2.5,2280,9725,2280,0,47.7568,-122.141
448175,2,2,1370,1339,1150,220,47.6021,-122.295
235000,0,0,1470,4800,1470,0,47.5265,-121.828
680000,5,3,2970,6500,2970,0,47.5973,-122.018
629000,3,1.75,1460,12367,1120,340,47.3311,-122.375
494000,3,3.5,1570,1486,1330,240,47.652,-122.384
1.1E+06,4,3,2880,5500,1920,960,47.6448,-122.317
450000,5,2.5,1900,9460,1190,710,47.7096,-122.202
330000,3,1.75,2020,11050,1320,700,47.4706,-122.119
960000,4,2.5,3110,11397,3110,0,47.5623,-122.106
360000,4,2.5,2390,7056,2390,0,47.3385,-122.264
378000,3,2.5,2150,11672,2150,0,47.3515,-122.006
499950,3,1.75,1340,6250,1090,250,47.5427,-122.386
450000,3,2.5,1990,12866,1990,0,47.7477,-122.17
523500,2,2,1600,5969,800,800,47.5691,-122.394
600000,3,2.5,2680,43995,2680,0,47.7655,-122.086
290000,3,2.5,2080,4828,2080,0,47.3737,-122.132
176000,3,3.25,1340,5434,1340,0,47.3779,-122.045
885000,3,2,2590,3750,1790,800,47.635,-122.353
483000,2,1.75,1240,3000,1240,0,47.6689,-122.326
240000,3,1,1310,7125,1310,0,47.3739,-122.148
720000,4,2.25,2530,5200,1530,1000,47.6985,-122.382
311000,4,2.5,1780,5822,1780,0,47.4455,-122.169
332500,3,2,1600,7995,1600,0,47.5177,-122.257
164950,3,1.75,1570,15330,1080,490,47.4608,-122.34
371000,3,1.75,1570,15330,1080,490,47.4608,-122.34
264500,3,1.75,1650,16200,1650,0,47.3926,-122.168
1.738E+06,4,2.25,2920,6513,2260,660,47.638,-122.29
503000,2,1,870,4280,870,0,47.6697,-122.29
738000,4,2.5,2830,5010,2170,660,47.6952,-122.327
393000,2,1,980,3350,980,0,47.6858,-122.352
280000,2,1,990,45528,990,0,47.5013,-122.463
260000,4,2.5,2360,9647,1530,830,47.3367,-122.332
505000,2,1,1000,4640,1000,0,47.5659,-122.389
241000,3,1.5,1660,8000,1120,540,47.353,-122.172
530000,3,1.75,1520,9605,1520,0,47.667,-122.142
713000,1,1,1180,4000,840,340,47.5561,-122.266
487000,3,1.75,1770,10125,1770,0,47.7289,-122.353
128000,2,1,980,5393,980,0,47.3674,-122.081
210500,3,1,1840,10178,1040,800,47.3979,-122.317
420000,3,2.5,1810,7210,1210,600,47.5067,-122.163
679000,3,2.5,1780,4320,1780,0,47.6809,-122.293
784950,4,2.75,2840,4227,2840,0,47.7097,-122.107
352000,4,2.5,2650,6366,2650,0,47.3325,-122.171
386000,3,1.5,1270,1318,1080,190,47.6526,-122.384
335000,3,1.75,1260,17000,1260,0,47.5114,-122.361
472500,3,2,1750,15500,1490,260,47.5887,-122.065
599950,5,2.25,2680,13292,1340,1340,47.7422,-122.257
963990,4,3.25,3830,6765,3830,0,47.685,-122.016
735000,3,2,1610,3600,1610,0,47.5969,-122.293
858450,3,4.25,3840,9751,3840,0,47.6347,-122.064
665000,5,2.75,2670,4000,1800,870,47.6711,-122.315
290000,3,2.5,2000,7414,2000,0,47.3508,-122.057
250000,2,1,860,4320,860,0,47.5263,-122.325
192500,3,1.75,1420,7205,1420,0,47.3555,-122.175
350000,4,2,2060,13400,2060,0,47.4404,-122.34
518000,4,2.5,2790,9910,2790,0,47.4891,-122.141
563000,4,1,1410,3376,1410,0,47.6606,-122.365
375000,4,3,2420,9566,2420,0,47.4693,-122.266
400000,3,2.5,1460,1319,1460,0,47.698,-122.349
240000,5,1.75,2460,16000,1230,1230,47.3305,-122.351
317500,2,1,1000,5120,1000,0,47.6088,-122.307
1.315E+06,5,4,4420,36342,2740,1680,47.6468,-122.151
234000,3,1,1240,239144,1240,0,47.4303,-122.046
645000,3,2.5,1740,13750,1740,0,47.6264,-122.092
649000,2,1,1280,4840,1200,80,47.6762,-122.299
605000,4,2.5,2520,3980,2520,0,47.5399,-122.07
337900,3,3.5,1500,1471,1500,0,47.7034,-122.362
535000,3,2.75,2490,3600,2290,200,47.6098,-122.292
325000,4,1,1530,5684,1130,400,47.5507,-122.298
429950,4,2.25,1740,10875,1740,0,47.5132,-122.157
775000,3,2.5,3550,32807,3550,0,47.7292,-122.082
650000,2,1,1280,6000,1280,0,47.6339,-122.282
1.2E+06,4,2.25,2320,13114,2320,0,47.5762,-122.239
275000,2,1,1140,10404,1140,0,47.7497,-122.286
575000,4,3.5,3930,16970,3930,0,47.7412,-121.966
540000,3,2.5,2370,16455,1640,730,47.7634,-122.277
640000,3,1.75,2340,4206,1170,1170,47.5759,-122.288
275000,3,1.5,1240,9125,1240,0,47.4469,-122.155
672800,4,2.5,2740,10533,2740,0,47.6095,-122.006
495000,4,2.25,1940,9144,1430,510,47.5942,-122.135
820000,3,2.5,2950,35108,2950,0,47.7316,-122.035
475000,4,2.75,1980,11443,1980,0,47.7707,-122.273
1.275E+06,4,2,2850,7861,1450,1400,47.6995,-122.397
380000,3,1,1160,9375,1160,0,47.7419,-122.073
397500,3,2,2130,8225,2130,0,47.4396,-122.162
352000,5,2.5,2420,8560,1620,800,47.532,-122.285
893880,6,2.5,2820,8600,1430,1390,47.565,-122.144
635000,5,3.25,3710,34200,2510,1200,47.6101,-122.047
420000,3,2.25,1770,8165,1770,0,47.7166,-122.236
503000,3,2,1260,2500,750,510,47.6748,-122.371
689000,2,1.75,2330,10143,1220,1110,47.4899,-122.359
749500,4,2.75,2490,3840,1610,880,47.6551,-122.344
1.15E+06,6,3.75,4090,49542,3100,990,47.6408,-122.153
563500,4,2.5,2800,12831,2800,0,47.7392,-121.966
480000,4,3,2440,9664,1890,550,47.7649,-122.253
374950,4,3,2540,8800,1620,920,47.3204,-122.387
308950,3,2.5,1600,6250,1600,0,47.3675,-122.02
445000,4,2.75,2680,16934,1340,1340,47.542,-122.364
237200,3,1.5,1220,9000,1220,0,47.3642,-122.109
453500,3,1.75,1550,7270,1550,0,47.72,-122.317
616500,3,2,2080,4549,1040,1040,47.6886,-122.309
1.25E+06,5,5,5000,32909,5000,0,47.6012,-122.022
396000,1,1,630,5150,630,0,47.6923,-122.369
210000,3,1,1070,8179,1070,0,47.5015,-122.349
539000,2,1.75,1900,5175,1200,700,47.5689,-122.386
605000,3,2.5,2960,18600,2960,0,47.4358,-122.344
437500,3,2,1490,4800,1490,0,47.6933,-122.361
215000,3,1.5,1500,15000,1500,0,47.3926,-122.208
440000,4,2.5,2410,4780,2410,0,47.5326,-121.879
525000,3,1,2000,22500,1680,320,47.711,-122.308
319900,3,1.5,1140,20383,840,300,47.4755,-121.758
335000,3,1,1120,9075,1120,0,47.7551,-122.072
485000,3,2.25,2900,35273,2900,0,47.4013,-122.03
359999,4,2.25,3220,7700,3220,0,47.3188,-122.38
799000,5,2.75,2500,19783,2500,0,47.5938,-122.174
280000,3,2.25,1610,10454,1610,0,47.4517,-122.331
1.05E+06,4,2.75,2250,3433,1500,750,47.6382,-122.307
290000,1,2,1240,4800,1240,0,47.4778,-122.211
235000,2,2.25,1660,2748,1660,0,47.4333,-122.212
495000,3,1.75,2080,3000,1040,1040,47.6853,-122.35
290000,3,2.25,1880,7488,1880,0,47.3631,-122.277
230000,4,1.5,1050,9516,1050,0,47.4151,-122.181
234000,3,1.75,1480,8475,1480,0,47.3126,-122.361
597400,4,2.5,2420,4500,2420,0,47.6874,-122.037
370000,4,2.5,2190,17600,1110,1080,47.4712,-122.112
755000,4,2.5,2660,10452,2660,0,47.6972,-122.104
342000,3,2.5,2430,5715,2430,0,47.3718,-122.168
497000,2,1,770,3325,770,0,47.6102,-122.299
835000,3,1,3060,30166,3060,0,47.5656,-122.093
730000,4,2.75,2920,4500,2920,0,47.5646,-122.124
655000,3,1,1370,5250,1070,300,47.6421,-122.348
205000,3,2.5,1870,3118,1870,0,47.3739,-122.056
632750,4,2,1800,4800,1800,0,47.6388,-122.302
330000,5,3,2100,7715,1250,850,47.4866,-122.319
527500,5,2.25,2530,8250,2530,0,47.6117,-122.134
716500,4,2.5,3290,6465,3290,0,47.5981,-121.976
388500,4,2.5,1890,5395,1890,0,47.5415,-121.883
530000,3,1.75,1680,7770,1680,0,47.6028,-122.167
419000,3,2.5,2170,4517,2170,0,47.4819,-122.14
385000,3,1.75,1200,7360,1200,0,47.6979,-122.13
655000,4,2.5,2990,5669,2990,0,47.6119,-122.011
1.695E+06,4,2.75,3770,10900,3070,700,47.5849,-122.29
279000,2,1,1020,47044,1020,0,47.4206,-122.155
262000,3,1.5,1700,9579,1100,600,47.3209,-122.338
533000,4,1,1550,4750,1550,0,47.6824,-122.389
640000,3,1.75,1680,8100,1680,0,47.7212,-122.364
285000,3,2.25,1680,35127,1680,0,47.3025,-122.067
458400,4,2.5,1910,10300,1910,0,47.7581,-122.359
620000,5,3.25,3160,10587,2190,970,47.7238,-122.165
465000,3,1.5,2020,11358,1190,830,47.6641,-122.185
690000,4,3.75,3210,7054,3210,0,47.7268,-122.103
462500,3,2.25,2350,51400,1390,960,47.7417,-122.053
369950,4,2.5,1910,10221,1910,0,47.381,-122.035
124500,2,1,840,6480,840,0,47.264,-122.258
950000,4,2.25,2620,10920,2620,0,47.6117,-122.164
418000,4,1.5,1220,10580,1220,0,47.6205,-122.116
160000,3,1,1060,8000,1060,0,47.305,-122.218
457000,4,2.5,2200,10800,1500,700,47.7711,-122.288
530000,2,1.75,2120,7680,1130,990,47.5304,-122.374
385000,3,1,1250,7300,1250,0,47.6032,-122.125
491000,3,1.75,1440,7800,1440,0,47.5996,-122.12
521000,4,2.25,1890,8034,1890,0,47.6338,-122.117
255000,3,1,1140,8528,1140,0,47.2098,-122.004
292050,5,3,2840,7199,1710,1130,47.5065,-122.275
326000,6,3,1880,7200,1880,0,47.5029,-122.188
300000,2,1,750,5120,750,0,47.5312,-122.375
291600,3,1.75,1630,7480,1330,300,47.4514,-122.159
435000,5,1.5,1720,12551,1720,0,47.5241,-122.053
465000,3,2.5,1600,1311,1600,0,47.6903,-122.394
200000,3,2.25,1230,7420,1230,0,47.3184,-122.22
238000,3,1.5,1610,6132,1090,520,47.5017,-122.174
455000,4,2.5,1320,7000,1320,0,47.6007,-122.127
230000,6,3,2180,7220,2180,0,47.3046,-122.305
808000,4,2.25,2190,4104,1410,780,47.6419,-122.306
578500,3,1,1490,5700,1490,0,47.6549,-122.331
390000,3,2,1463,868,1463,0,47.6843,-122.317
517500,3,2.5,1800,3933,1800,0,47.5746,-122.009
755000,4,2.75,2880,4000,2100,780,47.5843,-122.293
579500,3,1.75,1250,4120,980,270,47.685,-122.36
649950,3,2.75,1670,1350,1350,320,47.5764,-122.408
228000,4,1.75,2000,6120,1100,900,47.5035,-122.258
665000,4,1.75,2280,3680,1470,810,47.6754,-122.3
689000,4,2.5,2110,6069,2110,0,47.6374,-122.111
560000,4,2.5,2520,11240,1440,1080,47.6748,-122.144
529000,3,1,1590,6420,1590,0,47.5355,-122.392
375000,5,2.5,2100,14858,2100,0,47.4721,-122.123
325000,4,2.75,2090,9240,2090,0,47.4854,-122.343
583000,4,2.5,3390,10519,3390,0,47.332,-122.334
330000,2,1,790,9784,790,0,47.7634,-122.284
262000,3,2.5,1970,8727,1970,0,47.3263,-122.189
555000,4,2.5,2870,6776,2870,0,47.539,-121.878
585000,2,1,1110,6000,1010,100,47.5632,-122.282
425590,3,2.75,1940,3088,1770,170,47.5185,-121.878
235000,2,1,720,4840,720,0,47.5534,-122.375
362362,2,1,710,4000,710,0,47.5535,-122.269
252000,3,2,1370,7500,1370,0,47.3634,-122.046
439000,4,2.5,2690,9551,2690,0,47.4343,-122.156
465000,4,2.25,3360,10810,3360,0,47.3316,-122.203
249900,4,2,1500,7854,1500,0,47.3127,-122.354
665000,2,2.5,2600,5000,1300,1300,47.5806,-122.379
370000,3,1.75,1160,8774,1160,0,47.7159,-122.165
620000,2,1,1430,3000,1300,130,47.6415,-122.303
375000,3,1,1870,7671,1720,150,47.7162,-122.36
552625,4,2,2560,9390,1280,1280,47.7169,-122.329
315500,3,1,1160,10500,1160,0,47.7267,-122.227
620000,2,1.75,1680,8187,1680,0,47.5603,-122.081
510000,4,2.5,2010,9075,1310,700,47.553,-122.182
652500,4,2.5,2540,38677,2540,0,47.6694,-122.044
574000,4,2.5,3240,22795,3240,0,47.6329,-121.969
430000,3,2.5,2670,12806,2670,0,47.3686,-122.059
390000,3,2,1080,7236,1080,0,47.7143,-122.32
466500,3,1,1430,3840,950,480,47.6847,-122.381
315000,2,2.25,1290,2436,1290,0,47.6803,-122.156
220000,4,1.5,1240,9600,1240,0,47.3206,-122.397
325000,3,1.75,1840,17286,1440,400,47.371,-122.173
365000,3,1,1120,8443,1120,0,47.7715,-122.336
356000,3,3.5,2100,12384,2100,0,47.4687,-122.263
380000,4,1.75,2030,12518,1610,420,47.7278,-122.297
579000,4,2.25,2030,8764,2030,0,47.7214,-122.11
682000,2,1,890,5000,890,0,47.6666,-122.279
499000,3,1.75,1750,12325,1470,280,47.6832,-122.118
333760,3,1,1300,5880,1300,0,47.6937,-122.113
745000,4,2.5,2650,18903,2650,0,47.5761,-121.989
380000,3,1.75,1750,10870,1750,0,47.4989,-122.188
435000,3,3,1440,1350,1440,0,47.6525,-122.345
520000,3,2.75,1700,3264,1060,640,47.6767,-122.311
965000,4,2.5,3920,41206,3920,0,47.7325,-122.132
270000,3,2.25,1470,16728,1350,120,47.4968,-122.302
1.1E+06,5,2.75,2520,4643,2120,400,47.6348,-122.301
577500,3,1.75,2140,13286,1220,920,47.5722,-122.128
650000,3,1.75,1550,5000,1250,300,47.6722,-122.372
1.2275E+06,4,2.5,3180,10319,3180,0,47.5372,-122.232
1.9E+06,5,4.25,6510,16471,3250,3260,47.5758,-122.242
475000,2,2,1440,3720,1440,0,47.6902,-122.325
200000,3,1,1150,10132,1150,0,47.3172,-122.372
397000,4,2.5,2320,11717,2320,0,47.484,-121.78
383610,3,2,1230,8450,1230,0,47.7548,-122.305
275000,4,2.5,2060,5742,2060,0,47.3612,-122.185
840000,3,2,2783,11177,2783,0,47.538,-122.38
365000,4,2.5,2140,7350,2140,0,47.4483,-122.124
362000,3,2.75,1420,955,1160,260,47.5477,-122.003
350000,3,1.75,2090,6258,1390,700,47.5503,-122.301
200000,2,1.75,1320,13052,1320,0,47.712,-121.352
299000,4,2.5,2300,8100,1360,940,47.2979,-122.371
555000,4,1.5,3050,82764,1650,1400,47.5266,-122.189
1.326E+06,3,2.25,2960,8330,2260,700,47.7035,-122.385
896000,5,2.75,2520,16100,1570,950,47.528,-122.224
550000,2,1.75,1740,7290,1280,460,47.6461,-122.397
324500,2,1,1300,6617,1300,0,47.7238,-122.302
312500,3,1,1170,7350,1170,0,47.625,-122.117
485000,4,3.25,1946,17786,1946,0,47.359,-122.452
511000,2,1,1250,5413,1250,0,47.6945,-122.315
139500,2,1.5,1230,1561,1230,0,47.3768,-122.149
464000,4,2.5,2180,7203,2180,0,47.5119,-122.151
255000,3,1.75,1740,8800,1140,600,47.2968,-122.372
679975,4,2.5,3830,4644,2900,930,47.5384,-121.88
624800,3,2,2250,14274,1500,750,47.5762,-122.217
920000,3,2.75,2590,223027,2590,0,47.6145,-122.001
1.365E+06,3,2.5,2090,6000,2090,0,47.6567,-122.281
510000,3,1.5,2400,10275,1540,860,47.6888,-122.126
289659,4,2.25,2260,7200,2260,0,47.4121,-122.183
585000,4,2.5,2910,6250,2910,0,47.538,-121.87
555000,5,3,3640,6930,3640,0,47.3521,-122.012
940000,4,2.75,3770,24897,2550,1220,47.5824,-122.078
460000,3,2,1600,7350,1600,0,47.6977,-122.126
319000,3,2.5,2110,7434,2110,0,47.3935,-122.169
280000,3,2.5,1720,1916,1720,0,47.4895,-122.166
250000,3,1,1100,7470,1100,0,47.5242,-121.831
749950,4,2.5,2620,8312,2620,0,47.6272,-122.033
458000,5,2.5,3090,23265,2990,100,47.7709,-122.212
465000,3,2.5,1890,4808,1890,0,47.5348,-121.866
580000,3,1.75,1850,2797,1150,700,47.6871,-122.336
700000,4,2.5,3100,36562,3100,0,47.7646,-122.065
350000,4,2.5,2506,7206,2506,0,47.3236,-122.337
456000,4,1,1700,7689,1080,620,47.6955,-122.116
290000,3,2,1550,18958,1550,0,47.3699,-122.319
475000,4,2.75,2200,16288,1290,910,47.4793,-122.122
285000,3,2.5,1890,3629,1890,0,47.3613,-122.041
309000,3,1,1140,6400,1140,0,47.4902,-122.331
860000,4,2,3740,32417,3740,0,47.6728,-122.012
219000,3,2.25,1940,6500,1440,500,47.3565,-122.149
546500,3,2.5,2130,7199,2130,0,47.6331,-122.027
338000,2,1,1470,5566,770,700,47.5348,-122.269
505000,2,1,1070,8130,1070,0,47.697,-122.37
340000,4,1.75,1680,15084,840,840,47.6895,-121.912
678000,3,2.25,2730,10675,2730,0,47.6289,-122.042
800000,3,1.75,1890,10292,1890,0,47.535,-122.234
112000,1,1,1080,3230,1080,0,47.3075,-122.217
252000,3,1.75,1440,16819,1440,0,47.3318,-122.373
335000,4,2.75,2540,7210,1600,940,47.4601,-122.165
610000,3,2,2300,13418,1430,870,47.6075,-122.2
245000,3,2,1690,6790,1360,330,47.2981,-122.38
493500,3,1.75,1800,16026,1390,410,47.5815,-122.121
596500,4,2.25,1770,8505,1770,0,47.6904,-122.102
245000,3,2,1190,4072,1190,0,47.5276,-122.274
333500,3,1.75,1320,7200,1320,0,47.7341,-122.237
373000,3,1,1290,8974,1290,0,47.74,-122.173
759900,4,2.5,3000,5639,3000,0,47.7066,-122.115
317000,3,2.25,1358,1204,1358,0,47.7054,-122.346
670000,3,1.5,1220,4080,1220,0,47.5746,-122.289
985000,2,2.5,2720,26761,2720,0,47.4499,-122.376
310000,3,1.5,1060,6954,1060,0,47.5497,-122.355
750000,4,2.5,3020,13122,2540,480,47.6989,-122.111
408000,3,2,1640,3440,1640,0,47.6829,-122.097
900000,5,3.75,3870,8225,3870,0,47.6078,-122.01
460000,4,2.25,2860,15054,1460,1400,47.7655,-122.3
339000,4,2.5,1740,6000,1740,0,47.5026,-122.236
660000,3,2,1140,6000,1140,0,47.637,-122.355
449950,4,3,3290,10783,3290,0,47.3904,-122.178
235000,3,1,1210,6000,1210,0,47.4984,-122.224
769000,5,2.25,3320,13138,1900,1420,47.759,-122.269
428000,2,2,1350,3900,1350,0,47.7094,-122.03
445000,3,2.25,1990,7340,1990,0,47.7579,-122.141
462000,4,2.5,2060,6958,1220,840,47.7251,-122.168
775000,3,1,1460,6198,1460,0,47.6626,-122.361
605000,4,1.75,2250,10108,2250,0,47.5922,-122.118
193500,2,1,950,15996,950,0,47.4987,-121.787
389950,4,2.5,3140,8060,3140,0,47.3091,-122.343
790000,4,3.5,3560,6098,3560,0,47.5828,-121.972
442000,2,1,1410,5000,940,470,47.5531,-122.379
890000,4,2.25,2770,13500,2770,0,47.543,-122.231
235000,3,1,1864,6978,1864,0,47.285,-122.206
495000,4,1.75,1930,6720,1130,800,47.6935,-122.312
600000,4,2.5,3870,50965,3870,0,47.3109,-122.045
1.4E+06,3,2,2020,5500,1790,230,47.6388,-122.409
251000,3,2,1300,8400,1300,0,47.368,-122.315
471000,4,2.25,3410,57063,2410,1000,47.505,-122.11
597000,4,2.5,2370,41338,2370,0,47.7379,-122.052
804000,5,3.5,2770,9305,2770,0,47.5628,-122.114
357000,3,1.75,1250,17493,1250,0,47.7613,-122.274
419990,3,2.5,1690,1689,1150,540,47.5528,-121.999
725000,4,2.5,3040,35201,3040,0,47.4872,-122.066
275000,3,2.5,2710,5733,2710,0,47.3357,-122.171
445000,3,2.25,1190,13630,1190,0,47.4813,-121.735
510000,3,2.5,2300,27566,2300,0,47.7369,-121.96
330000,4,1,1360,13372,1360,0,47.7622,-122.263
270000,3,1,1500,5605,750,750,47.5456,-122.359
495000,4,2,1610,4770,1230,380,47.5333,-122.381
225000,4,1.75,1420,10300,1420,0,47.3121,-122.215
716528,3,1.5,1750,5400,1050,700,47.6799,-122.279
260000,3,2.5,1510,6095,1510,0,47.3498,-122.037
471000,4,2.5,2330,9928,2330,0,47.4836,-121.783
690000,5,3.5,2690,4800,1930,760,47.5592,-122.269
548000,5,1.5,1700,7200,1700,0,47.7614,-122.203
505000,3,1,1020,5410,880,140,47.6924,-122.31
325000,3,1,1160,11799,1160,0,47.7263,-122.229
682000,4,2.25,2450,34092,2450,0,47.5751,-122.049
605000,3,2.25,2010,10760,2010,0,47.7276,-122.103
276200,2,1.75,1370,4495,1370,0,47.3794,-122.317
530000,3,1,1370,4040,1370,0,47.6867,-122.354
245000,3,3,1990,9600,1440,550,47.3499,-122.296
654950,4,2.5,2790,45902,2790,0,47.7674,-122.086
221900,2,1,780,6727,780,0,47.4733,-122.281
466000,4,2,2240,4508,1340,900,47.5096,-122.25
383150,3,2,2210,6387,2210,0,47.265,-122.302
657100,4,1,1390,4240,1050,340,47.6596,-122.338
539000,3,2,1800,43995,1800,0,47.7585,-122.022
400000,6,3,3320,15600,1660,1660,47.2983,-122.166
215000,4,2.5,1960,11600,980,980,47.2898,-122.222
489000,2,1,850,2850,850,0,47.6875,-122.309
649000,4,2.5,2980,12764,2980,0,47.5857,-122.027
700000,4,1.75,1980,10800,1320,660,47.5899,-122.173
268500,2,1,790,8424,790,0,47.7511,-122.352
515000,3,2.5,1800,5001,1800,0,47.7126,-122.231
685000,4,2,2260,10800,2260,0,47.6124,-122.153
305000,2,1.5,800,2142,800,0,47.5917,-122.297
950000,4,2,2490,4600,2090,400,47.6557,-122.278
292500,4,2.5,1610,4568,1610,0,47.3351,-122.289
270000,4,1.75,1850,7730,1100,750,47.7481,-122.355
450000,4,1.75,1850,7730,1100,750,47.7481,-122.355
535000,4,1,1920,6480,1920,0,47.6897,-122.374
550000,3,2.5,1740,3082,1740,0,47.5489,-122.006
457500,3,2.25,1430,2003,980,450,47.5908,-122.292
136500,3,1.5,1420,8580,1420,0,47.3076,-122.362
224097,3,1.5,1420,8580,1420,0,47.3076,-122.362
254000,3,2.5,1560,10608,1560,0,47.3572,-122.161
335000,4,2.25,2030,13500,1230,800,47.4596,-122.066
594950,5,2.5,3280,6553,3280,0,47.475,-121.737
350000,3,1.75,1360,18123,1360,0,47.4716,-121.756
169950,3,1,1180,9832,1180,0,47.3845,-122.085
432500,3,2.5,1940,10800,1340,600,47.7471,-122.075
440000,2,1.75,1300,4000,1300,0,47.6687,-122.288
233703,3,2.25,1650,3788,1650,0,47.3908,-122.167
310000,3,1.5,1140,3292,1140,0,47.5701,-122.017
735000,3,2.5,2540,6762,2540,0,47.6239,-122.144
730000,4,2.75,3440,8150,3440,0,47.5168,-122.189
257000,3,1.75,1800,9000,1200,600,47.4932,-122.278
485000,2,2.25,1260,1240,1260,0,47.6531,-122.352
899000,4,2.25,2370,6000,1440,930,47.7023,-122.388
279000,3,1,1520,8055,1520,0,47.7222,-122.305
225000,4,2,1750,7245,1050,700,47.3164,-122.196
1.355E+06,3,1.5,2680,4775,1880,800,47.6333,-122.347
355000,3,2.5,1590,4242,1590,0,47.5309,-121.876
382500,4,1.75,1560,8700,1560,0,47.7274,-122.181
324360,3,2.5,2000,9669,2000,0,47.1964,-122.009
315000,3,1.75,2380,10450,2380,0,47.3143,-122.37
426000,2,1,2230,11472,2230,0,47.7372,-122.35
395000,5,2.5,2820,6305,2820,0,47.2616,-122.296
212644,3,1,1570,9650,1570,0,47.3531,-121.982
510000,3,3,1845,5100,1845,0,47.5204,-122.208
85000,2,1,830,9000,830,0,47.3813,-122.243
235000,2,1,830,9000,830,0,47.3813,-122.243
295000,4,2.5,2030,5754,2030,0,47.3542,-122.137
720001,3,2.5,1430,2200,1430,0,47.6601,-122.331
313950,3,1,1510,6083,860,650,47.6966,-122.324
415000,3,1,1510,6083,860,650,47.6966,-122.324
305000,3,1.75,1610,12247,1610,0,47.4476,-122.124
625000,3,1.5,1600,4128,1250,350,47.6122,-122.297
490000,3,1,1420,11040,1420,0,47.5969,-122.14
269950,3,2,1660,8641,1660,0,47.3663,-122.088
2.7E+06,5,4,4230,27295,3230,1000,47.6803,-122.214
829000,4,3,3310,4500,2910,400,47.6594,-122.345
635000,4,2.5,2470,77550,2470,0,47.5888,-122.011
217500,3,1,1040,9750,1040,0,47.4553,-122.274
270000,4,1.75,1850,7350,1050,800,47.3413,-122.277
1.245E+06,3,3,4610,8400,2790,1820,47.5854,-122.292
480000,4,2.5,2480,5100,2480,0,47.7383,-121.969
575000,3,1.75,2130,6500,1170,960,47.6424,-122.386
426950,4,2.75,2350,5589,2350,0,47.5098,-122.155
125000,3,1,920,7314,920,0,47.2892,-122.22
208000,3,1,920,7314,920,0,47.2892,-122.22
325000,4,2,1780,10622,900,880,47.4573,-122.158
597157,7,4,2690,10880,2690,0,47.6787,-122.168
728725,4,2.5,3010,3120,3010,0,47.5539,-121.996
708000,5,2,3180,10800,1910,1270,47.6354,-122.103
1.3E+06,4,3,4120,14021,4120,0,47.5985,-122.026
405000,3,1,1280,11625,1280,0,47.6827,-122.059
550000,4,2.75,1690,6090,1400,290,47.6814,-122.269
451000,4,2.5,2320,5375,2320,0,47.5415,-121.883
540500,5,3.75,3090,7415,3090,0,47.435,-122.329
1.025E+06,5,3.5,5050,16500,5050,0,47.5863,-121.967
218000,4,1,1640,10455,950,690,47.2974,-122.366
562000,4,2.25,2170,7007,1540,630,47.672,-122.169
401500,4,2.5,3140,94525,2280,860,47.4155,-122.163
196700,2,1,1090,9994,1090,0,47.4761,-122.287
583000,3,1.75,1930,10183,1480,450,47.5624,-122.135
309900,5,2.5,2100,17825,1400,700,47.3094,-122.191
485000,4,3,3110,18843,3110,0,47.4619,-122.154
465000,3,1,930,3348,930,0,47.5532,-122.277
595000,4,2.25,2050,8372,2050,0,47.7234,-122.107
254000,3,1,1160,7560,1160,0,47.45,-122.179
488500,3,2.75,1820,9490,1820,0,47.7481,-122.178
260000,4,2.5,2110,8990,2110,0,47.4457,-122.127
166000,2,1,870,8487,870,0,47.4955,-122.239
440000,2,1.5,1080,6760,1080,0,47.7008,-122.386
375000,3,2,1260,7560,1260,0,47.7225,-122.351
529500,2,1,900,4800,780,120,47.6575,-122.4
338000,2,1,750,6439,750,0,47.6995,-122.354
335620,3,2.25,1800,15903,1340,460,47.3813,-122.043
464000,4,2.25,2220,15232,1690,530,47.7449,-122.103
354000,2,1,1390,7740,1390,0,47.5232,-122.371
601000,4,3.5,2160,3600,1660,500,47.6103,-122.297
285000,3,2.25,1840,9040,1370,470,47.3144,-122.339
462500,2,2,1690,4200,1690,0,47.621,-122.303
350000,4,2.5,2650,10459,2650,0,47.2739,-122.293
329000,4,1,1120,3844,1120,0,47.7038,-122.352
312500,4,2.5,2500,11983,1320,1180,47.4292,-122.148
370000,4,2.5,2220,5338,2220,0,47.4887,-122.15
399900,3,1.75,1260,12750,1260,0,47.7289,-122.233
398000,3,1,1480,6550,1480,0,47.5498,-122.381
550500,2,1.5,930,7400,830,100,47.5691,-122.408
709000,3,2.75,2780,7200,1870,910,47.5632,-122.27
402000,5,2.75,2770,7620,1700,1070,47.5188,-122.348
450000,3,1.5,1530,23660,1530,0,47.7467,-122.295
524000,3,2.25,2140,6720,1440,700,47.6949,-122.396
800000,4,2.75,4600,322188,2400,2200,47.4626,-121.739
185000,4,1,1760,8906,1230,530,47.4288,-122.198
365000,4,1,1760,8906,1230,530,47.4288,-122.198
925000,4,2.5,3110,11422,3110,0,47.6833,-122.271
714000,3,1.75,2260,11781,1520,740,47.5982,-122.128
495000,3,2,1460,9759,1460,0,47.6644,-122.144
535000,3,2.25,2050,6648,1230,820,47.7258,-122.332
880000,4,2.5,2340,10800,2340,0,47.5715,-122.225
150000,3,1.5,1230,8056,1230,0,47.4878,-122.314
554500,3,2.25,1880,6565,1420,460,47.6396,-122.113
520000,3,1.75,1280,3880,1280,0,47.6871,-122.391
839990,4,2.75,3660,5637,3660,0,47.6845,-122.017
500000,3,2.5,1650,5683,1650,0,47.683,-122.035
305000,2,1,1960,186872,1960,0,47.2681,-122.267
247800,3,2.5,1580,2170,1580,0,47.5418,-122.289
344200,4,2.5,2490,5812,2490,0,47.3875,-122.155
459950,4,2.5,2000,6107,2000,0,47.7557,-122.221
229900,4,1.75,1550,9899,1550,0,47.3583,-122.183
750000,4,2.25,2820,9602,1950,870,47.5881,-122.113
509000,4,2.5,2600,9355,1840,760,47.7446,-122.249
680000,4,1,2200,12137,1640,560,47.7473,-122.261
661500,5,2.5,2500,7200,1490,1010,47.6964,-122.12
370000,2,1,1270,1399,1270,0,47.5552,-122.381
785000,4,2.75,2900,17400,2410,490,47.6431,-122.108
355000,2,1,840,6720,840,0,47.5707,-122.396
446000,4,2,1940,6350,970,970,47.6948,-122.357
830000,5,3.5,3490,21780,3490,0,47.6707,-122.144
324000,3,2.5,1940,8347,1940,0,47.3654,-122.164
500000,4,2.25,2490,23478,2490,0,47.7547,-122.094
745000,3,1,1390,9112,1390,0,47.6071,-122.197
1.197E+06,4,2.5,3940,4407,2620,1320,47.6374,-122.299
385000,2,2.5,1760,3710,1130,630,47.7335,-122.16
565000,3,2.25,2560,8040,1510,1050,47.7124,-122.303
465000,4,2.5,2300,7314,1420,880,47.7671,-122.33
401000,3,3.25,1770,1977,1770,0,47.7186,-122.314
385000,3,1.75,2310,11200,1630,680,47.3637,-122.21
395000,3,2.5,2310,4930,2310,0,47.4512,-122.208
245000,5,1.5,2000,8100,2000,0,47.4945,-122.304
500000,3,2,1540,3600,890,650,47.6103,-122.296
334000,5,1.75,2590,6720,1750,840,47.435,-122.192
550000,3,1,980,10960,980,0,47.5908,-122.173
216000,3,1,1730,7950,1180,550,47.3644,-122.312
340500,3,2.5,3070,5871,2510,560,47.5007,-122.223
375000,4,2.25,2100,12738,2100,0,47.4698,-122.118
600000,3,2.75,2080,16740,1580,500,47.3632,-122.324
375000,4,1.75,1890,8000,1250,640,47.7576,-122.333
536500,4,1.75,2000,4000,1450,550,47.5659,-122.375
599900,3,3,3030,35123,1760,1270,47.4694,-122.006
750000,2,1.5,1110,3600,1110,0,47.6382,-122.359
355000,3,1,1650,10075,1170,480,47.7695,-122.359
590000,3,2,1410,6413,910,500,47.6826,-122.298
680000,2,1,2140,6000,1070,1070,47.651,-122.399
429000,3,2.5,1860,11122,1860,0,47.5062,-122.151
581000,2,1,1170,4080,1170,0,47.6784,-122.386
463800,3,1.5,980,7770,980,0,47.6923,-122.201
2.983E+06,5,5.5,7400,18898,6290,1110,47.5431,-122.112
443000,5,1.75,1650,3000,1650,0,47.5955,-122.306
276200,3,2.5,1480,7210,1180,300,47.3124,-122.351
630000,5,3.5,4060,8309,2960,1100,47.757,-122.228
570000,3,1.75,1370,3300,1370,0,47.6714,-122.32
979700,4,2.25,2480,6000,2380,100,47.6392,-122.406
730000,4,2.5,2030,4080,1730,300,47.6753,-122.311
268450,5,2.25,2200,9600,1100,1100,47.3263,-122.364
490000,3,1.75,1770,7508,1270,500,47.7354,-122.343
808000,3,2.5,2550,6240,1750,800,47.6992,-122.387
350000,3,1,1250,9786,1250,0,47.7622,-122.163
695000,4,1.75,2390,5880,1390,1000,47.6956,-122.399
1.228E+06,4,2.5,5730,44947,4280,1450,47.6052,-122.064
309950,1,1,1120,11800,1120,0,47.5123,-122.331
134000,3,1,1270,8508,650,620,47.4961,-122.322
645500,4,2.5,2390,9638,2390,0,47.5598,-122.018
750000,3,2,1760,5488,1540,220,47.6479,-122.367
1.399E+06,3,2.5,2560,3600,2110,450,47.632,-122.279
344900,4,1.75,1820,7700,1100,720,47.7545,-122.357
601450,2,3.25,1840,1500,1840,0,47.6595,-122.354
575000,4,2,1810,4400,1700,110,47.6132,-122.292
405000,3,1.75,2470,9620,1570,900,47.3996,-122.32
518000,4,2.75,2520,14021,2520,0,47.7344,-121.957
265000,2,1,1600,7936,1600,0,47.7411,-122.322
180000,3,1,1280,4875,1280,0,47.3686,-122.081
285000,3,2.5,1590,9736,1590,0,47.33,-122.278
433000,3,2.75,2000,7200,1000,1000,47.4531,-122.352
399000,3,1.75,1780,11440,1350,430,47.474,-122.139
565000,3,2.5,1700,7210,1700,0,47.6688,-122.161
406500,3,1.5,1970,10080,1970,0,47.4703,-122.276
420000,4,1.75,1940,11500,1090,850,47.5774,-122.147
965000,4,3.5,3290,5559,2290,1000,47.6788,-122.346
1.375E+06,4,3.5,3500,9523,2460,1040,47.6848,-122.208
353950,5,2.25,3260,7969,3260,0,47.314,-122.344
847700,5,3.25,4230,10260,3860,370,47.5503,-122.081
185000,5,1,1590,6700,1090,500,47.5075,-122.35
269000,2,1.5,1010,6000,1010,0,47.498,-122.222
422800,3,1.75,1820,8400,1340,480,47.734,-122.17
379950,2,1,870,7500,870,0,47.5465,-122.384
525000,3,2,1620,7800,1200,420,47.7288,-122.171
810000,4,3.5,3980,209523,3980,0,47.5574,-121.89
209950,4,1,1630,8400,1630,0,47.3052,-122.362
439950,3,2,1230,1613,1010,220,47.6661,-122.37
554820,4,2,3510,12905,2210,1300,47.4466,-122.36
359000,4,2.5,2160,4500,2160,0,47.4819,-122.182
242500,3,1,1020,5870,1020,0,47.741,-122.314
330000,3,1.75,1590,9417,1590,0,47.7617,-122.36
740000,3,2.25,3440,44374,2190,1250,47.547,-122.111
630000,5,1,3020,4800,3020,0,47.6025,-122.313
750000,3,1.75,2280,7800,1360,920,47.6985,-122.387
695000,4,2.5,2790,6540,2790,0,47.6087,-122.016
109000,2,0.5,580,6900,580,0,47.5135,-122.262
389000,3,1.5,2030,10075,1080,950,47.4713,-122.197
447000,2,1,850,2700,850,0,47.6684,-122.316
1.2E+06,3,2,2480,13310,2480,0,47.6759,-122.114
315000,3,1.75,1010,12000,1010,0,47.77,-122.207
640000,3,2.5,2420,8244,2420,0,47.5595,-122.019
570000,3,2.25,2180,9246,2180,0,47.6215,-122.031
495000,3,2.75,1830,208216,1830,0,47.4377,-122.464
449500,5,2.75,2040,7488,1200,840,47.7289,-122.172
1.0845E+06,4,2.75,2640,5000,1840,800,47.6619,-122.275
294950,2,1,1060,7868,1060,0,47.7414,-122.295
170500,3,1,1640,13939,1040,600,47.3947,-122.313
312000,4,1,1190,7620,1190,0,47.5281,-122.348
350000,3,2.5,2180,15484,2180,0,47.2688,-122.309
690000,4,2.5,2120,8448,2120,0,47.5654,-122.01
375000,4,2.5,2210,9427,2210,0,47.4323,-122.327
575000,4,2.5,2510,47044,2510,0,47.7699,-122.085
646000,4,2.25,2500,8500,1600,900,47.5615,-122.131
239950,3,2.5,1560,4800,1560,0,47.2653,-122.285
400000,5,2.5,2510,7525,1710,800,47.5422,-122.359
455000,4,1.75,3060,94089,3060,0,47.744,-122.087
240000,3,2,1310,8069,1310,0,47.3694,-122.083
3.4E+06,4,4,4260,11765,3280,980,47.638,-122.288
695000,3,2,2500,4080,1680,820,47.6813,-122.346
304950,2,1,670,6720,670,0,47.5151,-122.372
650000,3,1.75,1840,2310,1140,700,47.6462,-122.351
402500,3,1.75,1480,2211,1480,0,47.6966,-122.35
482000,3,2.5,2420,7307,2420,0,47.5361,-121.871
655000,3,2,1820,4480,1120,700,47.6717,-122.295
577000,5,2.75,1940,5000,1940,0,47.6704,-122.362
350000,3,2.5,1630,5996,1630,0,47.4738,-122.19
415000,4,2.25,2520,8000,1680,840,47.3202,-122.383
396400,4,2.5,2120,215186,2120,0,47.701,-121.857
654300,3,2.5,2490,8582,2490,0,47.625,-122.042
774950,4,2.5,3410,179419,3410,0,47.3602,-121.986
855000,4,2,2380,10800,2380,0,47.5682,-122.275
1.145E+06,3,2.5,2490,4000,1670,820,47.6403,-122.35
330000,2,2.5,1240,1546,1240,0,47.5634,-122.298
290000,4,2.25,1900,10950,1400,500,47.3582,-122.284
519500,3,3,2390,19454,2390,0,47.4545,-122.336
450000,3,1.75,1810,12600,1400,410,47.7143,-122.233
3.12E+06,3,3.5,4490,56609,4490,0,47.6997,-122.24
265000,3,1,1620,9450,1620,0,47.5136,-122.313
359000,4,2.5,2640,7883,2640,0,47.3124,-122.188
2E+06,4,3.75,2870,4500,2510,360,47.6291,-122.363
1.05E+06,4,2.5,3250,48037,2030,1220,47.6326,-122.07
402500,2,1,800,2280,800,0,47.6588,-122.362
450000,3,1.75,1360,5445,1360,0,47.6071,-122.123
262500,5,2.25,1950,8086,1130,820,47.3179,-122.331
285000,4,2.25,1970,7200,1970,0,47.3132,-122.182
290000,3,2.5,2020,4861,2020,0,47.4659,-122.144
752500,2,2.5,2280,6230,2280,0,47.7065,-122.013
820000,4,2.75,3540,13515,3540,0,47.5945,-121.982
292000,3,2.5,1560,2740,1560,0,47.4909,-122.154
213000,2,1,750,6089,750,0,47.475,-122.199
400000,4,3,2240,7035,2240,0,47.5124,-122.374
202000,1,0.75,590,5650,590,0,47.5181,-122.267
484000,1,0,690,23244,690,0,47.6429,-121.955
617450,3,2,1580,14398,1080,500,47.6328,-122.174
250000,3,1,1040,8000,1040,0,47.4711,-122.35
405000,5,1.75,1880,10000,960,920,47.7182,-122.201
325000,2,1,1070,8750,1070,0,47.4734,-122.198
301350,3,3,1860,7440,1040,820,47.5035,-122.255
425000,2,1.75,1550,7800,1050,500,47.5436,-122.39
460000,3,1,1860,6360,1470,390,47.5327,-122.392
938000,3,2.5,3090,10940,3090,0,47.5492,-122.119
348000,3,1.75,1720,8867,1320,400,47.44,-122.136
435000,2,1,1260,4080,1260,0,47.687,-122.32
227950,3,1.5,1120,11430,1120,0,47.4105,-122.194
425000,2,1,1250,5880,900,350,47.6908,-122.391
550000,3,2,1810,4064,1810,0,47.6859,-122.339
347500,3,2.5,1890,7053,1890,0,47.3967,-122.183
397000,4,1.75,2020,6000,1620,400,47.577,-122.302
410000,4,1.75,1790,11875,1490,300,47.522,-122.047
780000,3,3.5,3190,6776,3190,0,47.6348,-122.064
1.35E+06,4,3.25,3030,5164,2700,330,47.6394,-122.299
476000,3,2.25,1630,3070,1630,0,47.6785,-122.03
390000,3,1.75,1180,16552,1180,0,47.7426,-122.116
226500,3,2,1560,7000,1560,0,47.3355,-122.284
495000,3,2,1340,2550,1340,0,47.6793,-122.38
1.5E+06,5,3.25,2590,11500,2590,0,47.545,-122.229
385000,3,1,1020,5950,880,140,47.5436,-122.357
535950,3,2.5,2370,5344,2370,0,47.54,-121.863
910000,4,2.5,3170,32430,3170,0,47.6903,-122.056
465000,2,1,1120,4000,1120,0,47.6567,-122.327
495000,3,1.75,1440,11787,1440,0,47.6276,-122.033
250000,4,2,2170,5404,1470,700,47.3046,-122.22
1.225E+06,4,2.25,3490,6906,2280,1210,47.6424,-122.407
400000,4,2.25,1970,8941,1970,0,47.7223,-122.172
715000,4,2.5,2780,13521,2780,0,47.6374,-122.042
342000,3,2,2250,7757,2250,0,47.2684,-122.308
420000,4,1.75,1340,8400,1340,0,47.5382,-122.173
148226,3,1,1400,7360,1400,0,47.3123,-122.186
313000,3,1,1510,10369,1010,500,47.4808,-122.099
150000,3,1,1320,8220,1320,0,47.3697,-122.309
150000,2,1,820,10270,820,0,47.5119,-122.329
230000,2,1,1080,9435,1080,0,47.459,-122.181
389100,2,1,840,5400,840,0,47.5489,-122.271
645000,4,2.25,2070,8720,1360,710,47.6678,-122.182
310000,3,1,1520,6500,990,530,47.4164,-122.332
351358,2,1.75,1210,1189,1210,0,47.5526,-121.998
1.7E+06,5,2.75,3810,9360,3810,0,47.6039,-122.194
1.565E+06,4,3.5,5370,323215,5370,0,47.6003,-122.076
850000,3,2,1540,3600,1540,0,47.6343,-122.283
470000,4,2.5,2310,14023,2310,0,47.7351,-121.964
770000,3,2.25,1870,1900,1870,0,47.6537,-122.34
366000,3,1.75,1840,11440,1340,500,47.474,-122.14
545000,3,2.5,2060,7184,2060,0,47.567,-122.012
205000,3,1,1010,8800,1010,0,47.2761,-122.208
405000,2,1,1020,8155,1020,0,47.7257,-122.361
467000,4,2.5,2220,7210,1270,950,47.7428,-122.183
392500,2,1,1050,4125,1050,0,47.5736,-122.307
901000,4,2.75,3030,18400,2360,670,47.7019,-122.243
500000,3,1.75,1800,7199,1300,500,47.7264,-122.307
384950,3,2.5,1860,3690,1860,0,47.776,-122.239
1.7E+06,4,3.5,4070,336283,4070,0,47.478,-122.038
245000,2,1,860,6120,860,0,47.7503,-122.328
1.165E+06,4,2.25,3080,10487,3080,0,47.5344,-122.224
184500,3,1.5,1280,3640,1280,0,47.334,-122.214
269000,2,2,1540,5000,1540,0,47.319,-122.394
570000,3,2.5,1530,3296,1530,0,47.6181,-122.138
850000,4,1.75,2350,11914,2350,0,47.5392,-122.228
209000,3,1,920,5200,920,0,47.3647,-122.082
327000,4,1.75,1840,5100,1840,0,47.5209,-122.205
369500,3,1.5,1650,9957,1100,550,47.7303,-122.298
440000,3,1.75,1760,8025,1230,530,47.7287,-122.192
947500,4,2.25,3290,12329,3290,0,47.5639,-122.216
510000,2,1,1270,4500,1270,0,47.6059,-122.295
385000,3,2,1600,10318,930,670,47.7466,-122.347
370000,5,3,2670,9920,1400,1270,47.3211,-122.277
660000,4,1.5,1960,4500,1960,0,47.6797,-122.359
729000,3,4.25,3300,308080,2520,780,47.3979,-122.416
440000,3,1.75,2000,11880,2000,0,47.5882,-122.052
445000,4,2.5,2360,81892,2360,0,47.369,-122.156
460000,2,1,1430,12092,1430,0,47.7023,-122.276
516000,3,3,2330,7304,1300,1030,47.5982,-122.172
343888,4,2.5,2060,5607,2060,0,47.4365,-122.144
500000,4,1.75,2240,9886,2240,0,47.6294,-122.116
465000,5,1.75,2330,6450,1330,1000,47.4959,-122.367
302000,5,2.25,2180,7813,2180,0,47.3651,-122.051
195000,2,1,1280,7861,1280,0,47.3007,-122.228
640000,3,2.5,2140,8925,2140,0,47.6314,-122.027
502000,6,2.5,2890,8122,1630,1260,47.5886,-122.113
360000,3,2.5,1480,3851,1480,0,47.7732,-122.163
290500,4,2.5,1680,3000,1680,0,47.494,-122.279
248000,4,3,2163,5883,2163,0,47.2734,-122.251
433000,4,2.5,2280,7568,2280,0,47.5115,-122.194
480000,2,1,820,4200,820,0,47.6249,-122.298
410000,3,1,1330,5000,1120,210,47.7211,-122.308
309950,4,2.75,2310,5000,2310,0,47.3614,-122.035
253000,3,2,1290,7372,1290,0,47.3658,-122.085
280000,3,1.75,1630,11800,1630,0,47.4863,-121.73
440000,3,1,1410,8925,1410,0,47.6782,-122.162
333000,5,1.75,1240,8936,1240,0,47.5738,-122.136
759950,3,2.5,3100,23790,3100,0,47.5882,-122.011
345000,3,2.25,2020,9000,2020,0,47.4487,-121.775
350000,4,2.5,2500,5831,2500,0,47.3454,-122.039
198000,2,1,790,14200,790,0,47.459,-122.285
730000,3,1.75,2040,11294,1340,700,47.5923,-122.197
266200,3,1.5,1430,9600,1430,0,47.4737,-122.15
1.06E+06,4,2.5,2250,10160,2250,0,47.5645,-122.219
95000,2,1,1070,20450,1070,0,47.4338,-122.183
430000,3,1.75,1300,12731,1300,0,47.6236,-122.04
650000,4,2.25,2560,9731,2560,0,47.7261,-122.246
379900,3,2.5,2190,5071,2190,0,47.3506,-122.04
325000,2,1.5,940,1222,860,80,47.7178,-122.318
455000,4,2.25,1740,8449,1170,570,47.6079,-122.123
392000,4,3.75,2220,3797,1330,890,47.5574,-122.315
373000,3,1.75,1310,7811,1310,0,47.7319,-122.167
951250,5,3,2710,8227,1910,800,47.6505,-122.39
502000,3,2,1300,14350,1300,0,47.5736,-122.152
362500,3,2,1940,40588,1940,0,47.4252,-122.159
525000,2,1,1080,3500,1080,0,47.6667,-122.356
580000,4,2.5,2110,11680,1420,690,47.6964,-122.118
278000,3,2.25,1590,9425,1170,420,47.4291,-122.16
422500,2,1,910,4800,910,0,47.5536,-122.377
783200,4,2,1590,5400,990,600,47.637,-122.367
715000,4,2.5,3290,6628,3290,0,47.5994,-121.975
472217,3,2.5,2010,2212,1390,620,47.5523,-121.998
244615,3,2.5,2060,4030,2060,0,47.3909,-122.238
385000,3,1.75,1560,14288,780,780,47.7183,-122.306
549995,3,1,1120,6600,1120,0,47.6712,-122.267
959900,4,3.75,3550,15151,3550,0,47.5888,-121.971
510000,6,4.5,3300,7200,3300,0,47.6798,-122.104
367000,3,1.75,2000,12669,1200,800,47.3579,-122.446
375000,5,3,2680,8410,1810,870,47.4401,-122.126
500000,2,2.25,1290,1334,1290,0,47.6719,-122.382
489000,2,2.25,1290,1334,1290,0,47.6719,-122.382
340000,3,2,1150,700,800,350,47.5552,-122.381
562000,3,1.75,1880,5978,940,940,47.5793,-122.294
489950,3,2.5,2400,7478,2400,0,47.7362,-121.974
652000,3,2.25,1920,9600,1560,360,47.6341,-122.103
472000,4,3.25,4350,7090,2870,1480,47.3747,-122.156
333000,4,2.5,1910,9244,1910,0,47.4918,-122.141
560000,3,1.5,2000,7350,2000,0,47.7061,-122.368
799000,4,3.5,3290,20107,2220,1070,47.355,-122.319
860000,5,2.25,3480,9200,3480,0,47.5585,-122.153
449500,4,2.5,2410,55931,2410,0,47.3109,-122.097
692500,4,3,2820,11500,2820,0,47.5826,-122.028
925000,4,1.75,2710,11400,1430,1280,47.561,-122.153
267500,3,2.25,2080,2856,1550,530,47.4198,-122.158
396800,4,2.5,2200,6018,2200,0,47.7338,-121.966
220000,4,1.5,1180,8058,1180,0,47.2966,-122.19
892500,3,1.75,2120,56192,1720,400,47.7665,-122.372
455500,3,2,1460,10311,1460,0,47.6771,-122.156
743000,3,1.75,2110,11250,2110,0,47.5402,-122.216
338000,4,1.5,1790,17925,1790,0,47.7501,-122.302
332000,3,1.75,1340,13115,1340,0,47.5021,-121.77
563225,3,1,2460,4000,1370,1090,47.6268,-122.297
1.15E+06,4,3.5,3760,20609,3760,0,47.7255,-122.059
645000,2,1,1240,5000,1000,240,47.6634,-122.351
739000,3,2.5,2750,16000,2560,190,47.693,-122.187
435000,3,2.5,2530,13446,2530,0,47.7345,-121.961
995000,3,2.25,3200,3800,2650,550,47.638,-122.317
520000,4,2.75,2020,7357,1350,670,47.7145,-122.225
400000,4,2.5,3030,180263,2030,1000,47.2953,-122.097
440000,3,1.75,2350,7641,1510,840,47.7307,-122.219
440000,3,1.5,1690,6010,1230,460,47.6955,-122.291
738000,3,1,1280,3900,1280,0,47.6545,-122.336
250000,3,1.5,1170,9848,1170,0,47.7612,-122.234
338150,4,2.25,2700,8580,2700,0,47.2087,-122.009
425000,3,2.25,1800,7371,1280,520,47.7584,-122.145
883000,4,2.5,3670,54450,3670,0,47.6211,-122.016
510000,3,2,2350,266151,2350,0,47.6609,-121.892
950000,4,1.75,3100,21303,3100,0,47.5847,-122.081
435000,3,1,1120,9656,1120,0,47.567,-122.139
415000,5,1.5,1900,10226,1130,770,47.7226,-122.227
439000,2,2.5,1350,944,870,480,47.5591,-122.385
295832,5,1,1410,6400,960,450,47.4207,-122.334
285000,3,1.75,1560,9514,1560,0,47.4088,-122.21
350000,3,1.5,1090,5003,1090,0,47.703,-122.321
489000,2,2.75,1465,972,1050,415,47.621,-122.298
304500,3,2.25,1790,6930,1390,400,47.3536,-122.317
288000,3,1.5,1300,7313,1300,0,47.4568,-122.21
417000,3,1.75,1920,9512,1440,480,47.7606,-122.167
615000,3,3,1420,991,1040,380,47.6408,-122.327
730000,5,3.5,3760,4857,2820,940,47.7398,-122.167
178500,2,1,930,3447,930,0,47.3822,-122.318
300000,4,2,1580,9600,1050,530,47.4091,-122.313
415000,4,2.5,2170,8518,1350,820,47.5073,-122.234
452500,3,1.75,2040,15695,2040,0,47.4155,-122.339
1.01E+06,4,2.75,3430,15877,3430,0,47.5364,-121.856
653000,4,2.5,2160,7000,2160,0,47.5659,-122.013
715000,4,2.25,2060,5649,1360,700,47.6496,-122.407
541000,3,1.75,1410,4080,1410,0,47.6695,-122.32
245000,4,1.5,1850,7547,1850,0,47.3714,-122.309
547000,2,1,1370,10038,1370,0,47.719,-122.339
750000,5,2.75,3330,12408,1740,1590,47.6318,-122.058
575000,5,2.5,1970,12375,1570,400,47.7412,-122.354
216000,3,1.75,1310,8670,1310,0,47.3156,-122.186
443000,3,1.75,1640,4579,1640,0,47.7061,-122.352
257700,4,2.25,1600,6202,1600,0,47.3784,-122.046
278000,3,1,1230,9440,1230,0,47.4657,-121.747
300000,3,2.5,2240,3691,2240,0,47.3364,-122.169
269100,3,2.5,2190,7904,2190,0,47.2617,-122.21
402500,3,1,990,10752,990,0,47.7648,-122.35
306888,2,1.5,1010,7719,1010,0,47.5128,-122.189
795000,4,2.5,2920,14210,2920,0,47.6196,-122.15
525000,4,2.5,2310,5573,2310,0,47.5197,-122.2
1.05E+06,3,2.5,3470,12076,2560,910,47.5319,-122.238
452000,2,1,1220,6000,880,340,47.5647,-122.27
350000,3,2.25,1550,5401,1550,0,47.737,-121.967
410000,4,2.5,2070,6180,2070,0,47.4915,-122.183
595000,3,1.75,2060,3600,1180,880,47.6389,-122.371
499000,3,2.5,1690,4851,1690,0,47.6795,-122.034
340000,4,2.5,2550,7555,2550,0,47.2614,-122.29
1.065E+06,5,3.25,3370,7947,3370,0,47.6906,-122.202
460000,4,3,2230,52983,2230,0,47.3577,-122.195
345000,4,2.5,2382,5899,2382,0,47.2793,-122.295
280500,3,2.25,1620,7566,1620,0,47.3566,-122.039
704000,3,1,1140,6120,1140,0,47.6822,-122.309
545000,3,2.5,2140,40173,2140,0,47.4786,-122.066
335000,3,1.5,1900,7584,1900,0,47.5091,-122.19
1.325E+06,4,3,3370,7920,1860,1510,47.6773,-122.403
420000,3,2.75,2300,8000,1430,870,47.3293,-122.306
705000,4,2,2040,5050,1160,880,47.6885,-122.324
274900,4,1.75,1840,10528,1210,630,47.2987,-122.385
499950,4,2.5,2860,3345,2190,670,47.7735,-122.158
415250,3,1.5,1400,7550,1400,0,47.7566,-122.337
222000,3,1,990,7520,990,0,47.285,-122.207
375000,3,2,3120,42247,2150,970,47.3925,-122.137
300000,3,2.5,1640,5707,1640,0,47.4016,-122.209
456700,3,1.75,2820,8879,1540,1280,47.5094,-122.376
925500,3,2.75,1970,5200,1970,0,47.5374,-122.388
375000,5,2.5,2840,15598,1470,1370,47.4693,-122.117
420000,3,2.5,2370,15375,2370,0,47.3803,-122.147
575000,3,2.5,2610,7301,2610,0,47.7614,-122.139
335000,3,2,1340,1951,670,670,47.5763,-122.309
428000,4,2,1300,7200,1300,0,47.6169,-122.294
655000,4,2.5,3340,34238,2060,1280,47.7654,-122.076
738000,3,3,2630,4896,2630,0,47.6932,-122.133
415000,5,1.75,1960,3748,980,980,47.7027,-122.349
392000,3,1,1090,6125,790,300,47.5343,-122.37
555000,2,1,1550,4600,1050,500,47.686,-122.384
260000,3,2.5,1770,2677,1770,0,47.4339,-122.194
392500,3,1,1390,10500,1390,0,47.567,-121.893
912000,3,2.5,2979,17313,2979,0,47.5503,-122.118
135000,2,1,830,7609,830,0,47.5057,-122.348
500000,3,2.75,1560,77536,1400,160,47.7695,-122.126
238000,3,1.5,1360,7488,1050,310,47.3314,-122.275
251000,4,2,1650,5974,860,790,47.5008,-122.257
406500,2,1.75,1510,5319,1510,0,47.6647,-122.13
433495,4,2.25,3010,10925,3010,0,47.3326,-122.201
265000,3,2.25,1510,6071,1150,360,47.3619,-122.077
360000,3,1.75,1950,7260,1520,430,47.7187,-122.33
425000,4,1,1800,12485,950,850,47.5729,-122.147
450000,2,2.75,2810,11205,1510,1300,47.4869,-122.243
449900,3,1.75,1760,8266,1760,0,47.7708,-122.339
345000,4,2.5,2040,5875,2040,0,47.5051,-122.17
612500,4,2,1690,35346,1690,0,47.6149,-122.124
317000,3,1.75,1530,7650,1530,0,47.4435,-122.128
585000,3,1.5,1810,3880,1310,500,47.6835,-122.392
455000,3,1.75,1180,14292,1180,0,47.4818,-121.733
1.035E+06,4,4,4090,51908,4090,0,47.7226,-122.039
497000,4,2.25,2250,3463,2250,0,47.6324,-122.106
226750,3,1.75,1070,6315,1070,0,47.2803,-122.356
385000,4,2,1820,7102,1220,600,47.7447,-122.324
205000,3,0.75,1080,5025,1080,0,47.4936,-122.335
745000,4,2.5,2760,13093,2760,0,47.5845,-122.06
371000,4,2.5,2550,4770,2550,0,47.3526,-122
545000,4,2.5,2080,8504,2080,0,47.5703,-121.998
443000,3,1,1280,5460,1280,0,47.7321,-122.334
287000,2,1,950,6350,950,0,47.528,-122.352
194000,3,1,1050,7577,1050,0,47.2891,-122.357
265000,3,1,1800,7650,1800,0,47.4922,-122.178
1.135E+06,4,2.75,3840,10004,2110,1730,47.5606,-122.225
699950,4,3.25,3674,12793,3674,0,47.4357,-122.343
433000,4,1,1710,7000,1710,0,47.7037,-122.293
200000,2,1.75,910,2693,910,0,47.3493,-122.025
289571,3,1.5,1340,25160,1340,0,47.475,-122.111
440000,4,2.75,2340,11034,1720,620,47.7686,-122.278
400000,3,1.5,1510,8360,1120,390,47.6119,-122.133
589000,4,2.5,2630,15000,2630,0,47.5262,-122.028
850000,5,2.25,3100,97661,3100,0,47.6624,-122.062
520000,3,1,940,3000,940,0,47.6033,-122.3
555000,2,2.25,1370,1248,1200,170,47.6399,-122.32
470000,3,2.5,2480,5082,2480,0,47.5297,-121.846
207000,2,1.5,1068,1158,1068,0,47.753,-122.244
379750,4,2.75,2390,9650,1620,770,47.3438,-122.322
709000,4,1.75,2170,4600,1270,900,47.6894,-122.384
240000,3,2.5,1520,9864,1160,360,47.3186,-122.171
445500,4,1.5,2210,10497,1650,560,47.4321,-122.347
1.308E+06,5,2.5,3200,7863,1600,1600,47.6398,-122.39
210000,3,1.5,1160,10125,1160,0,47.4919,-122.151
603000,4,2.5,2670,5895,2670,0,47.6066,-122.016
720000,3,2.5,2520,10012,2520,0,47.6295,-122.051
92000,2,1,760,5500,760,0,47.5045,-122.329
600000,3,1.75,1310,5000,1310,0,47.6722,-122.379
725000,4,2.5,2750,13950,1380,1370,47.4938,-122.364
409950,5,2.25,1790,10300,1270,520,47.7718,-122.292
515000,3,2.5,1790,7167,1790,0,47.6176,-122.045
495000,4,2.5,2400,11640,1800,600,47.4485,-122.139
998000,4,2.25,2420,10200,2420,0,47.5336,-122.225
630000,3,1.75,1710,8767,1710,0,47.6945,-122.188
410000,3,1.75,2000,7480,1320,680,47.7734,-122.359
602000,3,2.25,1580,11580,1580,0,47.5503,-122.155
750000,4,2.75,2310,10232,1310,1000,47.5515,-122.153
711600,4,3,3580,9316,2370,1210,47.595,-122.133
1.05E+06,4,4,4320,8709,3190,1130,47.5369,-122.07
700500,3,2.5,2560,35265,2560,0,47.7354,-122.095
710000,4,2.5,3220,18618,3220,0,47.5326,-122.181
250000,3,2,1660,13085,1010,650,47.3298,-122.277
350000,4,1.75,2420,8400,1620,800,47.5017,-122.165
475000,7,3.5,2870,29699,1520,1350,47.7153,-122.327
200000,2,1,830,7200,830,0,47.5604,-122.275
450000,4,2.25,1710,7000,1040,670,47.719,-122.217
316000,5,2.5,2600,4641,2600,0,47.4325,-122.146
310000,1,1,670,4920,670,0,47.5342,-122.373
392000,3,1.5,1500,11975,1500,0,47.4658,-121.758
521000,3,3.25,1460,1254,1460,0,47.6535,-122.353
495000,2,2,1540,7110,960,580,47.6932,-122.395
209000,3,1.75,1250,8084,1250,0,47.3364,-122.276
809950,4,2,2230,9900,2230,0,47.5979,-122.173
400000,2,1.75,1800,224769,1420,380,47.4327,-122.06
415000,4,2.5,2400,7292,1530,870,47.7749,-122.339
411000,4,2,2370,76665,2370,0,47.2831,-122.279
825000,2,2,1830,3600,1230,600,47.6359,-122.351
436000,3,2.25,1480,1384,1480,0,47.691,-122.342
460000,4,2.5,2620,8331,2620,0,47.4357,-122.159
281000,3,1,1300,5782,1300,0,47.524,-121.821
976000,4,1.5,3120,7680,1660,1460,47.646,-122.39
485000,4,2.5,2400,10364,2400,0,47.4832,-121.799
429000,3,2.5,1430,9240,1430,0,47.6258,-122.058
729000,3,2.5,2480,7428,2480,0,47.5489,-122.185
625000,3,2.5,2280,4757,2280,0,47.5901,-122.018
218500,3,1.75,1390,9328,1390,0,47.2766,-122.146
175000,3,1,1030,8395,1030,0,47.3322,-122.337
442500,3,1,1120,8200,1120,0,47.7254,-122.29
480000,3,2,1300,3000,1300,0,47.6728,-122.325
715500,3,2.25,2410,9668,1540,870,47.6996,-122.391
432500,3,1.75,1470,7350,1470,0,47.6687,-122.154
875000,5,4.25,4720,18741,3210,1510,47.6347,-122.013
605000,5,2.75,2910,13332,2910,0,47.4977,-122.359
1.688E+06,4,4,5000,12941,5000,0,47.55,-122.103
318000,3,2.25,1690,12662,1090,600,47.4972,-122.264
311300,2,1,1000,7228,1000,0,47.7294,-122.352
325000,5,2.75,2400,7904,1450,950,47.4683,-122.263
795000,5,3.5,3330,3705,2610,720,47.5567,-122.124
558000,4,2.25,2060,10358,1320,740,47.5478,-122.174
370000,4,2.5,3090,18645,3090,0,47.2902,-122.342
598850,4,2.5,2350,7245,2350,0,47.6318,-122.023
515700,3,2.5,2180,9722,2180,0,47.527,-122.173
458000,3,2.5,1870,5013,1870,0,47.7552,-122.221
583500,3,2.25,3530,13000,3530,0,47.3823,-122.159
653750,4,2.5,2460,4166,2460,0,47.7072,-122.232
299000,3,2.5,1650,4725,1650,0,47.3548,-122.055
532000,5,3,3480,57499,2340,1140,47.4574,-122.024
819000,3,2.75,3176,13391,2726,450,47.3429,-122.33
945000,4,2.25,2420,9000,2000,420,47.4884,-122.363
608700,4,2.5,2260,9696,2260,0,47.643,-122.066
812000,4,2,2380,6122,1310,1070,47.6506,-122.405
464000,5,2.5,3400,8970,1700,1700,47.7358,-122.335
950000,4,2.5,3770,35081,3770,0,47.6908,-122.051
700000,4,2.5,2672,4297,2020,652,47.6955,-122.289
435000,3,1,1180,4219,1060,120,47.6867,-122.378
229500,3,1.5,1810,14400,1810,0,47.2887,-122.269
1.575E+06,3,3,2610,22672,2610,0,47.4414,-122.354
265000,3,2.25,1450,13439,1180,270,47.2811,-122.299
995000,2,2,1600,64468,1600,0,47.7344,-122.143
590000,3,2.5,2650,9380,1680,970,47.7756,-122.273
740000,4,2.75,2490,17833,1490,1000,47.7206,-122.284
360000,2,0.75,850,7710,550,300,47.5588,-122.301
548500,4,2,1820,7200,1300,520,47.5161,-122.388
599000,3,1.75,1960,4788,1090,870,47.6746,-122.312
615000,3,1.75,2350,20820,1800,550,47.6095,-122.059
292000,3,1.75,1320,6600,1320,0,47.4838,-122.33
899000,4,2.5,3720,30649,3720,0,47.6651,-122.056
500000,3,1.5,2210,6500,1030,1180,47.5434,-122.388
580000,3,2.5,1910,11550,1910,0,47.6213,-122.064
580000,4,2.5,2840,6268,2840,0,47.7386,-122.235
594000,3,1,1320,5000,1090,230,47.6674,-122.365
500000,3,2.5,2440,7600,1420,1020,47.6966,-122.127
550000,4,2.5,2420,8056,1680,740,47.5748,-122.013
275000,3,1.75,1180,6260,1180,0,47.3531,-122.048
390000,3,2.25,1820,7420,1820,0,47.4368,-122.162
1.25E+06,3,3,3760,8500,3060,700,47.5815,-122.398
250000,3,2.25,1560,15340,1560,0,47.4989,-122.322
405000,2,2.5,1790,5400,1790,0,47.6606,-122.128
213950,3,1,1430,7000,1430,0,47.3018,-122.369
232000,3,1.5,1390,11340,1390,0,47.3984,-122.186
207000,3,1,990,10800,990,0,47.293,-122.215
310000,3,1.75,1880,30346,1880,0,47.3515,-122.291
540000,3,2.5,2520,5000,2520,0,47.5664,-122.359
750000,4,1.5,2060,4000,1580,480,47.6857,-122.353
392500,4,2.5,2150,7303,2150,0,47.5109,-122.183
305000,5,2.5,2500,12220,1690,810,47.3335,-122.325
735000,3,2.5,2390,9157,2390,0,47.6617,-122.15
575000,4,2.5,2400,6137,2400,0,47.6187,-122.04
175000,2,1,660,5000,660,0,47.5664,-122.364
291000,4,2.5,1580,6633,1580,0,47.3768,-122.118
791500,4,2.5,3250,8970,3250,0,47.5862,-122.037
475000,3,2,1880,9659,1180,700,47.7497,-122.284
238950,2,1,1190,11400,1190,0,47.5012,-122.265
470000,3,3.5,1280,1257,1040,240,47.6721,-122.374
420000,4,1.75,2380,15324,1610,770,47.6262,-122.049
440000,3,2.5,2040,7605,2040,0,47.4876,-121.779
656000,4,1.75,1440,4300,1290,150,47.6846,-122.372
559950,3,2.5,2120,4310,2120,0,47.687,-122.037
600000,2,2,990,5416,990,0,47.604,-122.311
255000,3,1,1710,12000,1710,0,47.2616,-122.281
210750,4,1.5,1840,7076,1840,0,47.5185,-122.345
485000,4,1,1150,2560,1150,0,47.6368,-122.355
390000,3,2.5,2250,8076,2250,0,47.3667,-122.041
405000,3,2.5,2460,12600,1810,650,47.473,-122.118
462500,4,1,1540,4500,1540,0,47.587,-122.384
435000,4,2.25,2210,14073,1630,580,47.4774,-122.142
440000,3,2.5,1440,5434,1440,0,47.6818,-122.034
299950,3,1.75,1790,7650,1790,0,47.3213,-122.385
440000,2,1.5,1120,1024,1120,0,47.6175,-122.298
312620,3,2.5,1260,11877,1260,0,47.4442,-121.762
372500,3,1.5,1180,12324,800,380,47.6337,-122.032
297262,3,2.5,1730,8076,1730,0,47.2619,-122.308
735000,4,3,2250,7245,1250,1000,47.6045,-122.169
430000,3,1.5,1550,5034,1550,0,47.7072,-122.36
241000,2,1.75,1070,9750,1070,0,47.7131,-121.319
201000,3,1,1460,9750,1460,0,47.3242,-122.144
570000,2,1,1060,4000,1060,0,47.6731,-122.315
538000,4,1.75,1840,9600,1220,620,47.6579,-122.125
729000,3,2.5,2440,4244,2440,0,47.7057,-122.112
331500,4,1.75,1700,14756,850,850,47.5762,-122.143
110700,2,1,680,8064,680,0,47.469,-122.298
245000,3,2,1700,8448,1700,0,47.2077,-122.011
427000,3,1.75,2000,7111,1360,640,47.7676,-122.373
650500,4,1.75,2340,5940,1290,1050,47.6789,-122.281
335900,2,1,1120,7440,1120,0,47.7405,-122.323
535000,2,2,1510,5133,1510,0,47.6415,-122.401
360000,5,2,2120,2400,1080,1040,47.5979,-122.297
294900,3,2.25,1500,8100,1210,290,47.4632,-122.19
460000,2,1,1030,5934,1030,0,47.6828,-122.287
1.769E+06,4,3.5,5440,38900,5440,0,47.6605,-122.069
463000,2,1,1150,4400,1150,0,47.6226,-122.292
332000,5,1.5,2420,43560,1500,920,47.208,-121.963
199500,4,2,1750,8116,1750,0,47.5097,-122.181
247000,4,2,1750,8116,1750,0,47.5097,-122.181
442500,4,2.5,2170,14024,2170,0,47.7346,-121.97
600000,3,2,2540,237402,2540,0,47.2688,-122.024
449000,3,2.5,1690,3827,1690,0,47.6768,-122.029
725000,4,1,1600,4500,1600,0,47.6804,-122.316
215000,3,1,1060,7900,1060,0,47.4604,-122.18
582500,2,1.75,1990,6549,1170,820,47.7,-122.296
305000,4,2.25,2210,9371,2210,0,47.3634,-122.279
734000,4,2.75,3090,7650,2340,750,47.3622,-122.157
300000,3,2,1050,10072,1050,0,47.7341,-121.976
525888,5,1.75,2550,71874,1810,740,47.4845,-122.08
711000,4,2.5,2095,4400,1295,800,47.5838,-122.39
360000,3,1.75,1520,12282,1220,300,47.7516,-122.299
357000,5,2.5,2750,12350,2750,0,47.419,-122.206
235000,3,1.75,1200,9266,1200,0,47.314,-122.208
550000,3,1.75,1830,9720,1150,680,47.5511,-122.23
324000,3,1,1160,7202,1160,0,47.7675,-122.334
420000,3,2,1750,9239,1410,340,47.7583,-122.339
450000,4,2.5,2400,7693,2400,0,47.4881,-122.142
825000,5,3.5,4140,6770,3030,1110,47.5381,-122.069
272000,4,2.25,2115,6234,2115,0,47.285,-122.201
481000,3,2,2580,15653,2580,0,47.4561,-122.361
500000,3,1,1220,3400,1060,160,47.6775,-122.363
448000,2,1.5,1630,3780,890,740,47.6711,-122.403
480000,2,2,1350,4220,1350,0,47.718,-122.034
475000,3,2.5,1690,2890,1690,0,47.6802,-122.031
472500,2,2.25,1700,2383,1700,0,47.547,-121.997
291000,4,2.25,1890,7616,1260,630,47.3275,-122.329
294000,2,1,850,5250,850,0,47.731,-122.342
1.01305E+06,4,2.5,2480,12688,1820,660,47.6344,-122.205
442500,3,2.5,1690,3129,1690,0,47.6875,-122.043
170000,2,1,810,8424,810,0,47.3286,-122.346
1.5825E+06,4,2.5,3980,16304,2480,1500,47.639,-122.21
665000,3,2.25,2580,6000,1780,800,47.5778,-122.289
1.61E+06,5,4.5,6085,142725,6085,0,47.6085,-121.952
675000,2,1.75,2140,5000,1000,1140,47.6284,-122.291
279900,2,1.75,1360,10000,1360,0,47.7421,-121.982
875000,4,1.5,1800,3245,1800,0,47.6605,-122.331
571000,3,2.5,1920,3867,1920,0,47.5538,-121.994
320000,3,1,860,5060,860,0,47.7062,-122.341
525000,3,2.5,2340,35021,2340,0,47.3988,-122.028
1.65E+06,8,2.75,4040,20666,2020,2020,47.634,-122.221
137900,3,1.75,1160,5082,580,580,47.503,-122.262
440000,3,2.25,1680,57063,1680,0,47.4669,-121.765
360000,3,1,1280,3870,640,640,47.6163,-122.294
271000,4,1.5,1800,9576,1800,0,47.4664,-121.747
465000,6,3.25,4250,23326,2150,2100,47.34,-122.327
280000,4,2.5,2400,4596,2400,0,47.3358,-122.265
283000,2,1,940,6350,940,0,47.698,-122.357
411500,3,1,1110,7208,1110,0,47.6979,-122.124
282000,3,2.25,2420,7548,1370,1050,47.3112,-122.376
535000,3,2.5,1850,1499,1790,60,47.6475,-122.396
554729,4,2.5,2020,4350,1730,290,47.6503,-122.41
868000,4,2.5,2020,4350,1730,290,47.6503,-122.41
427000,3,2.5,1830,65340,1520,310,47.4553,-121.75
455000,4,1.75,1920,6000,960,960,47.7137,-122.315
595000,2,1.75,1280,8500,1280,0,47.6553,-122.19
400000,4,2.5,3130,5240,3130,0,47.3446,-122.042
770000,4,2.5,3920,12415,3920,0,47.5658,-122.032
742500,4,2.75,3100,3773,2000,1100,47.6158,-122.291
1.25E+06,4,2.5,3220,15600,1680,1540,47.5697,-122.182
375000,3,2,1670,13775,1670,0,47.4873,-121.783
1.5576E+06,4,2.5,2700,17853,2700,0,47.6463,-122.219
545000,4,2,5461,22880,3265,2196,47.3557,-122.29
1.05E+06,4,3.25,4400,16625,4400,0,47.5868,-121.968
1.565E+06,3,1.75,2190,8500,2190,0,47.64,-122.285
178000,4,1.5,1200,11163,1200,0,47.3024,-122.106
262500,3,1.75,1470,10390,1470,0,47.4192,-122.201
730000,3,1.75,1650,5000,1650,0,47.6743,-122.371
395000,5,1.75,1840,10453,1360,480,47.4508,-122.368
355000,3,1,1210,6650,1210,0,47.6214,-122.12
299990,3,2.5,1870,8541,1870,0,47.2925,-122.346
1.125E+06,4,3.25,3890,422096,3150,740,47.4125,-121.982
425000,4,2.25,2660,11200,2660,0,47.4722,-122.131
349000,2,1,1150,7552,1150,0,47.7215,-122.323
554950,4,1.75,1740,4816,870,870,47.5758,-122.382
326000,6,3,2580,8064,1880,700,47.5549,-122.287
580000,4,1.75,1720,6975,1420,300,47.6506,-122.121
699000,3,2.5,2740,18455,1510,1230,47.5585,-122.215
757000,3,2.75,2610,11290,1630,980,47.6632,-122.201
335000,3,1.75,1400,7920,1400,0,47.7312,-122.202
660000,3,2,2570,28500,1970,600,47.7318,-122.138
540000,4,2.75,2830,7334,2830,0,47.4868,-122.141
320000,5,2.25,2630,8625,2630,0,47.3619,-122.287
280000,3,2.5,1580,7918,1580,0,47.4431,-122.19
324000,3,2,1540,10931,1540,0,47.495,-121.776
300000,3,1,2120,7735,1060,1060,47.4869,-122.123
360000,3,1.75,1830,10000,1830,0,47.741,-121.979
600000,3,2.5,2260,10153,2260,0,47.641,-122.068
950000,4,1.75,2500,92347,1500,1000,47.5345,-122.216
599950,3,3.25,1830,1804,1830,0,47.6945,-122.377
190000,4,1,1190,7920,890,300,47.5305,-122.371
350000,4,1.75,2310,9002,1780,530,47.731,-122.166
522000,3,1,1230,4600,1230,0,47.5616,-122.392
850000,3,2.5,2940,10809,2940,0,47.5418,-122.136
308000,3,1,1010,8800,1010,0,47.5483,-122.278
1.02E+06,6,2.25,2550,5000,2550,0,47.6785,-122.396
397500,3,1,1480,5100,1480,0,47.6915,-122.348
186000,3,1.75,1460,7967,1040,420,47.3199,-122.374
436500,5,3,3110,12429,1790,1320,47.7463,-122.213
710000,3,2,2140,4923,1070,1070,47.6902,-122.339
1.3786E+06,5,3.25,3450,6360,1860,1590,47.6133,-122.287
450000,3,2.25,1960,10682,1960,0,47.6319,-122.124
375000,4,2.75,1890,5240,980,910,47.5528,-122.356
315000,2,1,2080,14659,1040,1040,47.4858,-122.231
467500,3,1,1700,4165,1700,0,47.5569,-122.277
330000,3,1,1140,7316,1140,0,47.527,-122.362
665000,3,2.5,3136,54450,3136,0,47.3999,-122.472
760000,4,3.25,2590,3889,2590,0,47.6259,-122.142
469000,3,1.75,1480,800,1000,480,47.5493,-122.387
408000,3,3,1500,1473,1120,380,47.6063,-122.305
851000,3,2.75,2660,10350,1330,1330,47.5868,-122.116
410000,2,2,1350,3926,1350,0,47.7192,-122.024
235000,2,1,860,10500,860,0,47.5662,-121.886
207100,2,1,1000,4500,1000,0,47.4896,-122.204
560000,4,2.5,2480,16360,1510,970,47.7638,-122.265
903000,3,2.75,3860,12786,3860,0,47.549,-122.141
998500,3,1.75,2140,4800,1690,450,47.6311,-122.312
268500,4,1.75,1820,13600,1120,700,47.3743,-122.295
494950,2,1.75,2220,33000,2220,0,47.7403,-122.129
1.13E+06,4,2.5,2660,11200,2660,0,47.5894,-122.197
250000,3,2,1470,12096,1470,0,47.3734,-122.193
449000,4,1.75,2350,54450,1250,1100,47.4816,-122.005
1.225E+06,3,2.25,2980,7700,2530,450,47.6336,-122.29
325000,4,2,1870,7700,1870,0,47.4619,-122.196
506000,5,3,2430,8000,1370,1060,47.603,-122.12
751000,4,2.5,2790,6538,2790,0,47.5349,-122.066
280000,3,2.5,1370,22326,1370,0,47.4469,-121.775
1.12E+06,4,2.25,4470,60373,4470,0,47.7289,-122.127
580000,3,1.75,2040,81021,2040,0,47.6536,-122.045
665000,4,2.25,2340,5300,1700,640,47.6202,-122.112
450000,4,2.5,2520,8515,2520,0,47.7233,-121.959
389900,4,1,1710,117176,1710,0,47.4497,-122.212
427000,3,1,1200,5252,1200,0,47.6075,-122.134
265000,3,1.75,1330,12618,1330,0,47.4403,-122.271
398000,3,1.5,1310,2996,1310,0,47.5879,-122.299
354000,6,3.5,3020,4500,3020,0,47.498,-122.225
339950,4,2.5,2260,6086,2260,0,47.3642,-122.174
399000,2,1,790,4000,790,0,47.6844,-122.289
325000,2,2,970,5000,970,0,47.7223,-122.16
998800,3,2,2250,8000,2250,0,47.7077,-122.378
350000,4,2.5,1530,2248,1530,0,47.5766,-122.309
1E+06,4,1.75,1780,11436,1780,0,47.6273,-122.194
561000,3,2.5,2120,5277,2120,0,47.6811,-122.034
245000,2,1,1500,6685,1190,310,47.7186,-122.354
570000,2,1,1500,6685,1190,310,47.7186,-122.354
845000,4,3,2390,4000,1460,930,47.6857,-122.331
314500,4,2.5,2390,9600,2390,0,47.3289,-122.001
650000,3,1.75,2920,9370,1620,1300,47.5491,-122.151
298000,2,1,850,5000,850,0,47.4874,-122.207
500000,2,1,930,3200,930,0,47.609,-122.314
870000,4,2.5,3340,12248,2470,870,47.5858,-122.379
299000,2,1,710,6732,710,0,47.5151,-122.372
527000,3,2.25,2240,6450,1440,800,47.7034,-122.315
420000,3,1,1060,7638,1060,0,47.5941,-122.142
290000,3,2.5,2360,8764,2360,0,47.2114,-122.009
1.662E+06,4,2.75,3520,19200,1950,1570,47.525,-122.393
499990,3,1.75,1730,9334,1220,510,47.6478,-122.113
315000,3,1.75,1170,4000,720,450,47.5306,-122.354
425000,4,2.25,3680,26266,3680,0,47.3219,-122.085
630000,3,2.5,2900,46609,2900,0,47.7731,-122.086
365000,3,1.75,1290,7205,1290,0,47.7329,-122.237
774000,4,2.75,2010,7000,2010,0,47.6607,-122.396
368888,3,1.5,1490,12186,1490,0,47.7739,-122.322
339500,4,2.5,1930,7862,1930,0,47.3644,-122.04
344950,4,1.75,2240,7500,1120,1120,47.7466,-122.34
450000,3,2,2320,17688,2320,0,47.4519,-122.363
814950,4,2.75,2990,6626,2990,0,47.7107,-122.11
299900,4,2.5,2200,5730,2200,0,47.3482,-122.153
315000,3,2,1500,7828,1500,0,47.4484,-122.158
880000,3,1.75,3860,9000,1930,1930,47.7431,-122.29
195000,3,1.5,1430,5200,1030,400,47.3644,-122.094
910000,5,2.75,3750,8279,3750,0,47.6039,-122.06
540000,5,2.5,3100,10189,3100,0,47.738,-121.965
306000,3,2.5,1870,5874,1870,0,47.3992,-122.163
272000,4,2.25,2040,7600,1580,460,47.3169,-122.365
1.295E+06,5,3.5,3700,8504,2750,950,47.669,-122.275
450000,3,1.75,3150,9258,2370,780,47.5571,-122.08
450000,3,2.5,1990,12793,1990,0,47.7347,-122.226
310000,4,1,1740,11075,1740,0,47.7458,-122.334
530000,2,2.25,2080,11285,1180,900,47.3628,-122.147
435000,4,2.5,2060,10125,1560,500,47.764,-122.262
485000,3,2,1590,11222,1590,0,47.7762,-122.367
690000,3,1.5,1760,4000,1760,0,47.6401,-122.32
305000,4,2.5,1620,4000,1620,0,47.3661,-122.02
300000,3,1.75,1210,7000,1210,0,47.4572,-122.169
289950,4,3,2040,5050,1490,550,47.3266,-122.175
575000,3,2.5,2270,9600,2270,0,47.7388,-122.206
1.82E+06,4,4.5,6640,53330,6640,0,47.7283,-122.046
219000,3,1.5,1060,9600,1060,0,47.3229,-122.348
265000,4,3,1940,8170,1940,0,47.7381,-122.302
1.105E+06,5,3.25,3070,5000,2050,1020,47.6742,-122.356
200000,3,1,930,7590,820,110,47.4802,-122.335
545000,4,2.75,2180,8480,1210,970,47.4961,-122.366
378000,3,2.5,2130,8404,2130,0,47.4623,-122.13
388000,2,1.75,800,4800,800,0,47.5559,-122.396
425000,4,2.25,2200,8384,1250,950,47.753,-122.317
536000,2,1.5,1130,746,1030,100,47.6684,-122.363
1.175E+06,3,2.5,1970,23180,1100,870,47.5495,-122.398
629950,3,2.5,1680,1620,1120,560,47.6425,-122.374
465000,4,1.75,1470,5350,980,490,47.7048,-122.315
545000,4,2.25,2390,40510,2390,0,47.7566,-122.113
592000,4,2.5,2300,11165,2300,0,47.5794,-122.118
446000,4,2,2280,43692,1140,1140,47.4067,-122.03
375000,3,2.5,1330,816,1330,0,47.6836,-122.387
632500,5,2.5,2640,7096,2640,0,47.6827,-122.038
459950,4,1.75,2430,9747,1780,650,47.7687,-122.276
485000,4,2.5,2470,35073,2470,0,47.3064,-122.108
255000,3,1,1440,11330,1440,0,47.4742,-122.265
251750,3,2,1320,7200,1320,0,47.3947,-122.174
725000,3,2.5,2810,6300,2810,0,47.6077,-122.02
460000,3,3.25,1370,1194,1370,0,47.6704,-122.391
625000,3,2.5,2000,6341,1040,960,47.5639,-122.401
530000,3,1.75,1980,6760,1980,0,47.6398,-122.113
394950,3,2.5,2050,8172,2050,0,47.4808,-122.28
324950,4,1.75,2320,9240,1160,1160,47.4909,-122.257
330000,3,2.25,1960,1985,1750,210,47.5417,-122.289
220000,4,1.75,1910,8171,1910,0,47.35,-122.168
685000,3,3.25,2030,11070,2030,0,47.6478,-122.117
500000,3,2.25,2210,7680,1730,480,47.7729,-122.389
368000,4,2.75,2610,9426,1360,1250,47.4435,-122.279
825000,3,2.25,2520,7975,1550,970,47.6704,-122.183
660000,6,1.75,1840,2774,1060,780,47.6041,-122.31
253000,3,1.75,1570,7416,1570,0,47.4117,-122.174
392500,4,2.75,2400,19923,1320,1080,47.3616,-122.144
605000,3,1.75,1930,5400,1930,0,47.77,-122.391
215000,3,1,1160,10384,1160,0,47.3634,-122.027
650000,4,2.5,2820,15000,2820,0,47.7255,-122.101
877500,4,2,3060,8000,2040,1020,47.5795,-122.29
232500,3,1,1320,8450,880,440,47.3278,-122.337
234000,2,2,1200,3624,1200,0,47.349,-122.025
380000,3,1.75,1560,104108,1250,310,47.4016,-122.131
420000,5,2.25,3070,64033,2730,340,47.3238,-122.292
399950,3,1,1040,9600,1040,0,47.6738,-122.063
256750,3,2.5,1990,8991,1570,420,47.3939,-122.164
535000,3,2.5,1690,9626,1690,0,47.5647,-122.092
515000,3,2,1810,2738,1810,0,47.6112,-122.115
770000,4,1.75,2520,8442,1640,880,47.6317,-122.205
256000,3,2.5,1570,5113,1090,480,47.3327,-122.29
489900,3,1,1680,8910,1680,0,47.7011,-122.375
165000,3,1.5,1250,7200,1250,0,47.3678,-122.282
220000,3,1.5,1280,7742,1280,0,47.3947,-122.197
575000,4,2.5,4620,20793,4620,0,47.2929,-122.342
375000,3,2.5,1580,5725,1580,0,47.7611,-122.161
422250,3,1.75,1650,7145,1300,350,47.7733,-122.324
420000,3,1.75,1660,9600,1380,280,47.7601,-122.167
608000,4,2.5,2410,7140,2410,0,47.6329,-122.021
620000,3,2.25,1720,4000,1450,270,47.6683,-122.286
850000,3,2.5,3120,12406,1940,1180,47.5507,-122.141
463000,4,2.5,2680,9928,1340,1340,47.5219,-122.052
750000,5,1.75,2640,13290,1400,1240,47.5022,-122.223
1.07E+06,3,3.25,3730,13264,3730,0,47.7246,-122.059
290000,3,2,1700,6498,1700,0,47.3781,-122.044
525000,4,1.75,2280,5959,1250,1030,47.5655,-122.395
319000,3,2.25,1220,2980,1220,0,47.7151,-122.203
592500,6,4.5,3500,8504,3500,0,47.7349,-122.295
350000,3,2.5,2010,14298,2010,0,47.5069,-122.472
454900,3,1.75,2130,9775,1430,700,47.5326,-122.049
272000,4,2.25,1800,9018,1800,0,47.2126,-121.984
357500,3,1,1070,10125,1070,0,47.7012,-122.167
285000,3,1.75,1020,5000,1020,0,47.5332,-122.29
280000,4,2,1600,6861,1600,0,47.2701,-122.313
477000,4,1.5,1380,7800,1080,300,47.7093,-122.306
750000,3,2.25,3270,168000,3270,0,47.5197,-122.191
595000,4,2.5,2100,3125,1400,700,47.6634,-122.358
525000,3,2.25,2110,2850,2110,0,47.6915,-122.339
319000,3,1.75,1640,53400,1640,0,47.3944,-122.506
225000,3,2,1320,5665,1320,0,47.3096,-122.357
485000,4,2.5,2420,10603,1210,1210,47.7397,-122.259
341000,3,1,1390,4814,1390,0,47.6881,-122.32
674000,3,3.25,2320,6744,1930,390,47.7132,-122.293
442250,3,2.5,2170,8169,2170,0,47.4833,-122.139
591000,4,2.25,2710,38180,2710,0,47.77,-122.097
276000,3,2,1450,8928,1450,0,47.3637,-122.075
394000,3,2.5,1370,4400,1370,0,47.7139,-122.203
355000,3,2.5,1810,3192,1070,740,47.7364,-121.969
260000,3,2.5,1420,14850,1020,400,47.3661,-122.29
300000,3,2.75,2090,9620,1340,750,47.2741,-122.337
310000,3,2.75,2090,9620,1340,750,47.2741,-122.337
209000,3,1,1330,6900,1330,0,47.3033,-122.381
344950,3,2,1330,7419,1330,0,47.7322,-122.236
230000,5,2,1910,7200,1110,800,47.4975,-122.261
336950,3,1.75,2310,7680,1410,900,47.3743,-122.285
700000,3,2.75,2500,7378,1390,1110,47.7032,-122.37
230000,3,2,1310,7332,1310,0,47.3597,-122.051
443500,4,2.5,2040,21781,2040,0,47.6458,-121.904
471000,4,2.5,2040,21781,2040,0,47.6458,-121.904
595000,3,2.25,2400,16301,1400,1000,47.6901,-122.282
470000,3,1,1400,4914,1400,0,47.681,-122.364
600000,4,1.75,1700,7800,1700,0,47.651,-122.119
1.381E+06,4,3.75,3160,9525,3160,0,47.5623,-122.221
427800,3,1.75,1340,13241,1340,0,47.7268,-122.213
445000,4,2,1470,8395,1470,0,47.631,-122.117
382000,3,1.75,1790,7679,1790,0,47.7442,-122.338
577000,3,1.5,1560,20251,1200,360,47.619,-122.054
427000,3,2.5,2620,108464,2620,0,47.4583,-122.036
255000,3,1,1580,8206,1100,480,47.3676,-122.312
240000,3,1,1090,10000,1090,0,47.6503,-121.911
1.23458E+06,5,3.25,3240,6551,2500,740,47.6792,-122.273
435000,4,1.75,2520,7200,1260,1260,47.4835,-122.192
1.45E+06,3,1.75,2230,13529,2230,0,47.6204,-122.217
425000,4,3,2430,5502,2430,0,47.356,-122.014
393000,2,1,1020,4200,1020,0,47.5319,-122.391
264950,4,1,1810,7500,1410,400,47.4935,-122.333
746500,4,2.5,3460,9699,3460,0,47.637,-122.04
450000,3,1,2020,8100,1170,850,47.7136,-122.288
229950,3,2,1410,7466,1410,0,47.427,-122.147
425000,2,1,750,4000,750,0,47.54,-122.32
2.555E+06,4,2.5,5300,26211,4570,730,47.661,-122.269
1.4E+06,4,3.5,4380,66613,4380,0,47.7279,-122.048
753000,3,2.25,2290,9047,2290,0,47.5545,-122.163
310000,2,1,720,5750,720,0,47.5535,-122.393
395000,2,1,1200,6014,600,600,47.5357,-122.28
725000,3,2.5,2620,28703,2620,0,47.7238,-122.114
295000,4,3,2120,7650,2120,0,47.6214,-122.14
225000,3,1.75,1580,8820,1580,0,47.317,-122.325
1.699E+06,3,3.25,4160,35153,3690,470,47.5749,-122.214
431000,3,2.25,1830,8831,1460,370,47.7286,-122.215
358500,3,2.5,2000,8057,1360,640,47.3724,-122.107
595000,2,1,980,3600,980,0,47.6366,-122.365
468000,4,2.5,3040,20682,3040,0,47.7245,-121.959
260000,4,1,1740,8100,1020,720,47.467,-122.185
375000,3,2,1450,7300,1450,0,47.7517,-122.342
295000,3,2.5,1560,4200,1560,0,47.3838,-122.026
403900,4,2.5,2050,8909,1690,360,47.398,-122.31
269950,3,1.75,1760,12823,1460,300,47.2868,-122.21
640000,3,3.5,1740,1975,1310,430,47.6085,-122.311
221000,3,1,910,8789,910,0,47.4345,-122.326
255000,3,1.75,1700,7532,1700,0,47.355,-122.176
300000,4,2.5,2620,4469,2620,0,47.3663,-122.115
270000,3,2.25,1500,7410,1500,0,47.4597,-122.162
575000,4,1.75,1630,5750,1160,470,47.5674,-122.384
246900,3,1.5,1370,9800,1370,0,47.3068,-122.27
635000,2,2.5,1390,1132,1130,260,47.6228,-122.319
450000,3,2,1540,67756,1540,0,47.721,-122.078
215000,3,1,1190,7500,1190,0,47.3248,-122.142
785000,3,3.5,4500,21870,4500,0,47.3043,-122.159
522500,4,3,2370,8154,1380,990,47.7258,-122.306
150000,2,1.5,1360,1934,1360,0,47.2857,-122.189
199950,2,1.75,870,18537,870,0,47.275,-122.278
3E+06,4,4.25,4850,12445,3850,1000,47.7011,-122.244
379900,3,2,3110,44967,3020,90,47.4343,-122.082
950000,4,2.5,3700,7051,3700,0,47.5427,-121.995
865000,6,2.75,3500,5150,2430,1070,47.6842,-122.363
785000,3,1.75,1670,9600,1670,0,47.5754,-122.233
245700,3,2.25,1640,8400,1180,460,47.3733,-122.289
951000,3,2.25,3400,12825,3400,0,47.5435,-122.26
499950,3,1.75,2060,3500,1030,1030,47.5635,-122.282
257000,3,1.75,1330,36537,1330,0,47.3126,-122.129
549000,3,2,2330,3600,1580,750,47.6025,-122.303
1.6E+06,3,2.75,3040,21052,3040,0,47.638,-122.225
1.4E+06,5,3.75,3700,7920,2900,800,47.6865,-122.266
619000,3,2,1990,3000,1430,560,47.5891,-122.293
311000,5,3,2020,5917,1220,800,47.5482,-122.294
600000,5,2.25,2980,7781,1580,1400,47.7048,-122.279
1.08E+06,4,3.5,3990,5267,3990,0,47.5641,-122.124
436000,2,1,790,6600,790,0,47.6149,-122.293
205000,2,1,1060,8000,1060,0,47.5088,-122.333
514000,3,2.25,2260,54014,1450,810,47.7657,-122.131
530000,2,2.5,1900,2983,1900,0,47.7029,-122.015
511000,5,2.5,3361,6983,3361,0,47.3427,-122.169
2.1E+06,4,1.75,3550,19865,3550,0,47.6236,-122.235
370000,5,2.5,2740,5460,2740,0,47.4042,-122.204
500000,4,1.75,2040,6000,1020,1020,47.5507,-122.383
710000,4,2.5,4070,129808,4070,0,47.4433,-122.016
270000,1,1,720,5196,720,0,47.6928,-122.337
415000,3,1.75,2000,8400,2000,0,47.7535,-122.334
1.8E+06,5,4.5,4400,15580,3390,1010,47.6232,-122.207
236000,3,1.75,1300,8976,1300,0,47.3357,-122.305
278000,2,2.5,1420,2229,1420,0,47.4871,-122.165
312000,3,2.25,1540,5338,770,770,47.6942,-122.304
539000,3,2.25,1540,5338,770,770,47.6942,-122.304
498000,3,3,2360,2750,1780,580,47.7142,-122.281
857000,4,3,3720,29043,3720,0,47.6907,-122.161
780000,3,1.75,1690,13500,1690,0,47.5897,-122.233
650000,3,2,2300,5000,1150,1150,47.6521,-122.413
559500,4,1.75,1650,7088,1650,0,47.5688,-122.087
219950,2,1,990,6448,990,0,47.5031,-122.245
671500,4,2.25,2130,8410,2130,0,47.5589,-122.128
813000,4,2.5,3320,52707,3320,0,47.6247,-122.016
182000,3,2.25,1960,8875,1290,670,47.3344,-122.301
203700,2,1,770,2500,770,0,47.7534,-122.172
740000,4,1.75,2010,3600,2010,0,47.6337,-122.371
230000,2,1,800,17965,800,0,47.4693,-122.161
128000,3,1,910,11117,910,0,47.3432,-122.309
345000,3,1,1200,6628,1200,0,47.7367,-122.319
663000,4,2.5,3570,6246,3570,0,47.5927,-122.006
329950,3,2.5,1820,8085,1820,0,47.4575,-122.204
1.0475E+06,3,2.25,2930,7005,2670,260,47.6763,-122.404
402300,3,1.75,1480,4050,870,610,47.681,-122.304
492000,4,2.5,3305,16164,2245,1060,47.7563,-122.338
448000,4,2.5,2230,5000,1650,580,47.4799,-122.129
273000,3,1,1560,7800,1560,0,47.4549,-122.287
335000,3,1,1030,7200,880,150,47.5255,-122.376
695000,3,3.75,2380,3600,1690,690,47.6374,-122.307
279000,3,1,1010,7903,1010,0,47.766,-122.32
485000,2,1.75,2060,2700,1030,1030,47.6856,-122.312
383000,4,2.5,2370,10580,2370,0,47.464,-122.192
490000,4,2.5,2242,37451,2242,0,47.7443,-122.228
240000,2,1.5,1078,1263,1078,0,47.7532,-122.244
285000,2,1,890,7250,890,0,47.7118,-122.314
524950,3,1.5,2700,24539,2120,580,47.7348,-121.984
729000,4,2.5,2450,27081,2450,0,47.7177,-122.104
460000,3,1.75,1420,8250,1420,0,47.6112,-122.133
687500,3,1.5,1280,2114,1280,0,47.6174,-122.308
1.168E+06,5,2.75,2910,15118,1780,1130,47.5696,-122.183
825000,4,2.25,2430,10050,2430,0,47.5563,-122.163
314950,2,2.5,1860,6359,1860,0,47.3847,-122.029
470000,3,2,1800,12669,1800,0,47.6935,-122.173
500000,3,1.5,1960,8815,1020,940,47.5765,-122.159
313000,3,1.5,1550,7260,1550,0,47.4693,-122.349
445000,2,1,840,3840,840,0,47.684,-122.378
300000,4,1.75,2080,8750,1330,750,47.3749,-122.291
619500,4,2.5,2210,5077,1480,730,47.5719,-122.377
305000,3,1.5,1210,5240,610,600,47.5524,-122.356
874000,3,2.5,1350,941,1350,0,47.6265,-122.364
477500,3,2,1860,5146,1860,0,47.5706,-121.999
700000,3,2,1940,4500,1090,850,47.6659,-122.359
515000,4,3.5,3400,5222,3400,0,47.3559,-122
590000,4,2.5,2240,9385,2240,0,47.7125,-122.332
205000,3,1.75,1170,8239,1170,0,47.3679,-122.088
310000,3,3.25,3130,9302,2190,940,47.3078,-122.338
442500,2,2.25,1510,7280,1510,0,47.6264,-122.058
1.0785E+06,4,3.5,3740,41458,3740,0,47.7375,-122.139
530000,4,2.5,2690,46609,2690,0,47.3843,-122.006
343500,4,1.75,1760,6204,1180,580,47.5045,-122.24
334900,4,1.75,2180,4066,1270,910,47.5487,-122.277
544300,4,1.75,1560,9000,1560,0,47.6707,-122.149
370000,3,2.5,1780,4050,1780,0,47.7346,-122.308
245000,3,1.75,1260,6908,1260,0,47.385,-122.031
535000,4,1.75,1570,3250,1570,0,47.5405,-122.393
202000,2,1,740,6550,740,0,47.4807,-122.332
490000,4,2.25,2020,4960,1710,310,47.6867,-122.369
651500,4,1.5,1500,3075,1420,80,47.6893,-122.35
270000,4,2.5,1670,8056,1170,500,47.4884,-122.319
1.164E+06,3,3.5,3620,8072,2920,700,47.5646,-122.127
289000,2,1.5,1010,1309,860,150,47.5659,-122.286
240000,3,1.5,1460,13503,1460,0,47.3119,-122.015
790000,3,1.75,1790,6117,1350,440,47.6366,-122.401
350000,3,2.25,1760,9621,1760,0,47.7466,-121.979
246950,3,3.5,1790,1682,1480,310,47.542,-122.321
400000,3,1,1050,6000,1050,0,47.5709,-122.401
533000,4,2.5,2590,6394,2590,0,47.7599,-122.233
198400,3,1,1040,8645,1040,0,47.3631,-122.116
495000,4,2.5,4060,8547,2790,1270,47.3694,-122.056
862000,4,2.5,3190,14565,3190,0,47.713,-122.072
870000,4,2.5,3190,14565,3190,0,47.713,-122.072
875000,4,1.75,2180,9726,2180,0,47.5359,-122.233
317000,6,3.5,2120,5840,2120,0,47.4788,-122.227
325000,4,2.75,2110,6838,2110,0,47.3877,-122.171
615000,2,1.5,1210,5000,1210,0,47.6793,-122.397
334950,4,2.5,2410,7846,2410,0,47.2641,-122.312
775000,3,2.5,1980,7807,1980,0,47.6884,-122.204
600000,4,2.5,2370,9135,1600,770,47.5564,-122.177
565000,3,1.75,1720,2218,1270,450,47.649,-122.335
292500,2,1,750,5026,750,0,47.5368,-122.374
825000,3,2.25,2510,10418,1810,700,47.7003,-122.285
495000,3,2.5,2577,156816,2577,0,47.2935,-122.108
525000,3,1.5,1540,4773,1540,0,47.5678,-122.378
438600,1,1,720,2500,720,0,47.6597,-122.345
507000,3,2.25,1810,8158,1450,360,47.6258,-122.038
275900,3,1.75,1380,8400,1380,0,47.3117,-122.321
1.17E+06,4,2.5,2570,6251,2570,0,47.593,-122.197
275000,4,1.75,1690,6000,1690,0,47.497,-122.227
355000,3,0.75,1420,3060,860,560,47.6872,-122.346
233000,4,2,2130,9579,1250,880,47.3069,-122.271
666000,3,2.5,3000,5000,2110,890,47.5781,-122.293
317500,4,2.5,2150,9000,1360,790,47.4785,-122.16
420000,4,2,2280,10319,1270,1010,47.3594,-122.322
290000,4,2,1560,8800,1560,0,47.4927,-122.312
320000,3,2,1880,10758,940,940,47.5091,-122.144
650000,3,2.5,2320,5284,2320,0,47.591,-122.017
325000,3,1.75,1010,7171,1010,0,47.7317,-122.231
165000,3,1,1120,5000,1120,0,47.5109,-122.357
500000,3,1.75,1560,16194,1560,0,47.5966,-122.175
443000,4,1.5,1860,12197,1860,0,47.729,-122.235
213400,3,1.5,1150,8686,1150,0,47.4417,-122.194
480000,4,1.75,1920,9380,1920,0,47.6344,-122.118
275000,4,2.25,2490,7233,1460,1030,47.3115,-122.396
299880,3,2.5,1460,3044,1460,0,47.544,-122.296
499950,3,3.5,1820,1501,1430,390,47.596,-122.298
1.705E+06,5,3,4290,17100,2480,1810,47.5473,-122.211
550000,4,2.75,2230,9460,1480,750,47.5246,-122.044
300000,4,2.5,2070,7476,2070,0,47.3352,-122.189
920000,3,1.75,2480,4000,1240,1240,47.615,-122.288
2.3E+06,4,3.25,4110,15929,2720,1390,47.6934,-122.271
620000,4,2.75,2290,3060,1550,740,47.6793,-122.316
253500,3,1,1220,20400,1220,0,47.2063,-122.023
978000,4,2.75,2620,13777,1720,900,47.58,-122.285
387500,4,2.5,3190,9856,3190,0,47.4445,-122.126
325000,3,1,850,6906,850,0,47.7441,-122.314
568000,3,2.5,1740,1308,1740,0,47.5892,-122.387
525000,4,2.5,2140,7754,2140,0,47.7173,-122.338
560000,3,2.5,2070,12708,2070,0,47.5295,-122.18
394000,3,2.5,1680,4075,1680,0,47.6964,-122.024
484950,2,1,1000,4956,1000,0,47.6753,-122.36
1.295E+06,3,2.75,3340,12690,2550,790,47.6665,-122.27
315000,3,2.5,1260,2767,1260,0,47.4914,-122.155
590000,4,2.25,2430,32496,2430,0,47.7642,-122.048
106000,1,1,560,5700,560,0,47.511,-122.359
751000,3,2.5,3380,9528,3380,0,47.5275,-122.148
474000,2,1,1100,3500,1100,0,47.6741,-122.323
189000,2,2,1700,3171,850,850,47.3025,-122.224
440500,3,2.5,1600,3172,1600,0,47.6868,-122.042
1.017E+06,3,2.5,2605,2216,2090,515,47.6529,-122.202
589000,2,2,1850,4667,1850,0,47.7101,-122.014
273000,3,2.25,1830,7651,1830,0,47.2642,-122.219
950000,3,3.25,3050,18892,1650,1400,47.3881,-122.326
277700,2,1.5,1240,1055,1200,40,47.6104,-122.112
299900,3,2.25,2100,8163,2100,0,47.3336,-122.269
235000,3,1,1250,15603,1250,0,47.5093,-122.172
464000,2,2,1230,4800,1230,0,47.7145,-122.35
281000,3,1.75,1690,9826,1690,0,47.314,-122.365
320000,3,1,1520,8870,1520,0,47.7638,-122.317
282000,4,2,1890,6302,1890,0,47.3846,-122.205
745000,4,1.75,1990,8900,1990,0,47.5639,-122.149
245000,3,1.75,1480,3900,1480,0,47.2977,-122.367
250000,3,1.75,1480,3900,1480,0,47.2977,-122.367
470000,3,2.5,2120,2374,1770,350,47.674,-122.142
216650,3,3.5,1480,1077,1300,180,47.5421,-122.322
440000,3,1,1250,8412,1250,0,47.7012,-122.131
590000,4,2.5,2010,7972,2010,0,47.5782,-122.018
935000,5,2.5,3150,35283,1800,1350,47.6368,-122.157
848000,3,3.5,3010,5717,3010,0,47.5943,-122.15
827500,5,4.25,3920,5823,3000,920,47.5492,-122.008
1.125E+06,6,3,2880,3192,2180,700,47.6506,-122.332
630000,2,2.25,2550,5663,1720,830,47.5304,-122.202
340000,5,1,1120,9022,1120,0,47.7296,-122.24
570000,4,2.75,3140,10918,1900,1240,47.7086,-122.243
2.75E+06,4,4,4130,5575,2860,1270,47.5968,-122.083
514500,4,2.5,2990,9614,1740,1250,47.3424,-122.329
360000,2,1,1120,12625,1120,0,47.5397,-122.385
228900,4,1.5,1570,8775,1570,0,47.4789,-122.335
660000,3,2.75,2210,4000,2210,0,47.6954,-122.017
647000,4,2.5,2390,5800,2390,0,47.5965,-122.038
366000,3,1.75,1520,8625,1520,0,47.7687,-122.223
354000,5,1.75,1830,7986,1060,770,47.5208,-122.35
850000,4,3.5,2640,5900,2640,0,47.5421,-122.383
496700,3,2.5,1740,5782,1740,0,47.5783,-122.001
300000,3,2,1550,8300,1550,0,47.4654,-122.195
390000,3,1,1040,8075,1040,0,47.6701,-122.176
350000,3,2.25,1640,7200,1640,0,47.5948,-122.153
561000,3,2.25,1640,7200,1640,0,47.5948,-122.153
475000,3,1.75,1260,10065,1260,0,47.5727,-122.138
275000,3,1.5,1170,1174,840,330,47.5459,-122.376
290000,3,1.75,1590,13500,1090,500,47.3621,-122.031
199000,3,2.5,1750,6725,1330,420,47.352,-122.058
279900,4,2.5,1770,4338,1770,0,47.3672,-122.099
1.655E+06,4,2.25,3530,5500,2860,670,47.6618,-122.273
405000,3,2.5,2160,10200,1360,800,47.7295,-122.331
615000,4,2.25,2360,15860,2360,0,47.6307,-122.051
268000,3,1.75,1980,12543,1180,800,47.3104,-122.394
451000,4,1.5,1620,5444,1620,0,47.7065,-122.297
850000,2,2.75,2700,9854,2700,0,47.7187,-122.024
1.18E+06,5,2.25,3270,16553,2470,800,47.5428,-122.236
245000,2,1,870,6150,870,0,47.5256,-122.347
450000,2,1.75,840,3340,700,140,47.6692,-122.359
370350,3,3.5,1340,1168,1080,260,47.711,-122.356
543000,3,2.5,1540,1256,1540,0,47.6498,-122.346
265000,2,2,1650,8975,1650,0,47.5073,-122.36
497000,3,2.5,2630,4611,2630,0,47.5322,-121.868
419000,4,2.25,1880,9727,1100,780,47.7731,-122.257
545800,4,2.5,1980,4500,1980,0,47.579,-122.001
403000,3,1,1500,10730,1000,500,47.6385,-121.966
195000,3,2,1230,8235,1230,0,47.4853,-122.304
1.125E+06,4,2.5,2520,2600,1670,850,47.6434,-122.358
255000,5,1.75,1970,8925,1170,800,47.2925,-122.196
500000,2,1.5,1520,8040,1520,0,47.7131,-122.306
855000,4,2.75,2600,5390,1300,1300,47.6382,-122.397
390000,4,2,2290,9200,2290,0,47.4678,-122.363
339000,3,2,1979,8470,1329,650,47.3912,-122.301
1.325E+06,4,3.5,2170,3672,2170,0,47.6828,-122.329
429900,4,1.5,1820,17918,1190,630,47.521,-122.179
370900,3,1.5,1200,8560,1200,0,47.7392,-122.194
457500,3,1,1210,7636,1210,0,47.5377,-122.266
499000,4,2.5,1970,2601,1440,530,47.5949,-122.308
225000,2,1,1040,11500,1040,0,47.2791,-122.3
615000,3,1.75,1920,4000,1070,850,47.6392,-122.318
455000,2,1.5,1020,1146,1020,0,47.6774,-122.325
458000,3,1,1660,7500,1060,600,47.7105,-122.306
580000,3,2.25,1670,7416,1220,450,47.6028,-122.172
966000,5,4.5,3810,8019,3810,0,47.5915,-122.058
240000,4,1.75,2020,10332,1010,1010,47.5059,-122.303
229050,1,1,420,3298,420,0,47.5375,-122.391
328500,3,2.25,1390,1407,1390,0,47.7227,-122.296
319000,3,1.5,2010,10100,1110,900,47.4738,-122.266
650000,4,2,1820,5000,1640,180,47.6815,-122.269
398500,3,2.5,1630,1971,1630,0,47.7753,-122.375
250000,1,1,800,16306,680,120,47.4916,-122.308
815000,3,2,2270,11989,2270,0,47.5434,-122.229
1.065E+06,3,2.75,2290,5002,1950,340,47.6811,-122.207
510000,3,2.25,2750,219542,1870,880,47.6367,-121.948
156000,2,1.75,590,6138,590,0,47.545,-122.278
254500,4,2.75,2570,7264,1720,850,47.258,-122.208
760000,3,2.5,2050,15020,1600,450,47.759,-122.371
210000,3,2.5,1610,6732,1610,0,47.3658,-122.172
349950,3,2.5,2140,7715,2140,0,47.384,-122.322
676000,3,2,1730,6784,1730,0,47.6462,-122.403
475000,4,3.5,2440,3052,1940,500,47.555,-122.309
880000,4,2.75,3220,4392,2320,900,47.6713,-122.276
1.209E+06,4,3.25,4330,26162,4330,0,47.6009,-122.011
420000,3,1.5,1780,5000,1030,750,47.5168,-122.256
607000,3,1,1230,8114,1230,0,47.5822,-122.196
475000,4,1.75,2160,19283,2160,0,47.7603,-122.169
395000,2,1.75,1400,2500,710,690,47.5628,-122.391
650000,4,1.75,1900,10454,1180,720,47.5933,-122.195
625000,5,2.75,2910,85377,1510,1400,47.48,-122.03
849000,3,3,2960,42159,2960,0,47.7183,-122.1
429950,3,1.5,2010,9480,1570,440,47.7102,-122.281
825000,3,2.5,3760,5260,3230,530,47.5489,-122.007
505000,2,1,1020,5000,1020,0,47.6781,-122.363
265000,2,1,1290,2828,1290,0,47.6968,-122.025
283000,3,1,890,8400,890,0,47.5168,-122.204
560000,3,2.75,1620,7500,1140,480,47.6175,-122.065
765000,4,2.5,3360,13636,3360,0,47.6373,-122.042
610000,5,2.75,2930,31411,1520,1410,47.5576,-122.186
589000,3,2.5,2940,4799,1710,1230,47.6681,-122.184
192500,3,1,1080,8580,1080,0,47.4716,-122.262
3.2E+06,3,3.25,4560,13363,2760,1800,47.6205,-122.214
550000,3,1,1010,6120,860,150,47.6861,-122.296
460000,2,1.5,1790,3760,1280,510,47.6871,-122.373
264500,4,2.25,2060,11385,1200,860,47.314,-122.363
339000,3,1,1150,2496,1010,140,47.5194,-122.376
950000,4,3.5,4030,4200,4030,0,47.6416,-122.386
677500,3,1.75,2020,9718,2020,0,47.574,-122.21
690000,4,2.5,2740,8120,2740,0,47.6123,-122.006
312000,4,2.25,1930,7452,1430,500,47.4098,-122.189
840000,5,1.75,2500,11617,1560,940,47.5361,-122.217
357500,3,3.5,2080,5100,2080,0,47.35,-122.005
675000,3,1.5,1460,6480,980,480,47.6962,-122.397
515000,3,2.75,3290,11441,3290,0,47.3052,-122.34
491234,4,2.5,1540,1860,1540,0,47.5521,-121.999
290000,3,2,1310,6265,1310,0,47.3893,-122.051
490000,4,2.5,2120,7820,1280,840,47.6743,-122.145
810000,4,2,2920,10424,1520,1400,47.5876,-122.172
252000,3,1.5,1150,13200,1150,0,47.4752,-122.345
299999,3,2.5,2380,9719,2380,0,47.2932,-122.283
400000,3,2.75,2220,5000,2220,0,47.5515,-122.324
530000,5,2,3020,6000,1860,1160,47.5207,-122.378
357000,3,2,2460,53882,2460,0,47.3811,-122.325
365000,3,1.75,1820,5555,1030,790,47.6867,-122.352
804000,4,2.5,2620,5060,2620,0,47.5634,-122.394
808250,3,2,1750,2640,1010,740,47.6419,-122.368
360000,4,2.5,2020,7289,2020,0,47.401,-122.171
240000,3,1.75,1240,10956,1240,0,47.3705,-122.15
335000,2,2,1380,5840,1380,0,47.7732,-122.172
380000,3,1.75,1920,8775,1920,0,47.4544,-122.351
350000,3,1.75,1680,250470,1070,610,47.7624,-121.93
194000,3,1,1400,7955,1400,0,47.4848,-122.221
310000,3,1,1240,7194,1090,150,47.7636,-122.202
315000,3,1.75,1410,15134,1410,0,47.6931,-121.921
258950,3,1.75,1440,8050,1440,0,47.3187,-122.39
479000,2,2.25,1230,932,1020,210,47.6192,-122.301
510000,5,1.5,1550,9750,1550,0,47.6811,-122.169
400000,3,2,1760,6875,1760,0,47.74,-122.093
1.45E+06,4,3.5,5000,38012,3610,1390,47.554,-122.036
680000,5,2,2140,5000,2020,120,47.6044,-122.299
1.75E+06,6,3,3510,5760,3510,0,47.6263,-122.312
335000,3,1.75,2010,9417,1500,510,47.373,-122.185
460000,5,2.5,3390,9760,1750,1640,47.4462,-122.137
440000,4,2.25,2160,8119,1080,1080,47.5443,-122.177
412250,2,2,1300,2983,1300,0,47.703,-122.015
185000,3,1.5,1280,4031,1280,0,47.3342,-122.215
286500,3,2,1840,8140,1040,800,47.3106,-122.325
422000,4,2.5,3200,6691,3200,0,47.367,-122.031
408000,3,2.25,2800,35362,2800,0,47.3507,-122.089
306500,2,1,1390,19988,1390,0,47.3985,-122.321
359900,4,2.5,2600,5188,2600,0,47.3451,-122.04
560000,3,2.5,1960,6058,1960,0,47.6319,-122.007
259875,3,1,1250,21303,1250,0,47.6625,-122.059
385000,3,1,1250,21303,1250,0,47.6625,-122.059
188000,1,1,550,16345,550,0,47.5181,-122.339
1.142E+06,4,3.25,2500,5801,1960,540,47.632,-122.29
255000,3,1,1250,10094,1250,0,47.4987,-121.781
1.185E+06,4,2.75,3020,8622,3020,0,47.5866,-122.201
635200,4,1.75,1640,4240,920,720,47.6766,-122.368
355000,3,1.75,1870,8250,1870,0,47.445,-122.285
544000,3,2.5,1760,1755,1760,0,47.6688,-122.279
402000,3,1.5,1320,3145,1320,0,47.5909,-122.297
575000,4,1.5,1430,4163,1430,0,47.6606,-122.397
216000,3,1.75,1580,9705,1580,0,47.3819,-122.09
1.2E+06,4,3.5,4170,9748,4170,0,47.528,-122.132
850000,4,3.25,3090,6744,3090,0,47.768,-122.388
238000,3,2,1020,1204,720,300,47.5445,-122.376
625000,4,1.75,2180,4431,2020,160,47.636,-122.302
1.11E+06,5,3.25,3350,4000,2510,840,47.6645,-122.291
820000,3,2.5,2510,5503,2510,0,47.5419,-122.383
355000,3,2.5,1880,5290,1250,630,47.5401,-122.3
495000,4,1.5,1810,7998,1210,600,47.726,-122.297
1.3E+06,5,2.5,4170,33310,4170,0,47.5455,-122.126
398750,3,2.5,2230,4000,2230,0,47.5801,-122.306
835000,4,2.5,3650,7784,3650,0,47.7066,-122.101
705000,6,2.75,2830,10579,1430,1400,47.636,-122.171
625000,4,1.5,2120,5000,2120,0,47.6024,-122.296
550000,4,2.5,2090,6926,2090,0,47.6339,-122.022
540000,3,1.5,2600,5085,1400,1200,47.5659,-122.376
519000,2,1,830,2820,830,0,47.689,-122.347
311000,4,2.5,1975,8734,1975,0,47.363,-122.034
305000,4,2.5,1900,7000,1420,480,47.3092,-122.376
395000,4,2.75,2640,35070,2640,0,47.4242,-122.181
275000,4,1.5,1610,6923,1010,600,47.3747,-122.306
450000,3,3.25,1770,1863,1430,340,47.5478,-122.005
324000,2,1,1070,6000,1070,0,47.7307,-122.332
2.795E+06,5,3.25,4590,12793,3590,1000,47.6453,-122.41
565000,4,1,1540,2452,1540,0,47.6522,-122.348
373000,4,1.75,1590,7920,1590,0,47.7456,-122.336
613000,2,2,1170,1890,1170,0,47.6402,-122.371
614000,4,2.25,2880,9996,1920,960,47.7584,-122.143
595000,4,1.75,2510,8989,1680,830,47.5569,-122.172
440000,2,1,1280,12086,850,430,47.634,-122.033
425000,3,1.5,1570,12412,1570,0,47.438,-122.349
407000,2,1,740,6380,740,0,47.6929,-122.318
472000,3,1.5,1740,9038,1740,0,47.5897,-122.136
472000,3,2.5,1180,1262,1180,0,47.6381,-122.375
1.25E+06,5,2.75,2960,28300,2160,800,47.7606,-122.37
412000,3,1.75,1880,5752,940,940,47.5354,-122.378
717000,3,1,1150,5000,1150,0,47.6805,-122.369
425000,3,1,1320,7076,1320,0,47.6131,-122.123
299999,4,2,1640,7200,820,820,47.4791,-122.347
254000,3,2,1470,7694,1470,0,47.3539,-122.054
178500,3,1,900,10511,900,0,47.2883,-122.272
800000,3,1.75,1510,3600,1230,280,47.6387,-122.363
420000,3,1,1440,5623,720,720,47.696,-122.319
319900,2,1,1380,9251,1380,0,47.7486,-122.249
350000,2,1.5,1150,7552,1150,0,47.7298,-122.286
968000,6,2.75,3610,17580,2070,1540,47.5739,-122.069
491000,3,2,1250,1306,1250,0,47.6705,-122.39
948000,3,2.5,3510,9824,3510,0,47.5635,-122.032
900000,3,2.5,2260,9577,1700,560,47.6928,-122.399
270000,3,1.75,2840,9800,1420,1420,47.3516,-122.119
198000,3,1.5,1430,7347,820,610,47.2927,-122.369
250000,2,1,1420,21158,1420,0,47.4594,-122.359
615000,4,2.5,2120,3720,2120,0,47.5526,-121.994
550000,3,2.5,2080,7749,2080,0,47.5723,-122.021
190000,2,2.5,1370,3438,1370,0,47.4606,-122.283
629000,4,2.25,1900,11171,1280,620,47.561,-122.126
434000,3,1.75,1660,8301,1660,0,47.7647,-122.263
415885,3,1,1310,4163,1310,0,47.5301,-122.381
550000,3,2.5,1840,3035,920,920,47.6557,-122.327
272000,1,0.75,1040,6034,580,460,47.5078,-122.251
665000,3,2.5,2610,35000,2610,0,47.7377,-122.101
510000,3,2,1990,7405,1990,0,47.5421,-122.172
530000,3,2,3080,17700,1740,1340,47.4695,-122.366
355000,3,1,1200,16000,1200,0,47.7452,-122.101
255000,4,1,1250,9102,1250,0,47.4258,-122.327
790000,4,2.75,2640,9000,2640,0,47.6481,-122.125
695000,5,1.75,1790,9335,1790,0,47.5945,-122.201
255000,2,2,1140,8400,1140,0,47.4351,-122.335
410000,3,2.25,1790,5794,1380,410,47.7477,-122.171
650000,4,2.75,1910,16532,1420,490,47.6952,-122.39
675000,4,1.75,1530,3615,1530,0,47.6529,-122.334
332888,2,2.5,1050,1029,950,100,47.6018,-122.299
300000,3,1.75,1730,6900,1130,600,47.3915,-122.188
320000,4,1.5,1100,11824,1100,0,47.5704,-122.141
342500,5,2.25,2100,10726,1050,1050,47.4922,-122.134
752875,4,2.5,2800,72309,2800,0,47.7432,-122.112
1.73E+06,5,3.5,5000,26540,3410,1590,47.5665,-122.21
255000,1,0.5,880,1642,500,380,47.5732,-122.372
244000,3,2.5,1470,9337,1470,0,47.7651,-122.323
1.42E+06,5,3.25,3950,11438,3430,520,47.6898,-122.189
218000,3,1,980,12812,980,0,47.4892,-122.306
359000,4,1,2180,10617,2180,0,47.7522,-122.307
840000,4,2.75,3040,13559,3040,0,47.522,-122.149
900000,5,3.75,4130,226076,3170,960,47.715,-122.065
205000,4,1.75,1850,65340,1850,0,47.3468,-122.11
205000,3,2.5,1600,7295,1600,0,47.3904,-122.165
500000,2,1.5,2070,5432,1370,700,47.5571,-122.299
510000,4,2.5,3180,5405,3180,0,47.4905,-122.14
1.135E+06,6,4.25,6900,244716,4820,2080,47.7506,-122.012
1.545E+06,4,2.25,2640,3000,2080,560,47.6313,-122.344
210000,3,1.5,1920,61014,1920,0,47.4446,-122.074
597500,3,1.75,2030,32565,1600,430,47.7112,-122.098
400000,2,1,1140,101529,1140,0,47.2592,-122.228
412000,3,1,1660,6992,1260,400,47.7576,-122.318
299950,2,1.5,1390,1756,1390,0,47.7274,-122.357
1.081E+06,4,3,2490,4325,1690,800,47.6628,-122.326
422500,4,2.5,2550,8824,2550,0,47.3979,-122.212
410000,3,2,1270,10227,1270,0,47.6876,-122.168
1.4E+06,4,3.25,2980,7000,2140,840,47.5933,-122.292
245000,3,2,1470,8000,1470,0,47.3191,-122.385
720000,4,3,3550,12327,2180,1370,47.7533,-122.205
315000,2,1,780,7200,780,0,47.5609,-122.279
191950,2,2.5,1390,1302,1390,0,47.3081,-122.329
455000,4,2.5,2440,5001,2440,0,47.5108,-122.193
523000,3,1.5,1260,3135,1260,0,47.5755,-122.388
250000,3,2.25,1640,4420,1640,0,47.311,-122.21
294000,3,3,1670,4120,1140,530,47.4881,-122.199
490000,3,2.25,2380,6000,2040,340,47.6955,-122.275
310000,4,1,1030,5750,1030,0,47.553,-122.37
265000,3,1.5,1560,10489,1560,0,47.2048,-121.999
402000,4,1.75,1640,10500,1010,630,47.6933,-122.116
705000,2,2.5,2200,188200,2200,0,47.2458,-122.002
589450,4,2.5,3190,7941,3190,0,47.353,-122.002
219950,3,1.5,1200,8404,1200,0,47.4482,-122.269
750000,3,2.25,2250,5301,1510,740,47.6741,-122.271
478000,2,1.75,1960,6000,980,980,47.6531,-122.401
170000,3,1,1250,7015,1250,0,47.4548,-122.29
489950,4,2.25,2640,31941,2640,0,47.3099,-122.116
1.37E+06,2,2.25,2460,16940,1930,530,47.6792,-122.404
319950,3,2.5,1700,7000,1700,0,47.3798,-122.025
208417,2,1,840,4200,840,0,47.5292,-122.316
410000,4,2,1900,5100,950,950,47.6767,-122.38
590000,4,2.75,2160,4205,1080,1080,47.7081,-122.276
648000,3,1.75,1610,10229,1610,0,47.553,-122.174
255000,3,2.5,1720,6194,1720,0,47.2624,-122.221
465000,4,2.75,2190,3267,2190,0,47.7751,-122.168
622000,4,1.75,3020,10714,1510,1510,47.56,-122.181
306000,3,1.75,1980,9800,1980,0,47.3745,-122.224
617000,3,2.5,1880,5500,1880,0,47.657,-122.393
438750,3,1.75,1610,6480,1610,0,47.7137,-122.307
1.28E+06,4,3,3260,4500,2300,960,47.6314,-122.353
995000,5,3.25,3970,8029,2970,1000,47.7764,-122.385
1.58E+06,4,2.5,4570,74487,4570,0,47.7282,-122.372
635000,5,2.75,2620,5500,1710,910,47.6806,-122.388
215000,3,1,1180,9000,1180,0,47.39,-122.166
530000,3,2.5,1365,1090,1315,50,47.6776,-122.324
295000,2,1,720,4125,720,0,47.5245,-122.354
245000,3,2.25,1350,6775,930,420,47.3593,-122.289
400000,6,2.5,3060,17112,1530,1530,47.4379,-122.146
303000,3,2.75,1850,8820,1850,0,47.1928,-122.01
330000,3,1.75,1320,9675,1320,0,47.5695,-121.902
700000,3,1.75,1990,13000,1990,0,47.7439,-122.262
126000,1,1,610,4400,610,0,47.4865,-122.197
850000,4,1,2500,35802,2500,0,47.6488,-122.153
405000,3,2,1440,7425,1440,0,47.7243,-122.185
869900,6,4.5,2750,4400,1770,980,47.6883,-122.335
485000,3,1.75,1790,6775,1790,0,47.5412,-122.377
400000,2,2,1050,1173,720,330,47.6181,-122.302
299950,3,2.5,1780,4650,1780,0,47.386,-122.047
585000,4,2.5,2200,9099,2200,0,47.733,-122.225
495000,4,2,1720,5413,1470,250,47.6929,-122.321
2.2E+06,5,4.5,5840,17168,4570,1270,47.5457,-121.991
447000,3,2.25,1520,14080,1520,0,47.6273,-122.059
206000,3,1,1320,9239,1320,0,47.312,-122.183
500000,3,1,1070,4600,950,120,47.5627,-122.383
302500,4,2.5,1990,5511,1990,0,47.3585,-122.191
1.25E+06,4,4.25,4980,13000,3080,1900,47.6406,-122.101
391000,2,1,890,5423,890,0,47.6966,-122.368
250000,3,2,1440,5457,1440,0,47.3784,-122.046
435000,4,2.5,2440,5350,2440,0,47.4891,-122.149
160000,4,2.25,1800,14722,1440,360,47.4874,-122.223
451000,5,3,2260,6508,1330,930,47.7508,-122.322
206000,2,1,810,7158,810,0,47.4882,-122.325
590000,4,2.75,2240,5400,1540,700,47.5785,-122.402
695000,3,2.5,4560,17622,3800,760,47.621,-122.03
350000,3,1.5,1550,40752,1550,0,47.394,-122.202
1.2363E+06,5,3.5,3180,4628,2420,760,47.6423,-122.394
395000,6,2.25,2950,11200,1700,1250,47.7476,-122.087
419000,5,3,2190,9652,2190,0,47.5049,-122.239
592350,2,2,1570,4665,1570,0,47.709,-122.017
855000,5,3.25,3420,5669,2620,800,47.5366,-122.067
771000,4,2.5,2420,7200,2420,0,47.6893,-122.197
325000,3,2.25,1570,43350,1570,0,47.2377,-122.016
1.85E+06,5,3.25,3680,6060,2630,1050,47.6341,-122.304
545000,4,1.75,1910,6731,1210,700,47.5693,-122.391
615000,3,1.75,1780,5175,990,790,47.5696,-122.386
625500,2,1,2160,7439,1300,860,47.6981,-122.286
232000,3,1.5,1460,15000,1460,0,47.3182,-122.271
168000,3,1.5,1370,7439,1370,0,47.4499,-122.189
238000,3,1.5,1370,7439,1370,0,47.4499,-122.189
260000,3,2.5,1500,7401,1500,0,47.2625,-122.221
460000,3,1.75,1210,7500,1210,0,47.5294,-122.033
900000,3,2.5,2850,11535,1680,1170,47.748,-122.288
289950,3,1,1090,8280,1090,0,47.7562,-122.318
265000,3,1.75,1450,5858,1450,0,47.3482,-122.037
465000,4,2.25,1820,20349,1340,480,47.7415,-122.096
370000,3,1.5,1320,7201,1320,0,47.7126,-122.211
240000,2,1.5,1670,9880,1670,0,47.4864,-122.348
232000,4,2,1440,5911,1440,0,47.5072,-122.181
237502,3,1,980,7560,980,0,47.5256,-122.375
1.28E+06,4,3.5,4340,5500,2850,1490,47.6427,-122.397
957000,4,2.25,2860,11545,1430,1430,47.588,-122.168
218000,3,1.5,1140,4875,1140,0,47.3684,-122.08
205000,3,1.5,1120,8366,1120,0,47.3632,-122.11
350000,3,3.25,1460,1592,1130,330,47.5481,-122.374
256000,4,2.5,2050,5787,2050,0,47.3527,-122.315
275000,3,1,1250,7654,1000,250,47.7289,-122.291
372000,4,2.5,2520,9604,2520,0,47.3893,-122.216
688888,3,3.25,2580,9825,1760,820,47.5314,-122.054
170000,2,1,1200,24792,1200,0,47.6337,-121.961
530000,5,2.25,2140,7910,1070,1070,47.6071,-122.137
905000,4,3.25,3440,7661,3440,0,47.5429,-121.995
365000,4,2.5,1800,5070,1080,720,47.5303,-122.28
312000,4,2.5,1790,10584,1290,500,47.4061,-122.188
400000,2,1.75,1250,7680,1250,0,47.5242,-122.371
278750,2,2,800,5765,800,0,47.7024,-122.346
510000,3,2,1410,11995,1410,0,47.5718,-122.127
527700,2,2.25,1330,806,1330,0,47.6904,-122.395
740000,4,2.75,2890,4000,2190,700,47.6419,-122.351
512000,4,2.5,2550,17209,2550,0,47.4836,-122.136
362000,5,2.5,2880,8216,2880,0,47.3747,-122.185
225000,3,1,660,6600,660,0,47.4842,-122.33
491500,3,2.25,1470,4322,1470,0,47.5672,-122.018
429950,4,1.75,1700,10230,1320,380,47.7453,-122.351
375000,3,1,1040,9800,1040,0,47.5765,-122.155
199400,2,1,880,4000,880,0,47.5331,-122.352
364900,4,2.5,2490,9346,2490,0,47.3831,-122.147
324950,3,1.5,1210,7560,1210,0,47.5255,-122.374
467000,5,2,2080,4000,1040,1040,47.5858,-122.308
380000,3,1,1380,5400,1380,0,47.7134,-122.288
250000,3,2.25,1620,10850,1620,0,47.4437,-122.194
700000,4,1,1680,4021,1680,0,47.6663,-122.332
206990,3,1,1330,9620,1330,0,47.3174,-122.127
670000,3,1.75,1730,3400,970,760,47.6662,-122.364
315000,2,1,790,6969,790,0,47.6978,-122.164
319950,3,2.5,2240,7500,2240,0,47.265,-122.22
419000,3,1.5,1500,8272,1500,0,47.7741,-122.38
205000,3,2,1800,11419,1800,0,47.2623,-122.217
335000,4,2.5,1980,4745,1980,0,47.3495,-122.04
397000,3,1.75,1340,5100,1340,0,47.694,-122.348
370000,2,1,750,2020,750,0,47.6175,-122.301
330000,4,2.25,1790,9920,1170,620,47.5126,-122.149
1.785E+06,4,3.5,5490,14300,2910,2580,47.5511,-122.114
399000,3,2,1940,16300,1140,800,47.774,-122.283
400000,4,1.75,2670,189486,2670,0,47.2585,-122.061
249900,3,2,1220,6404,1220,0,47.3523,-122.059
717000,3,1.5,1310,3880,1090,220,47.6821,-122.392
319000,4,2.5,1930,8336,1930,0,47.4016,-122.166
635000,4,3,2100,3800,2100,0,47.6807,-122.291
355000,3,1,1180,7573,1180,0,47.7372,-122.294
1.6E+06,5,3.25,4320,32840,4320,0,47.5461,-122.122
585000,4,1.75,3140,12519,2320,820,47.6941,-122.173
320000,3,2,2320,7800,1160,1160,47.5141,-122.316
305495,3,1.75,2110,10200,2110,0,47.4744,-122.154
240000,4,2,1790,14690,1670,120,47.3965,-122.321
199950,5,2.5,1740,8750,1740,0,47.3904,-122.299
1.62E+06,4,3.25,3820,8114,3820,0,47.5837,-122.194
770000,3,3.5,2050,21744,1750,300,47.4536,-122.376
255000,4,2.25,1680,3179,1680,0,47.3258,-122.186
289000,4,2.25,1930,8925,1930,0,47.4501,-122.128
494500,4,3,3760,8804,2470,1290,47.5161,-122.191
746000,3,2.25,2370,9619,1650,720,47.6366,-122.099
385000,4,3,2120,13000,2120,0,47.4745,-122.141
688100,4,2.5,2370,10513,2370,0,47.6915,-122.099
870300,4,2.5,2350,3150,1690,660,47.6605,-122.335
310000,3,1,1180,8474,1180,0,47.7416,-122.327
500000,3,2.5,2270,5654,2270,0,47.7733,-122.351
255000,3,2.25,1830,7770,1400,430,47.3925,-122.161
1.475E+06,3,2.75,3910,7080,1970,1940,47.6324,-122.289
154500,3,1,890,9465,890,0,47.4388,-122.328
425000,3,2.25,1820,8058,1260,560,47.7241,-122.168
700000,4,2.5,2440,7491,2440,0,47.561,-122.019
410500,2,1,1110,3943,740,370,47.6436,-122.352
432000,3,2,1870,7080,1210,660,47.7244,-122.179
530000,3,1.5,1240,4080,1240,0,47.5745,-122.291
465000,3,2,1560,8640,1560,0,47.7294,-122.186
498688,3,2.5,1910,5600,1910,0,47.5752,-122.009
573500,3,1,2200,21450,1600,600,47.4527,-122.372
349900,4,2.75,2530,13474,2530,0,47.289,-122.344
220000,3,1,1130,12519,1130,0,47.4965,-122.176
260000,2,1,820,6771,820,0,47.52,-122.354
290000,2,1,960,4000,960,0,47.5554,-122.267
615000,4,1.5,1980,3240,1780,200,47.584,-122.294
730000,4,3.5,3370,5638,2250,1120,47.7196,-122.223
1.95E+06,4,3.25,7420,167869,7420,0,47.4548,-121.764
332500,3,2.25,1800,10500,1800,0,47.3879,-122.032
650000,5,3.5,3990,10120,2820,1170,47.741,-122.208
1.4E+06,4,2.5,4070,7800,3390,680,47.6838,-122.327
465000,4,1.75,1640,7194,1480,160,47.7649,-122.205
690000,4,3.25,3730,11820,2460,1270,47.5775,-122.019
289900,3,1.75,1220,7004,1220,0,47.4492,-122.157
1.62E+06,3,3.5,3490,4000,2570,920,47.6385,-122.281
339950,3,2.5,1730,4286,1730,0,47.432,-122.329
367999,4,2.75,3430,8000,3430,0,47.3183,-122.382
380000,4,2.5,2320,10079,2320,0,47.3828,-122.026
440000,3,1.75,2030,17100,2030,0,47.451,-122.365
975000,5,4,4850,36450,4850,0,47.6426,-122.158
309500,3,1.5,1340,13560,1340,0,47.741,-122.234
350000,3,1,1130,8201,1130,0,47.7359,-122.306
215000,2,2,1180,2521,1180,0,47.3487,-122.021
254000,2,1,910,6000,910,0,47.5253,-122.266
567000,3,1.75,1630,4275,1630,0,47.6851,-122.322
402000,2,1,710,1173,710,0,47.6412,-122.329
365000,4,1,1520,80150,1520,0,47.4742,-121.769
625000,4,2.5,2820,8408,2820,0,47.7538,-122.325
432000,4,1.75,1970,5160,1970,0,47.534,-122.373
335500,5,3,2240,19090,1700,540,47.4416,-122.149
672500,2,1.75,1860,5940,1020,840,47.5751,-122.407
336000,4,1,1780,4310,1780,0,47.5486,-122.278
294400,4,2.5,1788,10183,1788,0,47.2883,-122.218
541900,3,2.5,1880,3054,1880,0,47.6091,-122.147
505000,3,1.75,2300,11400,1520,780,47.6884,-122.128
255000,3,2.5,1610,6176,1610,0,47.3657,-122.173
435000,6,2.5,2270,11970,1470,800,47.7722,-122.204
636000,2,1.75,1230,3600,1230,0,47.6423,-122.361
655000,4,3.5,3420,33106,3420,0,47.3554,-121.986
280500,3,1.5,1670,6988,1370,300,47.4283,-122.323
520000,2,1,1120,6141,900,220,47.6924,-122.372
354000,4,2.5,2580,5476,2580,0,47.4042,-122.205
810000,5,2.75,3847,17654,2299,1548,47.3379,-122.322
400000,4,2.5,3630,42884,2300,1330,47.2617,-122.19
879900,4,2.75,3580,12000,1840,1740,47.6319,-122.05
1.288E+06,5,4,4050,11358,2780,1270,47.56,-122.225
902500,3,3.5,3240,23522,2130,1110,47.3388,-122.033
900000,3,1.75,1540,8400,1540,0,47.6187,-122.295
419500,4,2.5,2550,7200,2550,0,47.4793,-122.18
685000,4,2,2340,6000,1270,1070,47.6495,-122.401
429950,4,2.5,2320,4524,2320,0,47.4798,-122.136
464950,4,2.5,1640,6000,1640,0,47.559,-122.365
239900,2,1,910,9000,910,0,47.4463,-121.771
406250,4,3.25,2550,11524,2550,0,47.7324,-121.963
447000,4,2.5,2660,8027,2660,0,47.4831,-121.781
466800,3,2.5,1480,14250,1480,0,47.6595,-122.186
674000,4,2.5,2810,11560,1740,1070,47.5846,-122.12
525000,1,1,830,3200,830,0,47.6557,-122.348
674950,3,2.75,3510,92347,3510,0,47.3735,-122.018
374900,3,2.5,2480,4950,2480,0,47.4389,-122.116
1.44392E+06,4,3,3720,5000,2720,1000,47.6282,-122.322
559500,3,2.25,2150,9250,2150,0,47.7179,-122.113
522500,3,2.5,2370,7875,2370,0,47.5427,-121.863
1.13E+06,5,2.5,4310,28008,4310,0,47.6662,-122.056
498500,5,2.75,2990,7420,2990,0,47.4944,-122.162
571000,4,1,1350,4000,1350,0,47.6885,-122.386
543000,2,2,2370,217800,1600,770,47.5007,-122.088
271920,3,2,1410,10248,1410,0,47.3315,-122.265
104950,2,1,1170,8254,1170,0,47.497,-122.346
485500,4,2.5,1800,4500,1800,0,47.5998,-122.014
1.21E+06,4,2.75,3650,6982,2530,1120,47.6756,-122.275
260250,3,1.75,1490,8357,1490,0,47.3473,-122.037
875909,4,2.5,3610,13292,3610,0,47.5868,-121.974
455000,4,1.75,2050,94525,1250,800,47.4492,-122.084
309000,3,1,1092,7500,1092,0,47.5321,-122.354
229000,4,2.25,2010,7688,1170,840,47.3086,-122.396
250000,3,2,1680,7900,1680,0,47.3255,-122.305
600000,4,2,2510,38141,2510,0,47.7219,-122.258
535000,4,2.5,2280,65836,2280,0,47.7237,-122.076
571000,3,2.5,2510,5186,2510,0,47.6895,-122.041
1.03E+06,5,2.75,3190,16920,1690,1500,47.5641,-122.16
600000,4,3.25,4690,14930,3680,1010,47.7718,-122.283
469500,3,2.25,1850,12000,1300,550,47.7408,-122.101
1.15E+06,4,3,4160,13170,3040,1120,47.5182,-122.149
785000,4,1.5,2220,4000,1970,250,47.6564,-122.325
872750,3,2.5,2870,13695,2870,0,47.6944,-122.102
900000,4,2.75,3950,10214,2050,1900,47.6969,-122.384
350000,2,1.75,1740,6620,1740,0,47.526,-121.828
2.575E+06,5,3,4780,20440,3660,1120,47.6242,-122.239
940000,4,2.5,3160,39960,3160,0,47.6418,-122.157
185000,5,1.75,1990,27810,1990,0,47.3325,-122.35
850000,4,3.5,3920,37122,3920,0,47.6316,-121.988
201000,3,1,960,15273,960,0,47.238,-122.039
499000,2,1.5,1540,6549,1540,0,47.7189,-122.353
315000,4,2.5,1970,5190,1970,0,47.515,-122.164
509950,3,2.5,1880,4668,1880,0,47.5666,-121.999
286300,3,2.75,2000,6405,1260,740,47.5066,-122.259
590000,3,2.5,1990,8325,1310,680,47.705,-122.201
325000,4,1,1400,9384,1400,0,47.5166,-122.361
625000,4,2.5,3190,27806,3190,0,47.3425,-122.03
378000,3,1.5,1000,6914,1000,0,47.7144,-122.319
239950,3,1.75,1670,6900,1170,500,47.2975,-122.38
550000,4,2,2100,4500,1060,1040,47.6699,-122.317
325000,2,1,1010,6180,1010,0,47.5532,-122.28
831000,4,2.5,2030,3905,1630,400,47.6547,-122.34
249000,3,1,1090,10296,1090,0,47.7743,-122.26
484000,4,1.75,2440,16730,1390,1050,47.7406,-122.11
395000,4,3,2500,6278,2500,0,47.3325,-122.168
839900,4,2.5,3420,7462,3420,0,47.6388,-122.064
760000,4,2.5,2850,11000,2850,0,47.6759,-122.161
750000,4,1.5,2030,3300,1530,500,47.5855,-122.383
3E+06,5,3.75,4590,11265,3450,1140,47.6389,-122.288
440000,3,2.5,2230,5800,2230,0,47.5308,-121.847
501000,2,1.75,1810,7523,1170,640,47.5695,-122.087
739000,6,4.5,4000,7500,4000,0,47.6146,-122.306
685650,3,1.75,1490,16200,1490,0,47.5919,-122.175
1.005E+06,4,4.5,4225,284011,4225,0,47.6118,-122.024
980000,4,1.75,2120,4000,1920,200,47.6601,-122.275
275000,3,1.5,1030,7184,1030,0,47.5069,-122.189
319950,4,1.75,2310,8045,1650,660,47.4569,-122.165
448500,3,2.25,1830,7943,1830,0,47.7466,-122.249
437000,5,2,2120,137565,2120,0,47.4558,-122.507
330000,4,1.5,2500,9448,1250,1250,47.5212,-122.339
365000,3,2.5,2470,7700,2470,0,47.4096,-122.17
329000,2,1,940,7700,940,0,47.7067,-122.354
681500,5,2.75,3260,11700,1630,1630,47.6169,-122.104
566000,3,2.25,1660,10140,1370,290,47.6889,-122.128
897500,4,3,4370,217882,4370,0,47.6573,-122.034
738000,3,2.5,2620,9112,2620,0,47.6972,-122.116
185000,3,1.75,1500,7800,1500,0,47.3141,-122.192
445000,2,1,910,7200,830,80,47.5145,-122.39
175000,3,1.75,1430,4920,1430,0,47.5388,-122.275
315000,2,1,900,8556,760,140,47.5148,-122.386
445000,4,1.75,1250,7400,1250,0,47.62,-122.12
1.4E+06,5,3,3850,14990,2290,1560,47.6425,-122.218
832500,4,2.5,3450,35100,3450,0,47.7302,-122.106
771150,4,3.5,3950,12320,3950,0,47.5414,-121.869
225000,4,1.5,1950,12559,1950,0,47.4364,-122.282
389950,3,2.5,1700,6396,1700,0,47.5333,-121.87
435000,3,2.5,2370,6082,2370,0,47.5288,-121.846
845000,3,1.75,1600,2538,1600,0,47.6447,-122.327
1.3E+06,4,1.75,4060,5500,2660,1400,47.6437,-122.321
350000,3,2.25,1322,1796,1087,235,47.5976,-122.298
250000,3,1.75,1140,10400,1140,0,47.2598,-122.311
370000,2,1.5,1280,2096,1080,200,47.5872,-122.308
750000,4,2.5,3080,4553,3080,0,47.7066,-122.112
439950,2,1.75,1210,3000,910,300,47.6789,-122.365
395000,4,1.75,1950,10219,1950,0,47.7492,-122.336
375000,4,1,1450,6820,1450,0,47.7061,-122.347
263000,3,2.25,1590,7748,1590,0,47.2857,-122.3
185000,3,1,1240,9198,1240,0,47.37,-122.297
500000,3,1,1440,54315,790,650,47.591,-122.01
920000,4,2.5,3470,10045,3470,0,47.554,-122.095
936000,7,3.75,5100,21802,3640,1460,47.595,-122.04
1.5E+06,3,1.75,2430,12757,1340,1090,47.6201,-122.209
1.1E+06,3,2.25,2420,7200,1420,1000,47.6867,-122.275
247000,3,2.5,1510,10875,1150,360,47.3482,-122.3
289500,3,1,1200,5525,1200,0,47.6981,-122.325
432500,3,2.5,2240,6396,2240,0,47.5356,-121.881
680000,3,1.75,1870,4320,970,900,47.6663,-122.357
589000,3,1,1110,6000,1110,0,47.6496,-122.403
756450,4,2,3210,8400,2040,1170,47.5322,-122.391
536650,3,1.75,2090,8910,1230,860,47.7149,-122.222
540000,3,2.25,1320,1800,1320,0,47.6081,-122.289
385000,3,1.75,1340,3850,1340,0,47.7134,-122.292
485000,3,1,1020,6120,1020,0,47.6787,-122.285
240000,3,2,1220,17652,1220,0,47.4712,-122.1
415500,3,2,1220,17652,1220,0,47.4712,-122.1
550000,3,2,1390,2688,1390,0,47.6783,-122.366
1.26E+06,4,2,2970,5400,2970,0,47.6235,-122.309
430000,2,2,1440,213008,1440,0,47.3604,-122.457
415000,2,1.75,1550,4257,830,720,47.5274,-122.384
365000,4,2.5,1904,8200,1904,0,47.3107,-122.001
257000,4,1.5,1400,8500,1400,0,47.3314,-122.275
420000,3,2.5,2140,3821,2140,0,47.5541,-121.995
338995,3,1.75,1320,9450,1320,0,47.4557,-122.348
615000,3,1.75,2620,8280,1330,1290,47.7235,-122.359
312500,4,0.5,2300,5570,2300,0,47.3285,-122.168
513000,4,2.5,2000,5684,2000,0,47.7443,-122.22
857500,4,2.75,2960,5040,2210,750,47.5747,-122.408
1.06E+06,3,2.75,2700,22343,2700,0,47.5706,-122.209
585000,3,1.75,1740,9500,1150,590,47.4919,-122.365
350500,2,2.5,1770,4950,1770,0,47.3497,-122.025
215000,3,2,1290,9312,1290,0,47.4811,-122.325
440000,4,2,1450,8400,1450,0,47.7285,-122.24
270000,3,2.25,1420,7800,1130,290,47.3598,-122.157
385000,3,0.75,1330,7020,1330,0,47.5377,-122.376
688500,3,1.75,1760,4125,1760,0,47.6748,-122.352
700000,3,1.75,2010,4905,1230,780,47.6105,-122.309
585000,5,2,2560,14467,1280,1280,47.5547,-122.178
401000,2,1.5,1260,2625,1260,0,47.6747,-122.151
655000,4,2.25,2420,7725,1890,530,47.6287,-122.093
317000,3,1,1010,5400,1010,0,47.5746,-122.293
500000,4,2.5,1770,8155,1770,0,47.719,-122.173
314963,2,1,890,6350,890,0,47.6975,-122.357
715000,3,1.5,1670,5060,1670,0,47.5671,-122.379
280000,3,2.25,1360,9600,1360,0,47.4687,-121.749
531000,3,2.5,2120,9736,2120,0,47.7374,-122.219
617000,3,2.5,1910,4488,1910,0,47.6176,-122.14
440000,4,1,1480,7560,1480,0,47.7079,-122.358
140000,3,1,1090,10114,1090,0,47.2975,-122.223
661000,4,1.75,1670,13125,1670,0,47.6315,-122.101
697000,4,1.75,1670,13125,1670,0,47.6315,-122.101
1.195E+06,5,2.75,3650,13297,2750,900,47.5497,-122.228
535000,4,2,1970,3515,1030,940,47.6873,-122.314
404500,2,2,1320,3060,1320,0,47.5643,-122.284
396500,3,1,1710,5110,1100,610,47.5256,-122.379
450000,3,2.25,1740,9488,1180,560,47.5339,-122.174
605000,3,3.25,2200,2400,1740,460,47.6325,-122.371
699000,3,2,2010,4320,2010,0,47.5153,-122.256
805000,3,3,3910,19023,3910,0,47.6953,-121.914
156000,1,0.75,470,15000,470,0,47.6554,-121.908
595000,4,2.5,2330,7064,1780,550,47.6955,-122.097
285000,3,1.75,1930,7200,1930,0,47.5263,-121.809
725000,4,2.5,3270,6055,3270,0,47.5374,-122.192
216300,3,2.5,1650,5000,1650,0,47.3206,-122.394
410000,4,2.75,2220,8450,1260,960,47.4804,-122.157
597000,2,1.75,2470,4600,1140,1330,47.5599,-122.378
325000,3,1,1300,9300,1300,0,47.7562,-122.073
355000,5,2.75,2530,9375,1530,1000,47.3738,-122.214
338000,3,1.5,2400,8215,1200,1200,47.5001,-122.338
210000,4,2.25,1500,5393,1500,0,47.3378,-122.263
423000,4,1.75,1700,9000,1700,0,47.7308,-122.18
249500,4,1.5,2120,8554,1170,950,47.2933,-122.195
325000,4,2.5,2240,5105,2240,0,47.3922,-122.165
257000,3,1.75,1540,8223,1070,470,47.3666,-122.089
550000,3,1.75,1890,100623,1890,0,47.6454,-121.978
490000,3,1,1260,9638,1260,0,47.6773,-122.178
299000,2,1.5,1160,3838,1160,0,47.7255,-122.164
295000,2,1,1300,39639,1300,0,47.466,-122.452
630000,4,2.5,3220,14463,3220,0,47.6261,-122.047
320000,4,1.5,2020,8474,1010,1010,47.4579,-122.17
1.11E+06,4,2.5,2990,8640,2100,890,47.5932,-122.172
398000,4,1,1420,6458,1420,0,47.6988,-122.358
218000,3,1,1020,7874,1020,0,47.5175,-122.346
590000,4,2.75,2400,104108,2400,0,47.4686,-121.989
1.595E+06,5,3,3640,8239,2540,1100,47.5842,-122.111
348500,2,2.25,1550,1824,1550,0,47.5396,-122.368
592500,2,2,1870,4751,1870,0,47.7082,-122.015
505000,3,2.5,2340,5957,2340,0,47.7347,-122.236
1.43E+06,5,4.25,3350,3600,2260,1090,47.6351,-122.364
502000,3,1,1710,5000,1140,570,47.5719,-122.385
257500,2,2,1180,9265,1180,0,47.7252,-122.297
405000,3,1.5,1600,7500,1600,0,47.721,-122.182
427000,3,1.75,1300,5111,1300,0,47.7005,-122.314
290000,3,1.5,1040,9997,1040,0,47.7583,-122.302
222000,3,1,1220,7695,1220,0,47.5191,-122.339
315000,3,2.5,2240,6097,2240,0,47.3503,-122.042
371000,3,1.5,1420,4500,1420,0,47.694,-122.332
279900,3,1.75,1580,6620,1580,0,47.2798,-122.303
250000,3,1.5,2390,23522,1890,500,47.4754,-122.09
599000,4,2.25,2260,29930,1400,860,47.5689,-122.126
267300,3,1.75,1890,93218,1890,0,47.2568,-122.07
585000,2,1.75,1830,7200,1070,760,47.5592,-122.273
350000,3,1.75,1000,8268,1000,0,47.7417,-122.172
506000,3,1.75,2180,7700,1480,700,47.7594,-122.361
400000,6,2,2320,210830,2320,0,47.398,-122.081
151100,3,1,840,4495,840,0,47.496,-122.349
251000,3,1,840,4495,840,0,47.496,-122.349
555000,4,2.25,2350,8140,1430,920,47.5579,-122.129
467500,3,1.75,2040,273556,2040,0,47.4361,-122.469
479000,4,2.5,2370,30378,2370,0,47.3389,-122.066
247000,5,2,1590,9350,1060,530,47.3398,-122.286
299500,3,1,1380,10875,1380,0,47.4653,-121.745
306888,4,1.5,1940,8970,1270,670,47.7297,-122.326
675000,4,2.5,3320,244807,3320,0,47.3637,-121.955
577000,2,1,1090,5265,1090,0,47.6638,-122.292
219950,3,1.5,1650,9936,1090,560,47.3285,-122.328
375000,3,1.5,1110,5500,1110,0,47.6717,-122.184
650000,4,2.5,2110,6820,1530,580,47.6882,-122.306
975000,3,3,1850,5000,1850,0,47.6711,-122.386
229000,1,1,600,3720,600,0,47.5558,-122.363
575000,5,2.5,2760,4000,1730,1030,47.6074,-122.299
815000,4,1.75,2970,14880,1560,1410,47.5907,-122.086
525000,3,1.75,2300,43560,1350,950,47.7716,-122.101
471000,3,2.5,2030,2805,1720,310,47.5305,-122.047
450000,4,1.75,2160,4333,1260,900,47.6893,-122.388
590000,3,2,1650,6150,1650,0,47.5713,-122.394
744000,4,2.5,3140,7260,2200,940,47.5664,-122.124
460000,4,2.25,2690,36114,2690,0,47.3106,-122.116
299000,5,2.5,1940,9389,1290,650,47.7438,-122.328
231000,4,1,1220,5120,1220,0,47.205,-121.996
195000,3,1,1300,9600,1300,0,47.3037,-122.107
305000,3,1.75,1660,11500,1130,530,47.4473,-121.774
895000,4,1.5,3390,6200,2530,860,47.58,-122.29
1.11E+06,4,1.5,2310,13300,1890,420,47.6232,-122.21
339000,2,1,950,7954,950,0,47.557,-122.306
885000,4,3.75,2400,3520,1370,1030,47.6295,-122.346
375000,3,1,1780,5236,1050,730,47.5119,-122.386
367400,4,1.5,1280,7400,1280,0,47.6023,-122.123
700000,4,2,1930,5398,1430,500,47.646,-122.363
667000,5,2.25,2560,10360,1870,690,47.5819,-122.126
200000,2,1,920,5250,920,0,47.5177,-122.266
552775,3,2.5,1900,18414,1900,0,47.6326,-122.015
452000,3,2,2270,148975,1270,1000,47.5092,-122.195
418000,3,2.5,2080,16050,1360,720,47.4694,-122.069
601500,3,1.75,1460,10128,1460,0,47.6709,-122.167
600000,3,1.75,1670,39639,1670,0,47.5929,-121.989
340000,4,2.5,2810,6481,2810,0,47.333,-122.172
310000,3,2.5,2370,6752,2370,0,47.2703,-122.312
290000,2,1.75,1700,18000,1700,0,47.5066,-122.194
438000,2,1,1630,9255,1630,0,47.7222,-122.332
718000,4,2.75,2930,4408,1660,1270,47.5841,-122.295
200000,2,1,860,6600,860,0,47.4878,-122.324
479900,3,2,1980,12150,1980,0,47.3657,-122.152
400000,3,2.5,2080,7877,2080,0,47.4395,-122.151
219950,3,1,1060,10042,1060,0,47.4434,-122.283
300000,3,2.5,1590,3381,1590,0,47.7344,-121.986
437000,3,2.25,1980,8775,1290,690,47.7753,-122.359
350000,4,2,1720,7210,860,860,47.7307,-122.239
626000,4,1.75,1350,9293,1350,0,47.6335,-122.196
490000,3,2.5,2080,12032,2080,0,47.7455,-122.073
289000,3,2.5,2090,4700,2090,0,47.3724,-122.104
595000,3,2.5,2030,5100,2030,0,47.6594,-122.397
676000,3,2.25,2680,41804,2680,0,47.4828,-121.73
389000,3,1.75,1820,8028,1220,600,47.7466,-122.355
240000,3,2,1300,5000,1300,0,47.3837,-122.304
382500,4,2.5,2210,7079,2210,0,47.4206,-122.183
511555,3,2,1400,7293,1400,0,47.586,-122.12
710500,3,1.75,2040,4125,1540,500,47.6608,-122.359
429000,3,2.5,2420,49928,1860,560,47.463,-122.008
170000,4,1.75,1920,7500,1920,0,47.4222,-122.318
2.135E+06,4,3.25,3860,17820,2630,1230,47.6224,-122.215
480000,5,2.75,2760,7200,1430,1330,47.7563,-122.147
1.665E+06,4,3.75,3450,8395,2640,810,47.6134,-122.282
225000,3,1,1040,6535,1040,0,47.4906,-122.306
615000,3,1.75,2220,7224,2040,180,47.774,-122.384
438950,4,2.5,2470,385506,2470,0,47.2396,-121.993
242000,3,1.75,1300,9856,1300,0,47.3448,-122.298
560000,3,2.5,1960,9686,1460,500,47.6339,-122.026
857500,3,1.5,2040,3960,2040,0,47.6658,-122.355
685000,4,2.5,3030,7864,3030,0,47.6075,-122.017
486000,4,3,2260,7336,2260,0,47.7297,-122.219
749000,3,2.5,2670,10338,2670,0,47.6599,-122.146
260000,3,2.5,1520,6298,1520,0,47.3687,-122.182
1.015E+06,3,1.75,3610,8502,2610,1000,47.583,-122.379
565000,3,1.75,1130,5111,930,200,47.6379,-122.4
355000,3,2,1480,2502,1480,0,47.6969,-122.338
775000,5,2,3540,9970,3540,0,47.7108,-122.277
335000,4,2.25,2100,7305,1050,1050,47.4676,-122.296
1.3E+06,5,4,3366,7800,2966,400,47.6466,-122.391
545000,3,1.75,1810,3000,1810,0,47.6599,-122.363
540000,3,1.75,1680,4240,1680,0,47.5745,-122.311
687500,3,1.75,2450,9377,1540,910,47.7296,-122.284
115000,1,2,1150,9812,1150,0,47.2951,-122.284
227000,1,2,1150,9812,1150,0,47.2951,-122.284
870000,4,2.5,3240,7621,3240,0,47.5641,-122.032
1.19E+06,4,2.5,3480,12164,3480,0,47.6404,-122.171
375000,4,2.5,2800,5000,2800,0,47.3596,-122.036
902000,3,2.75,3240,7200,1620,1620,47.567,-122.273
269500,2,1.5,1480,7276,940,540,47.4942,-122.166
570000,3,1,1700,4750,1200,500,47.6819,-122.389
359950,2,1,1240,7590,1040,200,47.7061,-122.34
1.45E+06,4,3.5,3720,8301,2880,840,47.5885,-122.199
615000,3,2.5,1910,3427,1910,0,47.6324,-122.11
250000,4,2,2120,8701,2120,0,47.3722,-122.308
530000,4,2.5,3020,6788,3020,0,47.5346,-121.881
474950,3,2,2250,222156,2250,0,47.542,-121.792
490000,4,2,1650,6480,1650,0,47.7117,-122.286
210000,2,1.5,880,1157,880,0,47.5188,-122.376
265500,3,1,1860,9225,1860,0,47.3904,-122.3
1.4625E+06,5,3.25,3840,4800,2750,1090,47.5929,-122.29
310000,4,2.25,2192,12128,2192,0,47.3644,-122.2
324500,3,2.5,1590,4108,1590,0,47.4832,-122.181
599000,4,4.75,3700,11000,1840,1860,47.768,-122.251
525000,4,2.5,3670,9958,3670,0,47.4617,-122.159
400000,3,1,1630,10304,1630,0,47.7548,-122.317
887500,3,3,4230,54977,3780,450,47.4176,-122.343
344000,2,1,1060,3325,770,290,47.6896,-122.307
525000,3,2.5,2700,7434,2700,0,47.7434,-122.174
385000,3,2.25,2110,8000,2110,0,47.7311,-122.204
820000,4,2.5,3720,8633,3720,0,47.6085,-122.013
1.305E+06,4,3.5,3440,5000,2560,880,47.6672,-122.409
549000,4,2.25,2420,59800,1350,1070,47.6206,-122.056
180000,3,1,1090,6771,1090,0,47.5177,-122.353
589000,4,2.5,2910,5776,2910,0,47.5388,-121.87
350000,3,1,1050,5518,1050,0,47.5564,-122.278
197400,3,2,1610,7575,1110,500,47.334,-122.3
267000,3,2.5,1760,6477,1760,0,47.3731,-122.172
480000,3,1.5,1540,20281,1540,0,47.5817,-122.007
650000,4,2.5,2580,9450,1660,920,47.703,-122.28
600000,2,1,1370,5000,1370,0,47.6744,-122.383
490000,2,1.75,1440,6265,1440,0,47.7028,-122.013
225000,3,1,1410,7700,980,430,47.4577,-122.171
640000,3,2.25,1980,10115,1980,0,47.6384,-122.174
710000,3,3.5,2440,3427,1990,450,47.589,-122.165
325000,3,2,1350,11805,1350,0,47.7313,-121.971
595000,3,3.25,3130,28001,2210,920,47.7741,-122.122
128750,3,1,880,7004,880,0,47.3019,-122.216
465000,3,2.25,1920,7300,1240,680,47.6078,-122.128
710000,4,1.75,2700,7625,1450,1250,47.6838,-122.323
605000,4,2.75,1670,6000,840,830,47.5496,-122.385
994000,4,2.5,3470,20445,3470,0,47.547,-122.219
489950,3,2.25,1820,7326,1820,0,47.7133,-122.217
365000,3,1.5,1310,8160,1310,0,47.7291,-122.339
359950,3,2,1790,7212,1790,0,47.3898,-122.154
495000,4,2.5,2460,4774,2460,0,47.4912,-122.145
255000,3,1.5,1060,9039,1060,0,47.4293,-122.151
330000,3,1.75,1340,10276,1340,0,47.7207,-122.222
450000,3,1.75,1480,8394,1480,0,47.6634,-122.144
655000,4,2.5,3500,11306,3500,0,47.5428,-121.861
485000,4,2.75,2910,16362,2120,790,47.3397,-122.322
375000,4,1.75,1940,15909,970,970,47.7578,-122.094
570000,4,2.5,2280,4534,2280,0,47.5902,-122.018
350000,3,2.25,1190,1022,1190,0,47.6972,-122.349
550000,3,1,1260,6000,1260,0,47.5058,-122.384
513000,5,2,2270,8652,1150,1120,47.6692,-122.151
450000,4,2.25,1990,7320,1030,960,47.5237,-122.376
432500,4,1.75,1500,1856,750,750,47.5917,-122.296
432000,5,2.75,2060,329903,2060,0,47.1776,-121.944
480000,3,2.25,1950,8892,1950,0,47.7213,-122.11
402200,3,1.75,1790,6980,1330,460,47.7311,-122.226
650000,3,1,1520,10227,1520,0,47.5872,-122.196
1.1995E+06,4,2.5,3240,13044,3240,0,47.5825,-122.242
312000,3,2,2440,13250,1440,1000,47.375,-122.227
610000,4,2,2220,5821,1380,840,47.5723,-122.382
823000,5,1.75,2640,7722,1650,990,47.6802,-122.361
471000,4,1.75,1450,3750,950,500,47.6706,-122.3
481015,3,2.25,1550,5511,1550,0,47.6946,-122.185
1.959E+06,5,4.5,6200,23373,5050,1150,47.5632,-122.215
624000,4,3.25,2810,11250,1680,1130,47.692,-122.099
480000,4,2.5,2080,7966,1200,880,47.7393,-122.181
815000,3,1.5,1370,8671,1370,0,47.6217,-122.198
1.65E+06,4,2.25,2920,20400,2920,0,47.6237,-122.228
180000,3,1,1000,18513,1000,0,47.5118,-122.348
156601,2,1.75,1210,9750,1210,0,47.3438,-122.037
374950,4,2.5,2790,4650,2790,0,47.3557,-122.026
368000,2,1.5,1660,4680,830,830,47.5134,-122.388
550000,3,2,1650,3952,1650,0,47.6727,-122.33
198000,3,1.75,1300,6318,1300,0,47.2752,-122.251
345000,3,1.75,1090,7200,1090,0,47.7227,-122.179
1.71275E+06,5,2.5,2660,6572,1960,700,47.6176,-122.223
185900,3,1,940,10890,940,0,47.2763,-122.257
950000,3,2.75,2750,18029,1810,940,47.5617,-122.134
995000,4,4.5,3850,13551,3000,850,47.5522,-122.103
345000,2,1,860,8250,860,0,47.7132,-122.334
741000,4,2.75,2070,10125,1390,680,47.5697,-122.219
737000,2,2.25,2290,9772,2290,0,47.7199,-122.025
668750,4,2.5,2340,6420,1590,750,47.7728,-122.386
575000,3,1.75,2680,8625,1590,1090,47.5316,-122.056
280000,4,2,1710,5440,1030,680,47.366,-122.093
583000,3,1.5,1800,10050,1800,0,47.6344,-122.126
196000,3,2.25,1510,9600,1090,420,47.7758,-122.238
349950,3,2.5,1700,7496,1700,0,47.432,-122.189
429000,4,1,1350,3333,1350,0,47.6727,-122.397
270000,5,2.5,2140,10320,1330,810,47.3927,-122.194
385000,6,4,2700,7416,1350,1350,47.5525,-122.3
535000,1,1,920,5000,920,0,47.6748,-122.352
352500,3,1.75,1500,10269,1030,470,47.7672,-122.348
624000,3,1.75,1510,5200,860,650,47.6864,-122.365
215000,5,1.5,1980,7958,1980,0,47.4571,-122.17
870000,4,3,4500,21780,3040,1460,47.5581,-122.213
440000,4,2.5,3220,8256,2610,610,47.495,-122.155
518000,2,1.5,1140,1149,940,200,47.6124,-122.314
259500,3,2.25,1490,7589,1490,0,47.3474,-122.037
795127,4,3.25,4360,91158,3360,1000,47.6398,-121.985
290000,3,1,960,9000,960,0,47.5765,-122.154
385000,4,3,2253,7700,2253,0,47.3935,-122.3
259950,2,1,770,6542,770,0,47.747,-122.301
330000,2,2.5,1310,2915,1310,0,47.4911,-122.154
280000,3,1,980,7480,830,150,47.5206,-122.363
595000,4,2.5,1820,20011,1820,0,47.5842,-122.045
925900,4,3.75,3980,7828,3980,0,47.6303,-122.065
499000,3,2.25,3010,9600,2410,600,47.7671,-122.263
325000,4,2.5,1830,7762,1830,0,47.267,-122.31
895000,5,2.5,2550,20875,1610,940,47.6336,-122.192
162248,2,1,800,8960,800,0,47.4756,-122.174
1.0725E+06,3,2.25,2890,21480,1790,1100,47.5027,-122.381
430000,3,1.5,1810,5080,1030,780,47.6819,-122.287
615500,3,1.5,1810,5080,1030,780,47.6819,-122.287
260000,3,1,940,5650,940,0,47.5551,-122.292
295000,4,2,1810,42981,1810,0,47.5597,-121.85
1.18604E+06,3,1.75,2550,6117,1650,900,47.6109,-122.285
749950,4,2.5,2370,2971,2080,290,47.7064,-122.224
175000,6,1,1370,5080,1120,250,47.5238,-122.35
415000,6,1,1370,5080,1120,250,47.5238,-122.35
190000,3,1,1200,8316,1200,0,47.3231,-122.215
625000,3,1.75,2100,3264,1350,750,47.6702,-122.364
420000,3,2.25,2020,21010,2020,0,47.6988,-121.915
339900,4,1.5,1570,9210,1400,170,47.3864,-122.22
160000,2,1,1140,23030,1140,0,47.7637,-122.266
353000,4,2.5,1830,5331,1830,0,47.3557,-122.016
390000,3,2,1010,14183,1010,0,47.6232,-122.043
675000,4,2.5,1770,9858,1770,0,47.7382,-122.287
400000,3,2.5,2120,3757,2120,0,47.4787,-122.128
1.34E+06,4,3.5,3190,5040,2160,1030,47.5928,-122.29
1.65E+06,4,2.5,2780,11904,1730,1050,47.6209,-122.216
1E+06,5,3,3350,9450,2180,1170,47.6705,-122.34
850000,5,3.5,3450,28324,2350,1100,47.6991,-122.196
275000,3,1.5,1060,6954,1060,0,47.5498,-122.355
450000,3,2.5,1670,2589,1670,0,47.5314,-122.047
305000,4,1.75,2251,12731,1390,861,47.3369,-122.32
643002,3,2.5,1770,3744,1270,500,47.6807,-122.364
468000,2,1.75,1510,4500,1510,0,47.6644,-122.13
324950,4,2.5,1770,5000,1770,0,47.3506,-122.006
290000,3,2,1260,7346,1260,0,47.4034,-122.176
488500,3,2,1710,10959,1030,680,47.697,-122.199
367950,3,1.75,2290,8234,1250,1040,47.7611,-122.351
285000,2,1,790,6555,790,0,47.5015,-122.35
417000,3,2.75,1820,52889,1820,0,47.501,-122.463
1.115E+06,4,2.5,3180,31931,2390,790,47.6388,-122.149
1.55E+06,4,4,5280,17677,3220,2060,47.5323,-122.238
604000,3,2.5,3240,33151,3240,0,47.3256,-122.378
380000,3,2.5,2390,8102,2390,0,47.4378,-122.16
336500,4,2.5,2500,5264,2500,0,47.3853,-122.028
685000,4,2,2290,6000,2290,0,47.6807,-122.318
4.208E+06,5,6,7440,21540,5550,1890,47.5692,-122.189
670000,3,1,1600,16868,990,610,47.5872,-122.241
524000,2,1,1120,2000,1120,0,47.6454,-122.354
172000,3,1,1340,10260,1340,0,47.3173,-122.317
680000,6,2,1670,3000,900,770,47.6637,-122.316
549900,4,3,2830,213879,2830,0,47.2925,-122.107
357000,4,2.75,2700,49428,2700,0,47.3168,-122.079
107000,3,1.5,910,5120,910,0,47.5238,-122.356
232900,3,1.5,910,5120,910,0,47.5238,-122.356
800000,4,3.5,2370,3302,1610,760,47.684,-122.341
248500,2,1.5,880,1498,880,0,47.7063,-122.342
670000,3,2.5,2050,6420,1730,320,47.5708,-122.405
207000,3,1.75,1180,21275,1180,0,47.4018,-122.037
164000,3,1,1070,8250,1070,0,47.2899,-122.192
570500,2,1,1380,1800,1080,300,47.6416,-122.361
599990,3,2.25,2680,9162,1570,1110,47.5683,-122.091
395000,5,1.75,2100,9599,1060,1040,47.7097,-122.216
979500,4,3.75,4133,361548,4133,0,47.7479,-121.972
207000,3,1,920,5546,920,0,47.7114,-122.284
237000,3,1,920,5546,920,0,47.7114,-122.284
650100,2,1,1750,60872,1180,570,47.5946,-122.006
385000,4,2.5,1950,7350,1150,800,47.656,-122.134
335000,2,1.75,1660,11437,1660,0,47.4899,-122.339
347000,4,1.5,2670,10026,2670,0,47.2659,-122.215
204000,3,1,980,8000,980,0,47.42,-122.317
615000,4,2.25,1780,10260,1780,0,47.6647,-122.142
943500,3,2.25,2370,10890,2370,0,47.5827,-122.197
560000,3,2,1640,7333,1020,620,47.5636,-122.316
547500,4,2.5,2610,7254,1610,1000,47.5618,-122.176
359500,4,1.75,2030,7210,1450,580,47.5067,-122.164
660000,3,2.5,2590,35640,2590,0,47.5516,-122.03
258000,3,1.75,1620,7540,1310,310,47.3635,-122.052
355000,3,1.75,2040,22693,2040,0,47.3519,-122.14
253500,2,1,810,4800,810,0,47.5232,-122.375
422500,3,1,1270,8920,1270,0,47.534,-122.172
239000,2,2,1470,2052,1470,0,47.3086,-122.328
628000,3,2.25,1720,8521,1140,580,47.6882,-122.184
352000,2,2.5,1320,1957,660,660,47.5364,-122.365
311600,3,2.25,1358,1196,1358,0,47.7052,-122.346
235000,4,1.5,2070,7245,1060,1010,47.3417,-122.281
870000,5,2.25,2910,9525,2910,0,47.5633,-122.218
190848,4,1.5,1370,7904,900,470,47.3344,-122.28
570000,4,1.75,2340,5080,1170,1170,47.6746,-122.32
661254,4,4,2290,6250,1690,600,47.5824,-122.384
575000,4,2,1650,5000,1650,0,47.6781,-122.374
230000,2,0.75,650,5360,650,0,47.7281,-122.335
680000,3,2.25,2300,9914,2300,0,47.5677,-122.086
148000,1,1,620,8261,620,0,47.5138,-122.364
244900,1,1,620,8261,620,0,47.5138,-122.364
214950,3,1,1400,6600,1280,120,47.4845,-122.331
580000,3,1.5,1800,6250,1420,380,47.5778,-122.389
263000,3,1.5,1300,7885,1300,0,47.4556,-122.209
317000,5,2.5,2360,11375,1180,1180,47.4875,-122.255
302000,4,3,3320,13500,1750,1570,47.4596,-122.065
899000,3,1,1480,6978,1480,0,47.6497,-122.217
1.289E+06,3,2.5,2190,11394,1550,640,47.6685,-122.409
710000,3,3.25,3740,136915,3100,640,47.4549,-122.363
230000,3,1,1360,9310,1020,340,47.4901,-122.185
430000,3,1,1210,5200,1210,0,47.531,-122.373
1.169E+06,5,4.25,4610,13252,4610,0,47.5878,-121.969
397000,3,1,860,6380,860,0,47.6942,-122.315
595000,3,2.5,2250,8300,2250,0,47.7174,-122.308
485000,3,1.75,2030,10089,1330,700,47.5217,-122.05
755000,5,2.5,3260,24300,2310,950,47.7587,-122.274
185000,3,1,1840,8100,920,920,47.455,-122.35
340000,3,1,1840,8100,920,920,47.455,-122.35
236000,4,2.75,2000,5827,2000,0,47.3629,-122.026
550000,4,2.5,2810,7549,2810,0,47.7441,-122.173
680000,3,2,1780,5720,980,800,47.6794,-122.351
630000,4,2.5,2540,8706,2540,0,47.5855,-122.031
560000,3,2,2340,3477,1170,1170,47.54,-122.267
385000,3,2,1480,6600,740,740,47.5081,-122.385
280000,3,2.25,1358,1141,1358,0,47.7052,-122.346
225000,3,2.5,1750,7490,1180,570,47.3746,-122.149
610000,4,1.75,1830,29110,1230,600,47.5449,-122.215
592500,3,2,1170,6750,800,370,47.6752,-122.281
750000,4,2.75,3170,7634,3170,0,47.5774,-122.054
164000,4,1,1530,4875,1530,0,47.3638,-122.091
320000,2,1,1100,8281,1100,0,47.7414,-122.315
544000,4,2.5,2030,3974,2030,0,47.5692,-122.006
344950,3,1.75,1870,7500,1320,550,47.4428,-122.134
539500,3,2.5,3080,12476,3080,0,47.3752,-122.029
420000,4,1.75,2480,60548,1600,880,47.4722,-122.001
305000,2,1,910,22725,910,0,47.7712,-122.299
229000,2,1,810,5100,810,0,47.7317,-122.343
1.068E+06,5,3.5,3990,9938,3990,0,47.5198,-122.156
397500,3,2.25,1430,1383,1430,0,47.6917,-122.341
540000,4,2,2190,8402,2190,0,47.6944,-122.175
650000,4,2.5,2290,10186,2290,0,47.6353,-122.124
1.9E+06,6,4,3020,13237,2840,180,47.5924,-122.287
649000,2,1.75,2260,280962,1890,370,47.6359,-121.94
287500,5,2,2020,67953,1620,400,47.4891,-122.263
815000,4,2.75,2620,4743,1310,1310,47.6829,-122.4
795000,2,2.5,2830,8630,2830,0,47.6481,-122.081
502775,3,1.75,1700,9840,1200,500,47.5192,-122.046
222900,2,1,1110,6411,1110,0,47.4962,-122.242
399950,4,3,2150,64694,1450,700,47.3268,-122.388
728000,4,2.5,2650,13684,2650,0,47.6278,-122.108
850000,5,3.5,3870,65556,3870,0,47.6403,-121.992
525000,4,2.75,2530,17856,2530,0,47.7356,-121.959
257000,3,1,1450,7850,1450,0,47.4299,-122.199
433500,3,2.5,2200,3360,2200,0,47.5418,-122.287
314950,4,1.75,1890,9623,1290,600,47.2901,-122.279
500000,3,1.75,1530,14633,1100,430,47.6949,-122.119
300000,3,1.5,1590,8911,1590,0,47.7394,-122.252
645000,4,2.5,2690,18653,2690,0,47.6449,-122.059
222500,3,1,990,10125,990,0,47.3422,-122.089
275000,3,1.75,1300,8099,1080,220,47.5026,-122.172
498000,3,1.5,1720,6570,1720,0,47.5284,-122.265
800000,3,1.75,2080,75794,2080,0,47.7018,-122.189
297000,3,2.5,1840,8234,1840,0,47.267,-122.312
625000,5,3.5,4010,6000,2560,1450,47.4928,-122.229
770000,4,2.5,3560,6187,3560,0,47.5593,-122.016
517000,3,2.25,1640,4635,1540,100,47.6793,-122.319
238000,1,1,530,6350,530,0,47.6946,-122.357
234550,3,1,1990,15375,1140,850,47.4778,-122.288
230500,3,2.25,1690,7245,1160,530,47.3505,-122.305
585000,5,2.5,2670,16777,1620,1050,47.7015,-122.301
733000,4,1.75,1930,3876,1450,480,47.6604,-122.324
357950,2,1,810,3880,810,0,47.6631,-122.365
530000,3,1.75,1550,3680,1050,500,47.6817,-122.36
377500,4,2.5,2640,10720,2640,0,47.4485,-122.278
475000,4,2.5,2320,10046,2320,0,47.5406,-121.887
399000,3,1.75,2170,73616,2170,0,47.2881,-122.086
660000,3,2,2080,5750,1040,1040,47.5791,-122.392
400000,5,2.25,2070,10488,1080,990,47.6095,-122.122
440000,2,1,800,4850,800,0,47.6639,-122.364
366400,4,2.25,2040,14383,1270,770,47.3849,-122.163
627250,4,2.5,2830,10677,2830,0,47.742,-122.208
375950,3,1.75,1480,7560,1100,380,47.6985,-122.364
162000,3,2.25,1810,6750,1280,530,47.2976,-122.377
780000,3,2.75,1970,2600,1970,0,47.663,-122.335
705000,4,2.5,2650,4316,1520,1130,47.5866,-122.389
450000,4,2.5,2820,15233,1820,1000,47.3426,-122.321
311000,3,2.75,1400,7880,1000,400,47.5095,-122.193
485000,3,2.5,1580,6065,1580,0,47.5692,-122.021
485000,3,2.5,1800,11034,1800,0,47.7558,-122.142
725000,5,3.75,3360,6000,2640,720,47.558,-122.277
185000,3,1,1510,17040,1510,0,47.2649,-122.285
1.89E+06,4,4.25,4285,9345,4285,0,47.6332,-122.199
260000,3,2.25,1610,7423,1610,0,47.3713,-122.091
356000,4,2.5,2470,5074,2470,0,47.3457,-122.041
225205,3,1,1200,7220,1200,0,47.3746,-122.183
445000,3,1,1260,8910,1260,0,47.7,-122.375
356000,2,1,920,4095,920,0,47.5484,-122.278
760250,5,2.75,2540,8250,1440,1100,47.5875,-122.24
572000,2,2,1870,5143,1870,0,47.7142,-122.033
970000,3,2.25,3060,9950,1810,1250,47.579,-122.284
348450,4,2.5,1950,8628,1950,0,47.3817,-122.035
535500,3,1.5,1730,40250,1730,0,47.7499,-122.111
710000,5,2.5,2570,9600,1620,950,47.7216,-122.282
745000,3,1.75,1490,9800,1140,350,47.584,-122.198
355000,4,2.5,2040,8265,2040,0,47.4973,-122.341
333000,4,2.5,2690,5505,2690,0,47.3666,-122.119
282000,3,2.5,1610,6000,1610,0,47.349,-122.036
840500,3,2,2520,5400,1410,1110,47.6365,-122.361
432000,3,1.75,1550,8134,1550,0,47.6136,-122.121
625000,3,1,1800,4800,900,900,47.5672,-122.372
209977,3,1,1170,6134,1170,0,47.4941,-122.312
174000,2,1,900,13531,900,0,47.2616,-122.251
740000,4,2,2800,8540,1730,1070,47.6869,-122.126
518000,3,1.75,1830,4500,1830,0,47.676,-122.308
539000,3,1.75,1380,3225,940,440,47.6652,-122.338
575000,3,2.75,1990,9600,1530,460,47.532,-122.05
530000,2,1.75,1170,976,780,390,47.6192,-122.316
242025,4,1.75,1400,54014,1400,0,47.4153,-122.184
1.03E+06,4,2.5,2620,11200,1770,850,47.5876,-122.193
230000,3,1,880,7500,880,0,47.3837,-122.307
350000,4,2.5,2260,7500,1460,800,47.4645,-122.196
595000,3,1,1300,11520,1300,0,47.6829,-122.195
440000,3,1.75,1450,6829,1450,0,47.7222,-122.108
550000,3,1,1110,6000,1110,0,47.6461,-122.357
940000,4,2.25,1890,5940,1470,420,47.6316,-122.303
375000,3,1.5,1100,1751,940,160,47.5927,-122.306
567500,2,1.5,1350,4592,1070,280,47.6511,-122.405
735000,3,2.5,3020,50800,1510,1510,47.5529,-122.026
114000,2,1,730,5200,730,0,47.4943,-122.337
608000,2,1,1390,3600,1010,380,47.6422,-122.36
442500,3,1.5,2710,47419,2170,540,47.6522,-121.966
381800,4,2,1530,5250,1110,420,47.7336,-122.339
330000,3,2,2170,3978,1340,830,47.571,-122.391
90000,2,1,790,2640,790,0,47.7351,-122.178
312000,2,1.75,1160,8625,1160,0,47.5509,-122.366
339000,3,1,1080,8100,1080,0,47.777,-122.307
313000,3,1.75,2190,8000,2190,0,47.3098,-122.381
618080,3,2.5,2030,6500,2030,0,47.5654,-122.092
325000,3,2.25,2480,8755,2480,0,47.4543,-122.125
242000,4,1,2240,7620,1120,1120,47.5089,-122.346
364000,2,1.5,1650,7311,860,790,47.7772,-122.357
545000,3,1.75,1700,5750,1450,250,47.5643,-122.38
445000,3,2.5,2790,16173,2790,0,47.3043,-122.343
1.0855E+06,4,2.75,3010,10830,3010,0,47.7005,-122.232
660000,4,2.5,2550,10000,1290,1260,47.6208,-122.141
845000,4,2.5,2880,35610,2880,0,47.6911,-122.054
417000,4,2,2090,4000,1060,1030,47.5893,-122.299
213800,2,1,740,5200,740,0,47.4934,-122.173
400000,2,1.75,960,6200,960,0,47.5551,-122.396
759950,4,3.5,2100,7560,2100,0,47.7076,-122.356
990000,4,2.5,2540,5930,2540,0,47.6451,-122.387
710000,3,1.75,1650,10250,1650,0,47.6118,-122.169
315000,1,0.75,770,4600,770,0,47.5565,-122.377
515000,4,2.5,2280,14810,1500,780,47.5392,-122.186
638000,3,2,1660,3729,970,690,47.5741,-122.414
370000,4,2,2020,8100,1160,860,47.7307,-122.297
184000,3,1,970,14850,970,0,47.3251,-122.268
583800,3,2.5,2480,6600,2480,0,47.6313,-122.008
309500,3,1,1250,7320,1250,0,47.5074,-122.163
1.96E+06,4,4,4430,31353,4430,0,47.6422,-122.157
299000,1,1,740,5000,740,0,47.5519,-122.292
215000,2,1,710,7200,710,0,47.4903,-122.245
410000,4,2,1970,10500,1820,150,47.479,-122.356
478000,2,1,820,6000,820,0,47.6494,-122.395
431000,2,1,1000,6500,1000,0,47.5474,-122.388
635000,4,2.5,3080,35430,3080,0,47.6325,-121.97
648000,5,2.25,2410,12000,2410,0,47.5434,-122.175
640000,3,2.5,2370,11172,2370,0,47.5345,-122.179
932808,5,4.5,4690,6705,3450,1240,47.5539,-122.108
835000,2,2,2280,6815,2280,0,47.7103,-122.027
469775,2,1.75,1530,7020,1030,500,47.6465,-122.395
587000,5,3.5,3610,52595,3610,0,47.6832,-121.907
677915,3,2,1740,3600,990,750,47.6448,-122.358
1.075E+06,4,3,3600,9200,2100,1500,47.5866,-122.116
671000,4,3,3130,5700,1750,1380,47.6811,-122.283
695000,5,3.25,3940,9780,3940,0,47.5435,-121.888
205000,4,2,2200,13320,1100,1100,47.481,-122.292
350000,4,1,1510,7200,1510,0,47.761,-122.307
360000,3,1.75,1560,7930,1560,0,47.4779,-122.161
313999,4,2.25,1870,4198,1870,0,47.3657,-122.021
300000,3,2.25,2070,7225,1690,380,47.3551,-122.148
452000,2,1.75,1660,11747,830,830,47.7661,-122.306
495500,3,2.5,2010,57934,2010,0,47.6262,-121.96
288000,3,1,1410,40500,1410,0,47.3199,-122.1
227490,3,1.75,1820,7194,1820,0,47.3352,-122.307
470950,3,2.5,2560,16420,2560,0,47.6916,-121.916
735000,4,2.75,2450,4187,2450,0,47.5471,-122.016
730000,7,2.75,3110,4400,2010,1100,47.6684,-122.319
412000,3,2.5,2210,7000,2210,0,47.4377,-122.132
589500,4,2.5,2630,6326,2630,0,47.5222,-121.874
291000,7,1,2350,8636,1550,800,47.5432,-122.277
1.3E+06,5,3.75,4450,7680,3460,990,47.6418,-122.392
190000,3,1,1200,10458,1200,0,47.3262,-122.342
456200,2,1.75,1210,7733,1210,0,47.7148,-122.282
225000,3,1,1290,8470,970,320,47.3054,-122.371
2E+06,3,2.5,3490,21064,2290,1200,47.6092,-122.073
740000,4,2.5,3360,15091,3360,0,47.6649,-122.135
467000,3,1.75,2660,5511,1330,1330,47.5575,-122.3
385000,2,1,770,7554,770,0,47.7057,-122.36
670000,3,2.5,1800,4763,1240,560,47.646,-122.362
500000,4,2.5,2900,5760,1660,1240,47.55,-122.272
352450,3,2,1430,6000,1430,0,47.7564,-122.316
669888,4,2.75,2550,7591,2550,0,47.5302,-122.147
405000,3,2.75,1310,7300,1310,0,47.6016,-122.123
518000,3,1.5,1430,8000,1430,0,47.5874,-122.136
280000,4,1,1880,6288,1120,760,47.5101,-122.259
435000,3,2.5,1600,2375,1600,0,47.5531,-121.996
314950,3,2,1760,9732,1760,0,47.1923,-122.014
209900,2,2,1180,3003,1180,0,47.3491,-122.02
630000,4,2.5,2330,31705,2330,0,47.6471,-122.03
442000,4,1.5,1960,12688,1960,0,47.6304,-122.097
340000,4,1,1140,13440,1140,0,47.4619,-122.344
230000,3,1.75,1400,6956,1400,0,47.4233,-122.198
495200,5,2.25,2710,22120,1410,1300,47.7642,-122.195
900000,4,2.5,3510,6745,3510,0,47.6016,-122.074
265000,2,1,910,4600,910,0,47.6916,-122.362
489500,3,1.75,2090,65558,1330,760,47.7621,-122.127
335000,3,2,1410,44866,1410,0,47.3273,-122.37
585000,3,3.25,3050,12700,2240,810,47.7445,-122.214
800000,4,2.25,2010,7200,1010,1000,47.5591,-122.267
379500,4,2.25,2120,53578,2120,0,47.2041,-122.021
475000,3,1,1270,8000,1270,0,47.6175,-122.118
520000,3,2,1670,8800,1150,520,47.6096,-122.132
515000,4,2.5,1800,4338,1800,0,47.5962,-122.015
577500,2,1,1640,5515,940,700,47.6912,-122.334
269900,3,2.25,1740,9672,1110,630,47.4149,-122.181
329000,3,1,1600,5952,1150,450,47.5292,-122.362
458500,3,1.5,1280,1920,1280,0,47.6117,-122.301
890000,4,2,1480,11171,1480,0,47.5849,-122.051
361500,4,2.5,1980,7334,1980,0,47.3528,-122.041
2.535E+06,5,3.25,3730,10626,3730,0,47.624,-122.221
325000,2,1,900,8374,900,0,47.7282,-122.225
1.85E+06,4,3.25,3480,6000,3480,0,47.6353,-122.353
945000,4,2,2840,13367,1420,1420,47.6237,-122.21
370000,3,2.5,2490,4244,2490,0,47.3705,-122.131
320000,0,2.5,1490,7111,1490,0,47.5261,-121.826
450000,2,2,1510,4908,1510,0,47.7196,-122.024
800000,4,2.5,2900,18303,2900,0,47.5981,-122.03
676000,3,2.5,2240,3825,2240,0,47.6786,-122.389
1.2725E+06,4,1.75,2040,5000,2040,0,47.6279,-122.315
290000,3,1.75,1460,7980,1460,0,47.7713,-122.265
158000,3,1.5,990,8925,990,0,47.3294,-122.331
379950,4,1.75,1970,9389,1140,830,47.7771,-122.339
583000,4,2.5,2660,4000,2660,0,47.6876,-122.038
150000,2,1,870,5700,870,0,47.498,-122.17
261500,3,2.5,1740,6992,1740,0,47.3574,-122.158
278000,4,2.5,2290,3777,2290,0,47.3617,-122.308
555000,4,2.75,2170,7140,1290,880,47.691,-122.113
355000,3,1.75,2040,8173,1470,570,47.7439,-122.333
375000,4,1.5,1770,6650,1770,0,47.6011,-122.124
227000,3,1.75,2380,12681,1380,1000,47.5294,-122.279
335000,4,2,2030,103672,2030,0,47.1647,-121.973
680000,3,2.25,2270,23900,1820,450,47.7506,-122.372
686500,2,1.75,1390,5025,1390,0,47.6701,-122.288
410000,3,1.75,1530,26642,1180,350,47.7422,-122.097
425000,2,1,1430,13300,1230,200,47.6996,-122.203
562500,3,2.5,2030,7549,2030,0,47.6187,-122.044
345000,4,2.5,2390,6976,2390,0,47.4807,-122.182
627500,4,2.5,2540,11500,1640,900,47.5609,-122.15
355000,3,1,1890,36300,1890,0,47.5719,-121.914
335000,3,2.25,1870,5876,1870,0,47.3779,-122.045
350000,4,3,1780,4228,1780,0,47.5488,-122.287
590000,3,1,1610,58370,1610,0,47.6718,-122.044
252000,3,2,1420,6788,1420,0,47.2887,-122.351
1.295E+06,5,4,4440,9270,2220,2220,47.5708,-122.212
705000,4,2,1820,5001,1820,0,47.6438,-122.373
498000,3,2,1620,8400,1180,440,47.6574,-122.128
312500,2,1,870,7227,870,0,47.7288,-122.331
260000,4,1.75,1830,5375,1060,770,47.4169,-122.316
209950,3,1.5,2290,9600,2290,0,47.3643,-122.111
610000,3,1.75,1110,10402,1110,0,47.5676,-122.177
500000,4,1,1440,7100,1440,0,47.6725,-122.396
850000,3,3.5,3070,7050,1570,1500,47.7076,-122.276
689000,4,2.5,2440,11700,1480,960,47.5606,-122.184
470000,4,2,2410,4680,2410,0,47.6234,-122.113
640000,3,3,2270,5175,2130,140,47.516,-122.203
290000,4,1.75,2340,7200,1590,750,47.497,-122.369
258500,3,2.5,1800,9000,1800,0,47.3186,-122.331
1.1E+06,4,3.5,2210,7597,1550,660,47.5816,-122.197
420000,3,1.75,1820,22320,1250,570,47.6441,-121.96
230000,3,1,1190,9083,1190,0,47.4116,-122.293
252000,3,1.5,1400,6865,1400,0,47.3639,-122.048
515000,3,2.5,2600,4506,2600,0,47.7353,-122.222
425000,2,1,910,4635,910,0,47.675,-122.393
575000,3,2.5,1760,2320,1760,0,47.5723,-122.376
390000,2,1,860,5160,860,0,47.6823,-122.388
561500,4,2.25,2310,9800,1780,530,47.6657,-122.178
1.35E+06,4,1.75,2000,3728,1820,180,47.643,-122.299
835000,5,2.75,2460,7830,1490,970,47.6938,-122.31
245000,2,1,1020,15000,1020,0,47.4956,-122.321
475200,3,2.5,1670,3980,1670,0,47.5317,-122.047
425000,2,1,790,5024,790,0,47.6833,-122.395
218000,2,1.5,2010,7755,2010,0,47.4947,-122.233
600000,4,2.5,2600,6536,2600,0,47.5232,-122.191
545000,4,2.25,1890,7210,1890,0,47.6342,-122.117
2.408E+06,5,2.5,4600,23250,3600,1000,47.623,-122.218
460000,5,3,2008,5050,1216,792,47.5376,-122.292
425000,2,1,880,6413,880,0,47.573,-122.395
455000,3,1.75,1700,8360,850,850,47.5766,-122.147
313100,3,2,1730,12821,1730,0,47.353,-122.272
780000,4,3.5,3910,59863,2490,1420,47.4846,-122.067
345500,4,2.5,2160,9682,2160,0,47.4106,-122.204
243000,3,1.75,1200,8034,1200,0,47.4135,-122.18
670000,5,3.5,3860,9600,2660,1200,47.7139,-122.223
325000,3,1.5,1320,7560,840,480,47.7451,-121.98
281000,2,1,1280,12500,1060,220,47.4833,-122.237
130000,3,1,1100,5100,1100,0,47.5231,-122.332
340000,3,2.5,2170,9798,2170,0,47.3817,-122.023
485000,4,2.75,2720,51396,2720,0,47.4777,-122.1
642860,4,2.75,2520,6398,2520,0,47.7685,-122.159
747000,3,1.75,2560,4800,1280,1280,47.6207,-122.295
559950,4,2.5,2650,7200,2250,400,47.7317,-122.354
577288,4,2.75,2870,7200,2870,0,47.5688,-122.317
575000,2,1,1230,2726,880,350,47.6815,-122.359
287000,3,1,1450,6000,1450,0,47.5238,-122.287
1.149E+06,4,3.75,3180,9889,2500,680,47.6853,-122.204
335000,2,1,1800,8900,900,900,47.51,-122.323
375000,4,2.25,2020,12500,2020,0,47.5403,-122.175
325000,2,1,620,14823,620,0,47.7322,-122.3
530000,3,2.25,2190,220414,1330,860,47.5041,-122.102
287000,4,2.25,1980,7081,1470,510,47.3669,-122.288
320000,5,3,2970,7000,1810,1160,47.3079,-122.341
425000,4,2.5,2270,4400,2270,0,47.5381,-121.888
550000,3,1,1630,6009,1630,0,47.693,-122.383
135000,3,1,1520,8450,1120,400,47.328,-122.337
695000,3,1.75,2080,5687,2080,0,47.5776,-122.289
975000,5,2.5,3020,9648,1980,1040,47.5586,-122.134
210000,4,1.75,2180,28710,1180,1000,47.405,-122.288
518000,4,1.75,1780,8768,1050,730,47.7085,-122.283
335500,3,1,1370,6780,1370,0,47.7156,-122.291
750000,4,3.5,3050,7020,2050,1000,47.571,-122.374
515000,3,1.75,1490,12000,1490,0,47.569,-122.175
344500,4,2.75,1800,5453,1050,750,47.4632,-122.209
470000,3,1.5,1760,6723,1160,600,47.5514,-122.266
606150,4,1.75,1770,9848,1370,400,47.6208,-122.099
292000,4,2.75,2910,7712,1600,1310,47.2842,-122.198
450000,3,2.5,2880,426452,2880,0,47.2485,-122.101
429000,3,1.75,2520,5043,1260,1260,47.5339,-122.372
765000,4,2.5,3190,38119,3190,0,47.6698,-122.044
425000,2,1,540,2500,540,0,47.6729,-122.383
505000,4,2.5,3170,5340,3170,0,47.4911,-122.138
544950,3,1.75,1830,7371,1830,0,47.6059,-122.121
382000,3,2,1360,4840,1360,0,47.5487,-122.376
475000,3,1.75,1870,25157,1870,0,47.695,-121.915
355000,3,1.5,1370,4790,1370,0,47.7253,-122.164
410000,4,2.5,1700,9000,1700,0,47.7306,-122.233
450000,4,2,1960,5008,980,980,47.5958,-122.299
565000,7,4.5,4140,9066,2070,2070,47.7302,-122.291
529100,2,1,1290,6528,1290,0,47.694,-122.29
452500,4,2.5,2460,6454,2460,0,47.5381,-121.89
245000,4,2,1580,8000,1040,540,47.3467,-122.304
415000,1,1,700,2550,700,0,47.6783,-122.383
610000,4,2.5,2410,15899,2410,0,47.6242,-122.04
363500,4,1.75,2180,9702,1090,1090,47.4973,-122.268
510000,3,2.75,1950,12630,1230,720,47.6301,-122.107
650000,4,2.5,2630,28298,2630,0,47.6314,-121.968
290000,4,2.5,2050,9015,2050,0,47.4357,-122.168
170000,3,1,790,6750,790,0,47.4984,-122.24
510000,2,1,1070,5280,1070,0,47.6168,-122.303
2.28E+06,7,8,13540,307752,9410,4130,47.6675,-121.986
316000,4,2.5,2320,7379,2320,0,47.3432,-122.316
690000,4,2.5,2670,13463,2670,0,47.5627,-122.018
199950,2,1,700,5200,700,0,47.4924,-122.174
207000,3,1,860,7740,860,0,47.4906,-122.244
449950,4,2.25,3490,8400,3490,0,47.4513,-122.128
361550,3,1.75,1160,257875,1160,0,47.4655,-122.072
824000,4,3.5,3650,57538,3650,0,47.7711,-122.041
537000,3,1.75,1550,10050,1550,0,47.6345,-122.123
838400,4,2.5,2620,9525,2620,0,47.5631,-122.219
225000,2,1,720,4758,720,0,47.5176,-122.376
329900,3,2,1380,5198,1380,0,47.5514,-122.357
282500,4,1,1170,34925,1170,0,47.5305,-121.841
229950,3,1.75,1170,11960,1170,0,47.3279,-122.136
500000,2,1,1630,12059,1270,360,47.7228,-122.314
495000,3,1.75,1890,6557,1890,0,47.7032,-122.286
149500,3,1,1010,9450,1010,0,47.3592,-122.315
726000,3,2.5,2040,10033,1420,620,47.6375,-122.173
899000,4,2.5,4080,10295,4080,0,47.5933,-121.982
317000,3,1,1270,8925,1270,0,47.5124,-122.165
395000,1,1,790,3000,790,0,47.6544,-122.386
360000,4,3,2580,6740,2580,0,47.4296,-122.185
570000,4,2.5,2290,6738,2290,0,47.5714,-122.005
320000,4,2.5,3490,5000,3490,0,47.3772,-122.127
320000,3,1.75,1510,30185,1510,0,47.4118,-122.089
268000,5,2.5,2400,4564,2400,0,47.369,-122.126
191000,2,1,900,3400,900,0,47.5269,-122.314
400000,2,1,1270,7440,910,360,47.5285,-122.372
515000,2,1,1050,5000,1050,0,47.6699,-122.369
610000,4,2.5,2950,9010,2950,0,47.531,-121.86
538000,2,1.75,1850,3060,1060,790,47.6821,-122.308
432000,3,2.5,1970,4036,1970,0,47.5335,-121.869
335000,4,2.25,2400,8592,2400,0,47.4383,-122.193
302000,5,1.75,2360,8642,2060,300,47.7617,-122.335
787500,4,1.75,1580,9382,1080,500,47.6353,-122.232
420000,3,1,1790,7055,1520,270,47.718,-122.355
560000,3,2.5,2840,216493,2840,0,47.702,-121.892
535000,3,2.5,1970,6634,1970,0,47.5759,-122.012
310000,3,2.5,1780,6771,1230,550,47.5237,-122.353
760000,5,2,3920,5250,2560,1360,47.5798,-122.294
242500,3,1.75,1550,1905,1550,0,47.4331,-122.195
1.313E+06,6,3,2980,7200,2980,0,47.6366,-122.362
235000,3,1,1270,7153,1270,0,47.4815,-122.226
598780,4,2.25,3040,12160,1520,1520,47.5911,-122.133
433200,3,2.5,2075,16200,2075,0,47.4848,-121.698
343000,2,1,1110,9920,700,410,47.5454,-122.192
145000,2,1,800,8125,800,0,47.6836,-122.174
291970,1,1,680,21727,680,0,47.446,-122.175
599950,3,1,1680,7910,1680,0,47.5085,-122.385
1.749E+06,4,2.5,3910,22710,3910,0,47.6295,-122.217
870000,4,1.75,2780,11000,1560,1220,47.595,-122.203
323000,4,2.75,2000,9083,2000,0,47.3511,-122.058
727000,4,3,3150,9703,3150,0,47.5962,-122.018
166000,1,1,1120,17332,1120,0,47.2972,-122.267
450000,4,1.75,1740,12204,1270,470,47.7675,-122.277
400000,3,2.5,2970,23100,1510,1460,47.7735,-122.133
599000,3,2.5,2970,23100,1510,1460,47.7735,-122.133
165000,3,1,1150,19200,1150,0,47.2756,-122.27
229000,2,1,1190,7408,830,360,47.5094,-122.31
305000,1,1,900,7500,900,0,47.7553,-122.283
930000,3,3.25,2950,4446,2450,500,47.5852,-122.391
542000,3,2.5,1990,15985,1540,450,47.6205,-122.141
214000,3,1,1020,9147,1020,0,47.3127,-122.002
718000,3,2.5,2070,7200,2070,0,47.6946,-122.211
349000,3,2.5,1430,1002,1430,0,47.698,-122.349
305000,3,2.5,2030,8000,2030,0,47.4024,-122.216
498000,3,2.5,1620,2640,1620,0,47.6036,-122.305
799950,4,3.5,4220,196817,4220,0,47.2642,-122.187
737000,3,2.5,2300,7800,2300,0,47.6842,-122.155
860000,4,3.25,3830,10005,3830,0,47.5953,-122.039
339950,3,2.5,2390,34041,1840,550,47.3546,-122.081
249000,3,2.25,1440,7673,940,500,47.4034,-122.178
370000,2,1,910,5525,910,0,47.5322,-122.379
725000,3,2,1550,12262,1550,0,47.5755,-122.216
529000,5,2.5,2380,91476,1580,800,47.479,-122.153
310000,4,2.75,2060,8100,1310,750,47.3581,-122.317
315000,4,2.25,1880,9163,1880,0,47.4362,-122.165
1.3E+06,4,2.5,3470,4160,2480,990,47.63,-122.363
435000,3,2,2360,12744,2360,0,47.483,-122.164
350000,3,1.75,1970,10800,1300,670,47.5107,-122.172
240000,3,1,1040,7800,1040,0,47.4804,-122.229
410000,3,2.25,1420,3750,1420,0,47.5725,-122.383
430000,4,2.75,2290,5249,2290,0,47.4916,-122.162
446000,4,2.5,1530,8375,1020,510,47.7174,-122.236
240000,3,1.5,1360,9760,1360,0,47.4648,-121.757
595000,4,3,3680,35736,2320,1360,47.4703,-122.015
215150,3,1,920,4770,920,0,47.3654,-122.082
319950,2,1,1070,5824,1070,0,47.507,-122.242
385000,3,2,1590,9912,1590,0,47.3731,-122.43
280000,3,2.5,1600,6700,1600,0,47.3618,-122.074
399950,3,2.5,1510,7300,1040,470,47.7153,-122.211
132500,3,1,1080,10500,1080,0,47.32,-122.278
399950,2,0.75,1330,2856,930,400,47.5671,-122.37
290000,2,1,850,6800,850,0,47.7282,-122.337
860000,5,2.25,1960,8592,1290,670,47.6066,-122.192
3.1E+06,6,4.25,6980,15682,5330,1650,47.5552,-122.231
245000,4,1,1530,7200,1400,130,47.5015,-122.262
255000,3,1.5,1320,7980,1320,0,47.5068,-122.259
310000,4,3,2320,7200,2320,0,47.7703,-122.312
299000,3,1,960,8100,960,0,47.7763,-122.305
575000,4,2.5,2040,5508,2040,0,47.5719,-122.007
284000,3,1,1080,8214,1080,0,47.7401,-122.348
840000,3,1.75,2020,4800,1090,930,47.6726,-122.294
442573,3,1.75,1780,7567,1290,490,47.7314,-122.225
560000,3,1,1140,7028,1140,0,47.6948,-122.322
485000,3,2,1610,4160,1010,600,47.5421,-122.388
472500,4,1.75,1440,8536,1440,0,47.6775,-122.18
1.61E+06,4,2.75,4270,25807,4270,0,47.5951,-122.206
808000,8,3.75,3460,4600,2860,600,47.6617,-122.289
398000,3,1.75,1890,16001,1890,0,47.7663,-122.201
340000,3,2.5,2240,6000,2240,0,47.4837,-122.138
380000,2,1,760,4000,760,0,47.5462,-122.32
235000,3,1,1020,6173,780,240,47.5042,-122.329
400000,3,1.5,1330,9900,1330,0,47.7167,-122.233
582000,5,2.5,2780,12335,1590,1190,47.5681,-122.128
209000,2,1,1070,6120,1070,0,47.4989,-122.317
335000,5,3,2660,7700,1670,990,47.46,-122.174
285950,2,1,710,7120,710,0,47.5122,-122.374
645000,5,2.25,3340,52476,3340,0,47.4553,-121.987
312000,2,1,1160,7500,1160,0,47.6499,-121.916
663000,3,2.25,2840,59677,1580,1260,47.5828,-122.044
443950,3,1.75,2000,36000,2000,0,47.5217,-122.182
315000,3,2,1060,5750,1060,0,47.5523,-122.372
302200,4,1.5,1730,10396,1730,0,47.4497,-122.168
770000,3,2.5,2190,2658,2190,0,47.6528,-122.203
374950,4,1.75,1660,8160,1660,0,47.4483,-122.129
330000,3,2.5,2210,7557,2210,0,47.3079,-122.393
230000,2,1,870,7020,570,300,47.5404,-122.352
967000,4,2.5,3100,7250,3100,0,47.6961,-122.316
536500,4,2.5,1720,3515,1470,250,47.591,-122.293
315000,6,4,3120,4240,2090,1030,47.5305,-122.353
626000,3,1,1040,4240,860,180,47.6768,-122.367
334009,4,2,1650,9305,1650,0,47.7183,-122.213
429000,2,1,1010,5000,1010,0,47.6715,-122.365
818000,4,2.5,4020,44431,4020,0,47.7467,-122.132
326000,5,2.75,2166,6342,2166,0,47.3461,-122.152
310000,5,3,1880,5000,1100,780,47.5453,-122.363
525000,4,2,2260,7680,1130,1130,47.7193,-122.361
350000,3,2.25,2010,4400,2010,0,47.4735,-122.189
936000,4,2.5,3330,8897,3330,0,47.6484,-122.08
226000,3,1,1520,7200,1030,490,47.4527,-122.352
1.25E+06,5,3.5,3510,4798,2700,810,47.669,-122.282
428000,3,1.75,1580,507038,1580,0,47.2303,-121.936
329932,3,1.5,1460,5040,1100,360,47.7112,-122.357
539000,3,1.5,1460,5040,1100,360,47.7112,-122.357
275000,3,1.75,1650,7700,1650,0,47.3155,-122.365
590000,4,2.5,2660,35010,2660,0,47.4816,-121.714
782000,4,2.5,3510,24604,3510,0,47.6772,-122.056
575000,4,2.5,2120,9603,2120,0,47.5348,-122.053
509000,3,2.25,1780,9315,1780,0,47.7484,-122.353
290000,4,2.5,2000,13300,1200,800,47.353,-122.294
305240,3,1,1300,9000,1300,0,47.7352,-122.337
555000,3,2,2180,4976,1680,500,47.573,-122.38
317000,3,2,1790,8228,1390,400,47.4658,-122.172
430000,3,2,1910,5040,1910,0,47.6312,-122.061
850000,2,1.5,1800,4144,900,900,47.5934,-122.39
469000,3,2.25,2620,10659,1660,960,47.7643,-122.273
327200,2,2,1440,8425,1440,0,47.4831,-122.296
835000,3,3,2790,12523,1600,1190,47.3571,-122.324
360000,4,2.5,2340,13445,2340,0,47.374,-122.125
372000,4,2.5,2070,8658,2070,0,47.5072,-122.257
453000,3,1,2160,11484,2160,0,47.7277,-122.185
275000,2,1.75,2090,11317,1090,1000,47.4594,-122.279
475000,4,2.5,2040,7260,2040,0,47.7399,-122.332
310000,4,2.75,1950,9720,1400,550,47.3969,-122.205
173000,4,2,1200,8460,1200,0,47.4413,-122.277
313500,5,3,2240,94960,2240,0,47.481,-121.788
345000,3,2.5,1360,1489,1360,0,47.549,-122.372
436000,3,1.5,1500,10200,1300,200,47.7598,-122.359
244500,2,1.75,1300,14500,650,650,47.4989,-122.329
206000,3,1.75,1140,9800,1140,0,47.3063,-122.27
890000,4,2.5,2930,9158,2930,0,47.7065,-122.13
329950,4,2.25,2140,8874,2140,0,47.2654,-122.217
250000,3,1.75,1628,286355,1628,0,47.2558,-122.122
246000,3,2,1990,203861,1990,0,47.2507,-122.039
440000,3,1.75,1950,19747,1150,800,47.7685,-122.162
395000,4,1.75,1910,8117,1460,450,47.7344,-122.173
305000,3,1,820,5150,820,0,47.5514,-122.284
160000,3,2.25,1470,8682,1160,310,47.2729,-122.299
269000,3,2.25,1470,8682,1160,310,47.2729,-122.299
169500,3,1,1060,10023,1060,0,47.2869,-122.36
690500,4,2.75,3130,8920,3130,0,47.7397,-122.316
245560,2,1.5,1260,9693,1260,0,47.7775,-122.365
345000,4,2.75,2200,13498,2200,0,47.3148,-122.35
383000,4,1.75,2580,19607,1290,1290,47.5067,-122.197
388500,3,2.25,1350,944,1050,300,47.5997,-122.312
250000,3,1.75,1350,8548,1350,0,47.3179,-122.33
455500,3,1.75,2290,19000,1650,640,47.3837,-122.158
672000,3,1,1220,8573,1220,0,47.6088,-122.193
550000,4,1.5,2750,128502,1500,1250,47.4345,-122.198
487000,3,1.75,1430,12632,1430,0,47.6371,-122.123
291375,4,2.5,2220,6233,2220,0,47.4887,-122.15
225000,3,1,1490,15850,1490,0,47.7411,-122.347
519950,5,3.5,2440,10200,2440,0,47.5814,-122.003
250000,3,2.5,2070,8400,2070,0,47.3099,-122.206
614950,3,1,1500,2400,1500,0,47.6333,-122.362
599500,4,2.25,2020,10260,2020,0,47.6801,-122.114
625000,4,1.5,2190,13660,2190,0,47.7658,-122.37
248500,2,1,780,10064,780,0,47.4913,-122.318
469950,5,2,1220,4200,1090,130,47.6677,-122.321
525000,3,1.5,1840,10956,1840,0,47.6746,-122.164
787500,2,2.5,2390,6928,1810,580,47.5101,-122.391
485000,4,2.5,3710,15935,2130,1580,47.3528,-122.267
310000,2,1,750,5379,750,0,47.5324,-122.272
280000,5,2,2110,7919,1110,1000,47.5164,-122.267
200000,4,1,1020,42966,1020,0,47.7617,-122.11
490000,3,2.5,3080,7363,3080,0,47.4473,-122.205
146000,3,1,900,4770,900,0,47.3038,-122.362
500000,5,3,3720,25474,2090,1630,47.3296,-122.256
242500,3,1,940,7380,940,0,47.4516,-122.175
324950,3,1,1040,7288,1040,0,47.7287,-122.311
231500,2,1,1000,7615,1000,0,47.49,-122.191
300000,3,2.5,2080,9827,2080,0,47.3058,-122.394
545000,4,2.5,2500,50595,2500,0,47.4736,-121.731
350000,3,1,1050,8583,1050,0,47.7451,-122.339
467100,3,1.75,1620,8645,1190,430,47.6651,-122.151
180000,3,1,1610,8500,1610,0,47.3717,-122.297
749000,4,1.5,2130,5000,2130,0,47.5828,-122.291
245000,3,2.5,1460,11593,1460,0,47.2984,-122.385
260000,5,1,1600,7350,1600,0,47.3943,-122.196
490000,3,3,1730,2940,1730,0,47.6911,-122.392
565000,4,2.5,2280,4602,2280,0,47.5895,-122.019
330000,4,2.25,2430,7490,2430,0,47.4406,-122.139
295000,3,1,1380,7575,1380,0,47.5139,-122.187
725000,3,1.5,1790,6000,1790,0,47.6754,-122.325
1.135E+06,4,2.5,3370,10602,3370,0,47.6591,-122.147
680000,3,2.25,2920,6300,1710,1210,47.7065,-122.37
490000,2,1,2180,9300,1090,1090,47.7032,-122.371
635000,3,1.75,1480,6985,1200,280,47.686,-122.374
750000,3,2.5,2350,715690,2350,0,47.1622,-121.971
330000,4,2.25,2440,8098,2440,0,47.3126,-122.346
270000,3,2.5,1350,1189,1080,270,47.5218,-122.358
340000,3,2.25,1970,3716,1970,0,47.4907,-122.167
413252,3,0.75,1110,3960,1110,0,47.6834,-122.366
600000,4,2.75,2950,5803,2950,0,47.7368,-122.231
726888,5,3,2970,7261,2970,0,47.5994,-122.019
285000,2,1,720,6400,720,0,47.5286,-122.368
365000,2,1,770,5680,770,0,47.6951,-122.366
295000,4,2,1650,7200,1650,0,47.7543,-122.344
460000,3,2.25,1620,7350,1170,450,47.7248,-122.179
230000,3,1.5,1510,10588,1510,0,47.3775,-122.319
337000,3,1,1070,6109,1070,0,47.7207,-122.32
300000,3,1,1010,6300,1010,0,47.7304,-122.352
2.3E+06,4,2.5,3370,8402,2240,1130,47.6349,-122.29
360000,4,2.5,2000,5500,2000,0,47.3552,-122.014
585000,3,2.5,2060,10839,2060,0,47.5675,-122.016
182700,3,2.25,1740,6650,1240,500,47.2979,-122.379
305000,3,2.25,1740,6650,1240,500,47.2979,-122.379
309950,3,2.5,1880,7838,1880,0,47.4439,-122.19
550000,3,1,960,12527,960,0,47.6891,-122.203
825000,3,2.5,3280,26413,2670,610,47.6395,-122.05
998500,2,1,1570,4400,1570,0,47.6112,-122.293
644500,4,2.5,2990,5342,2990,0,47.6124,-122.009
320000,3,2,1250,8636,1250,0,47.5066,-122.159
266950,3,2.5,1920,4803,1920,0,47.3745,-122.127
633100,4,2.5,2470,33305,2470,0,47.6303,-121.99
395000,2,1,960,6700,960,0,47.6955,-122.357
259250,3,1,940,5904,940,0,47.699,-122.35
300000,3,1,1260,5000,1260,0,47.6492,-121.915
413000,3,1.75,2280,139392,2280,0,47.291,-122.118
435000,3,2.25,1740,8491,1240,500,47.7758,-122.379
500000,4,2.75,2630,15000,1690,940,47.7425,-122.089
402000,4,1.75,2430,5481,1430,1000,47.5569,-122.298
777700,3,2.5,2260,251460,2260,0,47.4096,-122.449
580000,2,1.5,1220,5000,1220,0,47.6624,-122.348
570000,3,1.75,2580,40392,1390,1190,47.7637,-122.134
174950,2,1,730,6000,730,0,47.3832,-122.3
300000,2,1,760,3001,760,0,47.5874,-122.311
435000,3,1.5,1740,6988,1600,140,47.7211,-122.33
840000,4,2.5,3420,8405,3420,0,47.6328,-122.064
469000,5,2.5,2240,7543,1140,1100,47.7756,-122.372
870000,4,1.75,1920,3600,1920,0,47.6382,-122.368
532000,4,1.75,2020,7029,1430,590,47.6983,-122.127
455000,4,1.5,1880,11400,1280,600,47.7718,-122.381
201000,3,1,1010,25277,1010,0,47.7242,-121.951
649000,5,3.25,3990,13087,2400,1590,47.3632,-122.061
445500,2,1.75,1390,6670,720,670,47.6914,-122.308
475000,3,2,1230,11502,1230,0,47.7017,-122.127
590000,4,2.5,2940,29013,2940,0,47.7635,-122.044
565000,4,1.5,2190,8296,2190,0,47.5158,-122.385
110000,1,1,640,10280,640,0,47.5144,-122.368
375000,3,2.5,1670,7740,1130,540,47.5222,-122.37
255000,3,1.5,1240,8528,1240,0,47.4478,-122.157
315000,5,1.75,1850,14800,1760,90,47.4935,-122.321
496600,4,2.25,2020,8400,1350,670,47.5488,-122.171
380000,3,1,1020,4800,1020,0,47.5615,-122.272
338950,3,1.75,1610,22496,1610,0,47.3443,-122.073
542500,5,3.5,2730,42500,1530,1200,47.4587,-121.996
739000,5,2.5,2840,5000,1620,1220,47.5817,-122.291
549000,4,1.75,1290,3060,1290,0,47.6798,-122.348
252000,3,2.25,1670,7881,1190,480,47.4105,-122.18
1.69889E+06,4,4.5,3860,15246,2940,920,47.56,-122.161
735000,4,1.75,2460,5100,1450,1010,47.6782,-122.3
270000,4,2.5,1660,8063,1660,0,47.3761,-122.32
2.25E+06,3,2.5,3420,8700,2890,530,47.6352,-122.29
155000,2,1,1010,43056,1010,0,47.7105,-121.316
469000,4,2.5,2240,5624,1520,720,47.5574,-122.308
305000,4,2.25,2340,5250,2340,0,47.5183,-122.266
675000,3,1.75,1920,4500,960,960,47.6645,-122.357
931000,3,2.5,2460,6600,1560,900,47.6364,-122.351
385000,3,1,1470,11398,1470,0,47.746,-122.296
815000,3,2.5,3400,12442,3400,0,47.5611,-122.032
531000,3,2.25,1910,8390,1910,0,47.73,-122.216
386500,4,1,1400,3600,700,700,47.5972,-122.295
475580,3,1.75,1520,11085,1520,0,47.646,-122.068
358000,2,1,930,5077,930,0,47.7095,-122.35
677500,5,1,2340,4730,1810,530,47.5895,-122.385
868500,3,2.5,2920,3942,2920,0,47.531,-122.204
599380,3,1.75,1270,7350,1270,0,47.6046,-122.168
712000,4,2.25,2450,11960,2450,0,47.6351,-122.06
350000,5,1.75,1380,7620,1180,200,47.5279,-122.345
875000,4,2,2520,6000,1400,1120,47.6767,-122.35
365000,3,2.25,2290,7350,2290,0,47.429,-122.162
452000,4,2,1660,6150,850,810,47.5371,-122.368
915000,3,2.75,2800,9750,1400,1400,47.5862,-122.202
482500,3,2.5,1690,3068,1690,0,47.6763,-122.028
425000,3,1,1180,7200,1180,0,47.7121,-122.333
460000,2,1.75,1390,4160,790,600,47.6681,-122.324
666570,4,2,2320,7400,1620,700,47.5558,-122.269
390000,3,2.25,2270,32112,1740,530,47.3451,-122.094
650000,4,1.75,2640,8215,1500,1140,47.5819,-122.125
305000,3,2,1680,8487,1680,0,47.1959,-122.01
250000,3,1,990,8100,990,0,47.4839,-122.341
438800,4,2.5,2770,4432,2770,0,47.4541,-122.117
290000,2,1,950,5650,950,0,47.5149,-122.257
324950,4,2,2160,4800,1290,870,47.4777,-122.212
453000,3,2.5,1650,1838,1270,380,47.6666,-122.367
556000,3,1,1800,4005,1160,640,47.6876,-122.38
315000,3,2,1660,11135,1660,0,47.4897,-121.787
445830,3,2.5,1870,5449,1870,0,47.7557,-122.22
1.26E+06,3,3.5,3220,3960,2760,460,47.5909,-122.384
287200,3,3,1850,19966,1090,760,47.3493,-122.034
525000,4,1.5,1580,6360,1290,290,47.6873,-122.286
1.135E+06,4,4.25,4590,17621,3160,1430,47.6973,-122.205
381000,3,1.75,2700,18246,1510,1190,47.4817,-122.097
360000,3,1.75,1020,7020,1020,0,47.7362,-122.314
619000,5,3.5,2950,2932,2950,0,47.5923,-122.298
535000,2,1.75,1780,224769,1780,0,47.4158,-122.002
402000,2,1,710,5100,710,0,47.6765,-122.381
600000,4,3.5,4300,70407,2710,1590,47.4472,-122.092
549950,3,2.5,2080,8690,1430,650,47.4424,-122.344
300000,4,2,2360,7440,1180,1180,47.5044,-122.245
360000,6,2,2210,9870,2210,0,47.4751,-122.145
419000,7,3.25,4340,8521,2550,1790,47.52,-122.338
510000,3,3,1320,1012,1320,0,47.6904,-122.395
319950,3,2.5,1980,9907,1980,0,47.1903,-122.013
1.18E+06,5,5,3960,94089,3960,0,47.38,-122.011
381000,4,2.5,2130,6003,2130,0,47.4518,-122.12
256900,3,2.5,1720,3951,1720,0,47.4033,-122.187
346000,5,1,1790,30456,1350,440,47.3469,-122.195
465000,2,2.25,1390,1222,1340,50,47.6754,-122.121
545000,3,2,1900,9975,1500,400,47.5307,-122.054
516000,2,1.75,1640,3090,910,730,47.679,-122.319
550000,4,2.5,2700,5100,1440,1260,47.5331,-122.384
339950,4,2.25,2200,7150,2200,0,47.3595,-122.089
417000,3,1,1310,8514,1310,0,47.7502,-122.353
906000,4,2.5,2480,5000,1480,1000,47.6653,-122.272
980000,4,2.25,3010,9800,3010,0,47.5336,-122.223
555000,4,2.5,2450,5079,2450,0,47.5214,-122.191
468000,2,1.75,1250,7029,1250,0,47.6936,-122.186
378000,3,1.75,2610,117176,1390,1220,47.2585,-121.925
430000,4,2.5,2010,16020,2010,0,47.4821,-122.108
730100,4,2.5,3120,14300,3120,0,47.5318,-122.055
219000,4,1.5,1370,7944,1370,0,47.4224,-122.289
570000,3,2.5,2420,11953,2420,0,47.6285,-122.054
262500,4,2.75,1500,7036,1060,440,47.3665,-122.276
525000,5,2.5,2630,9216,2630,0,47.7379,-121.966
520000,2,1,950,3880,950,0,47.687,-122.389
417400,3,3,2680,12285,2680,0,47.4633,-122.196
788000,4,3.25,3680,5759,2840,840,47.5367,-122.067
320000,3,1,1270,7400,1270,0,47.4831,-122.191
950000,6,1,2330,5000,2330,0,47.6789,-122.397
255000,3,1,960,8100,960,0,47.7766,-122.307
260000,4,2.5,1990,6671,1990,0,47.3078,-122.358
394000,3,1,1450,7930,1150,300,47.5212,-122.371
575000,4,2.5,2280,27441,2280,0,47.7628,-122.123
1.25E+06,4,2.25,1830,7200,1750,80,47.6315,-122.282
385000,3,2.25,1650,7800,1260,390,47.7377,-122.197
456000,5,2.75,2720,193406,1700,1020,47.2838,-122.121
637000,4,2.5,1710,5000,1110,600,47.6772,-122.285
485000,5,1.5,1420,9900,1050,370,47.6348,-122.118
315275,3,1.75,1440,8040,960,480,47.7128,-122.306
252500,2,1.5,1280,8710,1280,0,47.4472,-122.16
240000,2,1,1320,24319,1320,0,47.4741,-122.015
790000,4,2.5,2560,12760,1760,800,47.6947,-122.303
310000,3,1,1480,7830,1480,0,47.7703,-122.336
1.25E+06,4,2.5,2960,20240,2960,0,47.5075,-122.389
425000,2,1,1160,5038,740,420,47.5304,-122.38
548000,3,2.5,2110,4099,2110,0,47.7508,-122.17
379880,3,2.5,1650,14054,1130,520,47.4821,-122.017
530000,3,2.5,1950,9906,1950,0,47.6363,-122.025
695000,3,2.25,2600,220300,2120,480,47.4562,-122.016
435000,3,1,1270,4000,1270,0,47.5695,-122.376
540000,3,1.75,1300,62290,1300,0,47.6529,-121.979
425000,3,2.25,1790,10209,1290,500,47.7492,-122.086
490000,3,2.5,1930,7266,1930,0,47.7191,-122.309
220000,4,1,1200,6000,1200,0,47.5307,-122.352
540000,4,2.5,2050,3784,2050,0,47.7189,-122.181
670000,3,1,1710,6195,1410,300,47.6706,-122.265
667500,3,1.75,2130,20423,2130,0,47.6339,-122.192
585000,3,3.5,1700,2197,1260,440,47.5767,-122.41
225000,3,1.5,1390,12500,1390,0,47.6496,-121.908
375000,3,1,1230,9877,1230,0,47.5745,-122.136
335000,3,2,1490,8847,1490,0,47.7639,-122.363
680000,5,3.25,2440,15815,1990,450,47.774,-122.28
600000,3,1,970,4800,970,0,47.6212,-122.298
161000,4,2,1700,8043,850,850,47.4758,-122.288
220000,4,2,1700,8043,850,850,47.4758,-122.288
420000,3,1.75,1720,5000,1720,0,47.738,-121.983
710000,3,1,1400,2250,1400,0,47.6373,-122.358
626000,4,2.5,2570,7221,1570,1000,47.6921,-122.387
279500,3,1.5,1200,8040,1200,0,47.4901,-122.341
1.61E+06,4,3.5,4390,11600,3060,1330,47.5862,-122.246
325000,2,1,1080,5000,1080,0,47.5682,-122.359
380000,4,2.25,1860,7980,1860,0,47.4524,-122.15
470000,4,2.75,2150,9820,1220,930,47.7758,-122.2
363000,4,3,2250,12142,2250,0,47.4338,-122.16
245000,4,2.25,2050,7700,2050,0,47.3009,-122.375
525000,3,1,1010,3520,1010,0,47.6208,-122.319
1.7E+06,5,3.5,5850,22885,4670,1180,47.606,-122.211
658500,4,2.25,1900,5000,1400,500,47.6456,-122.387
680000,2,1,1020,8442,920,100,47.5145,-122.391
835000,4,2,3390,16025,3390,0,47.7222,-122.056
595000,4,2.5,1990,2175,1680,310,47.6696,-122.371
419000,4,2.5,3190,4980,3190,0,47.3657,-122.034
198900,2,1,1210,18700,1210,0,47.3752,-122.166
1.085E+06,4,3.25,3740,12080,2000,1740,47.7214,-122.056
500000,3,3.5,2150,4368,1610,540,47.6213,-122.065
575000,4,1.75,2440,8100,1620,820,47.7201,-122.361
324950,2,1.5,1230,1516,1230,0,47.7265,-122.314
259000,3,2.5,2740,7980,2740,0,47.473,-122.3
551000,2,2,2260,9604,2260,0,47.7718,-122.208
488000,2,1.5,1000,5125,1000,0,47.6926,-122.347
635000,4,2.25,2350,46173,2350,0,47.6657,-122.067
395000,3,2.5,2300,8938,2300,0,47.4181,-122.211
370000,3,1,1440,8287,1440,0,47.7438,-122.315
675000,4,3,2780,5000,1710,1070,47.5721,-122.381
402000,3,1,1200,6825,1200,0,47.7491,-122.353
825000,3,2.75,3040,24192,3040,0,47.7108,-122.225
579000,3,2.75,2660,223027,1330,1330,47.4127,-122.071
455000,5,2,1510,3000,1510,0,47.6029,-122.304
265000,3,2.5,1780,6527,1780,0,47.2578,-122.217
713500,5,2.75,2920,9163,1520,1400,47.5668,-122.169
240000,3,1,1550,12670,1550,0,47.5024,-122.169
570000,4,3,2710,217800,2710,0,47.2411,-121.932
243800,3,1,1140,27760,1140,0,47.5372,-121.972
543000,2,1,940,3864,940,0,47.6631,-122.345
1.01E+06,3,2.25,2160,7500,2160,0,47.6232,-122.299
625000,4,2.25,2470,17008,2470,0,47.5924,-122.048
459950,4,2.5,2800,6567,2800,0,47.3555,-122.002
370000,4,2.75,2420,39704,2420,0,47.4053,-122.03
150000,4,2,1460,7254,1460,0,47.5056,-122.254
683500,3,1.5,1820,5756,1640,180,47.6479,-122.367
499950,3,2.5,1520,2208,1040,480,47.6419,-122.374
255000,2,1,1320,9967,940,380,47.5693,-122.296
279000,3,2.5,1920,7779,1920,0,47.4024,-122.171
910000,5,3,2640,5096,2640,0,47.6809,-122.288
699000,4,2.5,2650,7945,2650,0,47.7113,-122.296
1.651E+06,4,3.25,3640,13530,2570,1070,47.6293,-122.238
248000,3,1,1420,8800,1090,330,47.3746,-122.181
429000,3,1,1540,37950,1090,450,47.3259,-122.289
685000,4,1,1550,15239,1370,180,47.4502,-122.378
316000,2,1,730,5040,730,0,47.5387,-122.374
410000,2,1,2020,7540,1010,1010,47.5359,-122.28
299000,3,1,1200,15843,1200,0,47.4991,-121.779
559000,2,1,1240,6400,1060,180,47.5493,-122.377
575000,3,2.25,2680,100188,1580,1100,47.4776,-122.02
602000,3,2.5,1640,3804,1640,0,47.6103,-122.3
492000,4,2,1640,5000,1640,0,47.6662,-122.365
293500,3,2.5,1610,5024,1610,0,47.3833,-122.043
481000,3,2.75,2290,14810,1400,890,47.5343,-122.185
311100,4,2.25,2130,8078,1380,750,47.4482,-122.209
375000,3,1.75,2140,13598,1620,520,47.7139,-121.321
1.075E+06,3,3,4020,435600,4020,0,47.4418,-121.731
500000,5,2.5,2030,8400,1330,700,47.6713,-122.152
553000,3,1,1380,6250,1380,0,47.5514,-122.385
760000,3,2,1780,1750,1400,380,47.6797,-122.357
589500,4,1.5,1440,3200,960,480,47.5269,-122.383
840000,5,2.75,2790,20824,1680,1110,47.6948,-122.282
2.546E+06,4,3,4190,8805,3490,700,47.6181,-122.284
1.275E+06,3,2.5,3870,46609,3870,0,47.5966,-122.112
260000,3,2.5,1850,7875,1250,600,47.434,-122.171
430000,3,2.25,1550,1469,1550,0,47.6911,-122.341
781000,3,2.5,1920,1896,1920,0,47.6616,-122.356
280000,2,1,790,13170,790,0,47.5487,-122.357
392000,5,2.25,3740,32481,2240,1500,47.3965,-122.314
466200,3,1.5,1340,8856,1340,0,47.6094,-122.126
641000,3,1.75,1620,3975,940,680,47.6786,-122.368
350000,3,1,1680,8010,840,840,47.6993,-122.376
450000,3,2,1610,4364,1610,0,47.5672,-122.004
1.8E+06,4,3.5,4460,16953,2550,1910,47.6338,-122.232
185000,3,1.5,1200,1848,1200,0,47.4658,-122.191
290000,2,1,1250,12507,1250,0,47.4972,-122.176
964000,3,2.5,3630,9475,3630,0,47.6544,-122.085
2E+06,4,3,4260,18000,4260,0,47.5355,-122.24
545000,3,2.5,2180,15693,1850,330,47.592,-122.082
609950,3,2.25,1760,10350,1330,430,47.6605,-122.188
605000,4,2,1820,7626,990,830,47.6878,-122.342
550000,4,2.5,2120,9163,1450,670,47.5551,-122.172
905000,4,2.75,2730,4268,2730,0,47.6397,-122.395
384200,3,2.5,2430,7613,2430,0,47.4383,-122.135
370000,3,1,1170,1105,1170,0,47.5448,-122.375
717500,3,1,2090,4000,1890,200,47.6393,-122.392
1.999E+06,4,3.25,3910,7500,2550,1360,47.6448,-122.409
365500,2,1,1140,15624,1140,0,47.7673,-122.367
580000,2,1.5,1460,5700,1460,0,47.6838,-122.312
415000,4,1.5,2700,14760,2700,0,47.1996,-122.003
272000,2,1,670,6300,670,0,47.5145,-122.374
600000,3,1.75,1880,6360,1040,840,47.6878,-122.286
744000,4,3,1980,5352,1980,0,47.532,-122.385
830000,3,3,2080,10521,2080,0,47.6987,-122.228
322000,3,3.25,1380,1225,1380,0,47.7035,-122.351
270000,3,2.5,1808,19200,1808,0,47.2598,-122.281
272450,3,1,1350,7973,1350,0,47.4323,-122.292
605000,3,3,1760,2114,1400,360,47.6666,-122.37
510000,3,1.75,1950,8325,1950,0,47.7685,-122.2
1.125E+06,4,3.5,3170,4000,2340,830,47.6265,-122.298
1.688E+06,4,2.5,3000,7500,3000,0,47.6571,-122.277
162000,4,1,1460,16638,1460,0,47.3431,-122.048
337500,3,1.75,1350,5850,1050,300,47.4225,-122.328
312000,3,2.25,1470,7857,1180,290,47.4547,-122.209
740000,4,3,3350,199253,3350,0,47.3602,-121.988
700000,4,3,3350,199253,3350,0,47.3602,-121.988
328000,4,1,1360,8136,1360,0,47.7366,-122.333
241000,3,1,1020,7538,1020,0,47.3587,-122.288
265000,3,2.25,1840,6750,1270,570,47.4075,-122.172
246000,5,1.75,2030,10200,2030,0,47.2867,-122.209
271000,4,1.75,1490,9112,970,520,47.4991,-122.345
270000,2,1,2060,8398,1260,800,47.509,-122.324
395000,4,2,2240,7085,2240,0,47.7309,-122.305
340000,3,2,1460,5715,1460,0,47.54,-122.276
340000,3,1.75,2140,13260,1240,900,47.5074,-122.353
335000,2,2.25,1420,1246,1420,0,47.5394,-122.368
435000,2,1,1060,3036,1060,0,47.6578,-122.324
527950,4,1.75,1760,3600,880,880,47.6889,-122.33
600000,2,2.25,2320,18919,2320,0,47.3905,-122.462
667000,3,1.75,1770,3880,1300,470,47.6846,-122.392
1.148E+06,10,5.25,4590,10920,2500,2090,47.5861,-122.113
417000,3,2.5,2040,11211,2040,0,47.4867,-122.223
451000,4,1.75,1260,7250,1260,0,47.5267,-122.032
580000,2,1,1650,9780,950,700,47.6549,-122.394
570000,4,2.25,2380,36446,2380,0,47.7644,-122.072
750000,5,3.25,2750,7500,2150,600,47.6636,-122.203
685000,3,2.5,2810,7700,2810,0,47.5464,-122.191
275000,3,2,1340,9764,1340,0,47.6786,-122.161
739888,3,2.5,2420,43177,1690,730,47.569,-122.058
715000,2,2.5,2160,5581,2160,0,47.7017,-122.023
800000,4,2,2450,4400,1450,1000,47.6414,-122.327
350000,3,1.5,1870,9000,1120,750,47.5224,-122.318
220000,3,1,1000,223462,1000,0,47.2099,-122.043
452500,3,2.5,2240,7791,2240,0,47.5361,-121.88
280000,4,2.5,2200,5893,2200,0,47.3333,-122.055
248000,1,1,790,12000,790,0,47.5146,-122.265
305000,2,1,890,7200,740,150,47.6998,-122.278
435010,3,1,1270,4000,1120,150,47.5293,-122.354
678100,3,1.75,1850,2860,1210,640,47.5853,-122.39
325000,3,2.25,1352,1694,1352,0,47.7265,-122.315
529950,3,2,1540,8400,1180,360,47.6554,-122.129
440000,3,1.75,1640,8529,1640,0,47.7751,-122.32
585000,3,1,1350,4800,1350,0,47.5749,-122.412
462608,3,2.5,2010,2778,1390,620,47.5528,-121.999
350500,3,1.75,2080,5200,1040,1040,47.4738,-122.35
210000,3,1,1040,8125,1040,0,47.3171,-122.316
510000,3,2.5,1890,5929,1890,0,47.5697,-121.994
280000,3,2.25,1810,7630,1810,0,47.497,-122.18
385000,3,1.75,1930,14389,1130,800,47.7733,-122.317
349000,3,1,1010,8184,1010,0,47.7416,-122.319
252000,3,2.25,1740,10836,910,830,47.3976,-122.166
1.1E+06,4,2.5,2910,8881,1940,970,47.6424,-122.411
375000,3,2.25,1330,8004,1330,0,47.7098,-122.217
336000,4,2.25,2210,11700,2210,0,47.3648,-122.284
732000,3,3.75,2670,6517,2020,650,47.5702,-122.38
200000,2,1,1000,6227,1000,0,47.513,-122.333
681716,4,2.5,3150,7277,3150,0,47.5159,-122.202
235000,3,1.75,1520,12246,1520,0,47.3434,-122.049
257500,3,1,1690,13825,1210,480,47.4256,-122.322
315000,3,1,1070,9497,1070,0,47.7425,-122.23
299950,3,1,910,8000,740,170,47.7746,-122.378
530000,4,2.25,2130,8640,1430,700,47.7087,-122.198
766500,2,1.75,2230,6930,1530,700,47.6705,-122.277
860000,4,2.5,3560,11119,2290,1270,47.6456,-122.19
690000,3,2.5,2590,4961,2590,0,47.5271,-122.381
551000,4,1.75,2040,6348,1020,1020,47.6964,-122.336
530000,3,2.75,2100,20150,2100,0,47.7206,-122.248
568000,3,1,1340,7260,1340,0,47.7016,-122.295
749950,3,2.5,2770,10773,2770,0,47.5754,-122.12
535000,3,2.5,2400,12546,2400,0,47.6317,-122.041
234300,3,1,1140,9779,1140,0,47.424,-122.201
190000,2,1,930,11450,930,0,47.4862,-122.264
525000,4,1.75,1820,6600,1820,0,47.606,-122.135
610000,4,1,1390,3708,1390,0,47.685,-122.363
520000,3,2.5,1480,1165,1480,0,47.6199,-122.3
375000,2,1,760,6000,760,0,47.646,-122.384
600000,3,1.75,1580,7416,1150,430,47.6056,-122.173
664000,4,2.5,1870,16200,1250,620,47.6651,-122.174
698000,2,1,1510,4080,1010,500,47.6742,-122.329
418000,3,2,1250,1306,1250,0,47.6705,-122.39
271675,3,1.75,2140,13068,1460,680,47.3099,-122.197
450000,3,1,1540,9028,1540,0,47.6698,-122.177
759000,3,2.25,2950,78843,2950,0,47.5917,-122.068
599950,6,3,2020,4129,1230,790,47.6648,-122.324
810000,4,2.75,2820,5000,2170,650,47.6376,-122.394
331292,3,1.75,1660,10000,1660,0,47.741,-121.978
348000,3,1.75,1830,2417,930,900,47.5723,-122.309
435000,2,1,720,5600,720,0,47.5641,-122.391
530000,3,2.5,2160,9063,2160,0,47.7296,-122.333
227000,3,1.75,1510,9837,1510,0,47.2576,-122.255
285000,3,1.5,1870,42070,1870,0,47.509,-122.313
740000,4,2.25,2860,26136,1640,1220,47.6033,-122.158
246000,3,1,990,9145,990,0,47.5022,-122.36
260000,3,1,1910,8710,1080,830,47.5038,-122.3
366000,3,2,1350,10200,1350,0,47.6159,-122.05
594950,4,3.25,2557,9480,2557,0,47.5449,-122.262
608000,3,2.75,2610,5000,1710,900,47.6729,-122.373
313100,3,2,1720,11875,1720,0,47.5068,-122.191
185000,3,1.75,1170,9085,1170,0,47.2808,-122.354
455000,2,1,1140,11480,1140,0,47.5328,-122.274
235000,3,2.5,2350,9051,1570,780,47.3126,-122.364
230000,3,1,1020,12289,1020,0,47.4235,-122.155
770000,4,2.25,2730,5000,1460,1270,47.5843,-122.393
240000,4,2.25,1830,7614,1830,0,47.3682,-122.179
461000,3,2.5,1690,3026,1690,0,47.6885,-122.043
1.58E+06,4,2.5,2900,10500,1450,1450,47.5838,-122.246
1.8225E+06,4,4.5,6380,88714,6380,0,47.5592,-122.015
452000,3,2.5,1690,4000,1690,0,47.6788,-122.034
765000,4,2.5,2660,5043,2660,0,47.5445,-121.996
1.05E+06,4,4,4550,54013,2300,2250,47.5964,-122.077
546000,3,3,1530,9999,1150,380,47.6869,-122.186
781000,3,2.5,2070,4463,1780,290,47.6853,-122.305
538000,4,1.75,1880,7953,1880,0,47.5838,-122.123
790000,4,2.5,2240,8664,1470,770,47.6621,-122.189
696500,4,2.75,2540,4400,1630,910,47.6832,-122.343
276000,3,2,1370,8137,1370,0,47.2802,-122.303
269000,2,1,770,8612,770,0,47.7547,-122.323
2.415E+06,5,4.75,7880,24250,7880,0,47.7334,-122.362
829000,4,2.75,2970,59677,1610,1360,47.5953,-122.08
122000,2,1,740,6840,740,0,47.5168,-122.373
352500,3,1.5,1360,7680,1360,0,47.7441,-122.337
249000,4,2,1280,7560,1280,0,47.45,-122.175
360000,4,2,1920,7803,1080,840,47.758,-122.325
629500,3,2,2020,10584,2020,0,47.5851,-122.028
1.14E+06,4,2.25,3310,127631,3310,0,47.732,-122.134
1.55E+06,2,2.25,2950,15593,1560,1390,47.6209,-122.236
275000,3,1.5,1320,7695,1320,0,47.4908,-122.181
697000,4,2.5,3160,6961,3160,0,47.6125,-122.01
379500,2,1,1640,17335,840,800,47.6397,-121.953
720000,3,2.75,2440,76531,1640,800,47.7672,-122.161
675000,4,2.5,3000,5548,3000,0,47.5399,-122.188
1.169E+06,5,2.5,2810,6000,2810,0,47.6367,-122.35
1.1E+06,3,2,2390,6888,2390,0,47.6839,-122.274
520000,4,1,2080,3500,1260,820,47.5445,-122.383
415000,3,1.75,2650,7500,1590,1060,47.7716,-122.317
415000,3,2.5,1060,1536,1060,0,47.6907,-122.395
450000,3,2.25,1940,8312,1220,720,47.4556,-122.346
485000,2,1,1080,4080,1080,0,47.6899,-122.32
294000,3,2.25,1700,9600,1700,0,47.39,-122.158
1.037E+06,4,3.5,4440,10660,4440,0,47.5294,-122.137
690000,3,1,1580,4000,1580,0,47.6363,-122.32
716500,5,2.75,3630,38461,3630,0,47.4289,-122.094
481000,2,2.25,1290,1137,1290,0,47.6718,-122.382
575000,4,2.75,1960,4635,1000,960,47.5693,-122.285
785000,3,2,2090,5015,2090,0,47.6378,-122.301
480000,3,1.75,1960,43995,1960,0,47.4915,-122.106
720000,3,2.25,2120,9297,2120,0,47.5561,-122.154
536000,3,2.75,2290,34548,2290,0,47.3691,-122.163
324900,4,2.5,1880,7965,1880,0,47.3642,-122.052
265000,2,1,770,5160,770,0,47.5304,-122.356
545000,3,2.5,1530,3210,1010,520,47.6913,-122.393
465000,2,1.5,1450,27075,1450,0,47.7281,-122.353
292500,3,2.25,1690,7320,1690,0,47.3889,-122.316
860000,4,1.75,1880,3720,1880,0,47.6431,-122.356
1.045E+06,4,3.25,4160,47480,4160,0,47.7266,-122.115
495000,4,2.5,2140,7245,2140,0,47.729,-122.35
342000,2,2,1320,1462,1320,0,47.7223,-122.29
320000,4,2.5,2000,10051,2000,0,47.3625,-122.025
444000,3,2,1460,2610,1460,0,47.6864,-122.345
804100,4,2.5,3070,8086,3070,0,47.5399,-122.16
432000,3,2.5,1660,15000,1660,0,47.5803,-122.05
230000,6,1.5,1810,4838,1050,760,47.4874,-122.202
935000,4,3.5,3510,11200,3510,0,47.5193,-122.15
634950,3,3,2180,2650,1410,770,47.6891,-122.375
780000,6,4,3300,5720,1960,1340,47.676,-122.309
611000,4,2.5,2460,4200,2460,0,47.6031,-122.021
475999,4,1.75,1880,4175,1090,790,47.6646,-122.364
565000,3,2,2290,9450,1670,620,47.5692,-122.1
630000,4,2.5,2290,26720,2290,0,47.7502,-122.374
840000,4,3.5,3860,18334,3120,740,47.7095,-122.075
790000,3,2.5,2640,432036,2640,0,47.1795,-122.036
450000,5,2.5,2850,209523,1930,920,47.3939,-122.089
1.272E+06,4,3.25,3020,4000,1920,1100,47.6395,-122.279
520000,3,2,1510,3760,930,580,47.5425,-122.39
446800,4,2,2410,8712,1260,1150,47.5729,-122.302
652000,3,1,1470,6122,1200,270,47.6517,-122.406
1.17E+06,3,2.75,2890,12130,2830,60,47.6505,-122.203
745000,4,3.25,3490,7024,3490,0,47.5834,-121.972
594000,3,2.25,1270,1406,1060,210,47.6647,-122.284
257000,2,1,1000,3700,800,200,47.552,-122.29
485000,4,1.75,1430,4096,1430,0,47.604,-122.306
330000,3,1,1060,20040,1060,0,47.7281,-122.235
381000,3,2,1680,8946,940,740,47.6379,-121.966
849900,2,2,2280,641203,2280,0,47.4125,-122.455
793000,4,2.5,2450,4080,1490,960,47.6899,-122.319
920000,3,2.25,3650,5353,2200,1450,47.5949,-122.291
455000,2,1,830,4000,830,0,47.6909,-122.381
975000,4,2.5,3490,7494,3490,0,47.559,-122.127
375000,2,1.5,1050,1046,960,90,47.6028,-122.309
400000,2,2.5,1170,1811,1170,0,47.6132,-122.297
447000,3,1,1220,7200,1220,0,47.6218,-122.116
470000,3,1.75,1310,8600,1310,0,47.686,-122.185
665000,4,2.5,3130,7582,3130,0,47.577,-122.055
295500,3,1.75,1590,41550,1290,300,47.4817,-122.28
200000,4,2.5,1720,8638,1720,0,47.2704,-122.313
620000,3,2.25,2520,212137,1590,930,47.7384,-121.878
434900,3,2,1520,11067,1140,380,47.6326,-122.033
1.328E+06,4,2.25,3260,4640,2360,900,47.6272,-122.312
1.65E+06,4,3.25,3910,7500,3910,0,47.6527,-122.198
852500,4,2.5,3480,6315,2360,1120,47.6841,-122.161
790000,3,2.5,3040,34670,3040,0,47.7565,-122.129
565000,4,1.75,2030,7350,2030,0,47.6274,-122.094
1.1275E+06,6,3.25,3870,24700,2520,1350,47.7517,-122.233
289950,3,2.5,1870,1436,1870,0,47.4899,-122.166
850000,2,2,2640,13939,1640,1000,47.5647,-122.165
505000,4,1.75,1940,4800,1030,910,47.6054,-122.314
372000,3,2.5,1710,5633,1710,0,47.7232,-122.161
207000,4,2,1690,7728,1690,0,47.3666,-122.318
780000,3,1.75,2340,10495,2340,0,47.5386,-122.226
400000,4,1.75,1700,20283,1340,360,47.7694,-121.903
440250,3,1.5,1850,8124,1850,0,47.7275,-122.359
585000,2,2,1370,7920,950,420,47.6589,-122.397
850000,4,2.5,2900,9972,2900,0,47.5536,-122.121
570000,3,3,2400,3192,2400,0,47.6963,-122.348
869000,4,3,3740,30884,3060,680,47.7505,-122.117
551000,4,2.75,2170,5988,2170,0,47.7484,-122.317
172380,3,1,970,8378,970,0,47.3078,-122.365
355000,3,2.5,2620,78843,1310,1310,47.2584,-122.093
728935,4,2.5,2980,10194,2980,0,47.5515,-122.12
850000,3,2.5,2340,1919,2340,0,47.6512,-122.203
515000,5,1.75,1880,48787,1880,0,47.5094,-122.165
215000,2,1,1480,5325,1120,360,47.2079,-121.993
220000,4,2.5,2240,9826,1370,870,47.314,-122.364
845000,4,2.5,2940,7675,2940,0,47.7054,-122.129
390000,1,1,710,4000,610,100,47.6562,-122.354
135000,4,1,1460,18599,1460,0,47.5006,-122.351
439000,3,1,1530,19007,1290,240,47.4508,-122.352
585000,4,2.5,2630,6185,2630,0,47.5229,-122.192
620000,5,1,2230,16800,1700,530,47.5161,-122.395
477000,3,1,960,3600,960,0,47.6758,-122.369
399500,2,1.5,1180,1722,1180,0,47.5626,-122.384
500000,2,1,1760,27332,1300,460,47.3799,-122.325
432500,3,2.5,1340,8867,1340,0,47.724,-122.327
940000,4,2.25,2800,18673,1650,1150,47.5893,-122.177
3.16875E+06,5,3.5,4330,11979,2090,2240,47.6251,-122.218
1.08E+06,3,2.5,3720,11610,3720,0,47.636,-122.049
229999,4,2,1670,5200,1030,640,47.3652,-122.09
233000,3,1,1100,7657,1100,0,47.4374,-122.285
600000,3,2.5,3240,8016,2910,330,47.5382,-121.877
334000,4,1.5,1680,7620,1180,500,47.4578,-122.351
332500,3,1,1030,8164,1030,0,47.7353,-122.334
249900,3,2.5,1630,7700,1120,510,47.3876,-122.211
310000,3,2,2610,12180,1670,940,47.5063,-122.346
200000,2,1,1250,8520,1250,0,47.5158,-122.378
310000,4,1.75,1480,11200,1480,0,47.5064,-122.141
230000,3,1,1390,6000,1390,0,47.4977,-122.175
420000,4,2.5,1940,5414,1940,0,47.5461,-122.299
785000,4,2.5,2960,4750,2960,0,47.5544,-121.993
1.775E+06,3,2.25,4320,19225,2160,2160,47.6368,-122.216
265000,5,1.5,1500,7112,760,740,47.4692,-122.35
295000,2,1,840,10465,840,0,47.755,-122.317
896000,4,2.5,3560,46644,3560,0,47.7268,-122.05
415000,4,2.75,2390,9968,1390,1000,47.3706,-122.056
250000,3,1.75,1200,5478,1200,0,47.4959,-122.174
1.475E+06,3,2.5,2570,5000,2570,0,47.6295,-122.32
635000,5,2.25,2180,6000,1430,750,47.6235,-122.143
905000,3,2.5,3450,48787,3450,0,47.739,-122.129
528000,3,2.5,2020,5613,2020,0,47.6835,-122.035
530000,3,2.5,2480,7480,2480,0,47.771,-122.166
310000,3,1.5,1140,3104,1140,0,47.5707,-122.018
252000,3,1,1530,9465,1530,0,47.4915,-122.151
334500,3,2,1700,8160,1120,580,47.74,-122.339
370000,3,1,2150,8480,1610,540,47.6996,-122.308
311000,3,2,1190,7840,1190,0,47.5531,-122.312
260000,3,2.75,1730,4131,1480,250,47.5327,-122.346
217500,3,1.75,1400,9546,1400,0,47.3179,-122.331
290000,3,2.5,2200,4240,2200,0,47.3715,-122.127
500000,3,1.5,960,4600,960,0,47.6937,-122.213
423500,3,2,1770,6000,1100,670,47.5644,-122.29
715000,4,2.5,2970,5722,2970,0,47.6134,-122.042
299000,3,2.5,1590,3121,1590,0,47.5515,-122.284
635000,3,2.5,3350,4007,2550,800,47.7277,-122.207
806000,4,2.5,3370,9629,3370,0,47.5896,-121.978
289950,3,2.5,1960,3480,1960,0,47.4802,-122.18
280000,3,1.75,1360,6603,1360,0,47.4619,-122.168
479950,3,2.5,2780,6000,2780,0,47.4569,-122.118
394000,4,2.5,3000,9793,3000,0,47.3655,-122.028
682000,4,2.5,3600,203425,3400,200,47.7597,-122.018
409950,2,1,990,3000,990,0,47.6839,-122.345
1E+06,4,3.5,2990,4200,2000,990,47.593,-122.289
436000,4,1,1200,6600,1200,0,47.5372,-122.382
279000,3,1,1530,15975,970,560,47.4766,-122.326
390000,1,1.75,1440,4920,720,720,47.534,-122.376
635000,3,1.75,1940,167125,1480,460,47.459,-122.504
304400,4,2.75,2140,8100,2140,0,47.3075,-122.359
780000,5,1.75,2330,3800,1360,970,47.6835,-122.308
520000,4,3.5,2734,210201,2734,0,47.3652,-122.504
580000,3,1.75,1950,10633,1250,700,47.7019,-122.313
274000,3,1.75,1440,7198,990,450,47.4333,-122.194
315000,3,2.25,1530,7906,1150,380,47.4418,-122.136
390000,4,1.75,1910,77574,1910,0,47.3932,-122.12
340000,5,2,1750,8220,1750,0,47.7694,-122.321
502000,3,2.25,1600,45613,1600,0,47.7523,-122.117
260000,3,1.75,1750,11180,1750,0,47.4713,-122.117
399000,2,1,940,4800,940,0,47.5756,-122.414
312500,2,1,880,6345,880,0,47.5341,-122.358
370000,3,1.75,1650,8254,1060,590,47.7596,-122.304
1.24E+06,4,3.5,3820,13224,3280,540,47.6005,-122.199
230000,3,1.5,1900,9630,1900,0,47.3352,-122.344
1.275E+06,4,1.75,3720,8448,1960,1760,47.6425,-122.406
294350,3,1,1410,5120,1210,200,47.5238,-122.355
208950,3,1,960,5700,960,0,47.4983,-122.172
515000,2,1.75,1930,5570,1930,0,47.7173,-122.034
965000,4,2.5,3420,9575,3420,0,47.5527,-122.095
925000,4,2.75,3010,3400,2240,770,47.6142,-122.284
654500,4,1,1780,5000,1780,0,47.6761,-122.297
364000,4,2.5,2080,11050,2080,0,47.472,-122.119
150000,2,1,1250,5208,1050,200,47.3063,-122.219
349950,5,3,2257,10117,1363,894,47.4524,-122.284
585000,3,1.5,1670,5000,1670,0,47.678,-122.36
801501,4,2.25,2250,13500,2250,0,47.621,-122.151
610000,3,1.75,1650,221720,1650,0,47.5297,-121.901
382000,5,2.25,2880,11965,2880,0,47.3734,-122.124
495000,4,3,3620,403693,3620,0,47.2527,-121.98
447500,3,1.75,1950,6504,1530,420,47.6934,-122.328
575000,4,2.5,2280,9491,1290,990,47.6297,-122.117
565000,2,1.75,1740,4736,1040,700,47.5994,-122.287
348580,3,1,1220,7876,1220,0,47.7317,-122.201
459000,4,1.75,2260,9703,1660,600,47.6622,-122.145
375000,4,2,1790,61419,1790,0,47.7216,-121.907
310000,4,2.5,2440,7093,2440,0,47.3817,-122.204
210000,3,1.5,1400,9600,1400,0,47.2878,-122.297
384205,3,2.75,1810,3292,1810,0,47.5164,-121.877
180000,2,1,1400,4500,900,500,47.4866,-122.219
310000,2,1,1400,4500,900,500,47.4866,-122.219
427500,4,2.5,2010,6294,2010,0,47.776,-122.24
780000,3,3,2520,2152,1560,960,47.6363,-122.371
1.762E+06,3,2.25,3060,16000,3060,0,47.6189,-122.23
339950,4,2.5,2150,4000,2150,0,47.3655,-122.018
820000,3,2.25,2880,9750,2880,0,47.5575,-122.119
398000,2,2,1300,3865,1300,0,47.7193,-122.024
492000,3,1.75,2770,39927,1580,1190,47.4669,-122.003
240000,4,1.5,1780,14810,1180,600,47.3581,-122.288
599950,4,3.5,3730,15029,2440,1290,47.3804,-122.163
105500,2,1,930,7740,930,0,47.4611,-122.324
445000,2,1,930,7740,930,0,47.4611,-122.324
390500,2,1.75,1460,426450,960,500,47.2079,-121.967
255000,3,2,1310,8454,1310,0,47.3697,-122.075
675750,4,2.5,2770,10274,2770,0,47.5748,-122.018
1.64E+06,3,3.25,3140,5445,2240,900,47.6406,-122.347
353500,4,2.5,1770,9239,1770,0,47.3512,-122.006
765000,3,1,1220,7585,1220,0,47.6094,-122.194
563500,4,2.5,2190,4944,2190,0,47.5341,-121.866
439000,4,2,1800,5465,900,900,47.561,-122.272
975000,5,2.75,3100,10014,1660,1440,47.5734,-122.213
469900,3,2.5,2270,4399,2270,0,47.5415,-121.884
252000,3,1,1300,8184,1300,0,47.7469,-122.319
495000,3,2,1769,9300,1769,0,47.441,-122.342
570000,6,2.5,3370,15625,1770,1600,47.4223,-122.343
327000,4,2.5,1630,5361,1630,0,47.5704,-122.294
898000,2,2.25,2470,7658,1480,990,47.653,-122.416
300000,4,2.5,2600,8572,2600,0,47.3155,-122.266
418500,3,2,1800,12440,1220,580,47.6254,-122.05
450000,4,2.5,2240,4616,1840,400,47.5118,-122.194
403000,3,2,1960,13100,1650,310,47.4419,-122.34
440000,3,1,1710,6556,1200,510,47.7185,-122.354
350000,4,1.75,2140,4959,1080,1060,47.5166,-122.266
240000,3,2,1400,6200,700,700,47.7634,-122.34
460000,2,1,890,2100,760,130,47.656,-122.359
825000,4,1,1820,4000,1820,0,47.6259,-122.321
267500,3,2.25,1860,12000,1860,0,47.2942,-122.19
201000,3,1,1220,22443,1220,0,47.2633,-122.245
479500,3,2.75,2300,4637,2300,0,47.5216,-121.878
210000,2,1,1520,4700,1520,0,47.3187,-122.182
445000,2,1,1440,3225,960,480,47.6653,-122.338
265000,3,1.75,1170,8148,1170,0,47.7479,-122.318
399000,3,1.75,1170,8148,1170,0,47.7479,-122.318
785000,4,2.25,3200,53357,3200,0,47.755,-122.035
831500,5,2.5,4470,35124,4470,0,47.7377,-122.084
360000,4,2.5,2570,4557,2570,0,47.367,-122.115
655000,3,2.5,2370,7916,2370,0,47.528,-122.171
449950,4,1.5,1800,10150,1800,0,47.7325,-122.242
612000,5,2.5,2300,7000,1290,1010,47.6875,-122.122
575000,3,2.5,3240,33661,3240,0,47.4785,-122.095
557000,3,2.5,2280,18241,960,1320,47.7453,-122.213
375000,4,1.75,1870,12500,1030,840,47.511,-122.197
369000,3,2.25,1820,99752,1820,0,47.2838,-122.006
330000,5,2.75,2390,6282,1290,1100,47.5149,-122.263
1.031E+06,4,1.75,2110,6708,1410,700,47.67,-122.274
550000,2,1,980,4800,980,0,47.6569,-122.348
338000,3,1.75,1250,7710,1250,0,47.7623,-122.317
1.9E+06,4,2.5,3680,13351,3680,0,47.6154,-122.214
235000,3,1,2230,8163,1230,1000,47.5215,-122.275
349950,1,1,1230,9300,1230,0,47.7055,-122.348
300000,5,2.5,2093,10350,2093,0,47.4495,-122.17
431000,3,1.75,1660,12865,1660,0,47.5375,-122.175
280000,5,2.5,1630,20750,1100,530,47.3657,-122.113
295000,4,2.5,1677,7209,1677,0,47.2957,-122.357
445000,4,2.5,2990,6383,2990,0,47.3499,-122.027
550000,5,1,2150,262231,2150,0,47.5519,-121.803
515000,4,2.5,2890,15067,2890,0,47.5666,-121.907
555000,3,2.5,3050,158558,3050,0,47.4326,-122.208
265000,3,2.5,1410,2500,1410,0,47.5132,-122.358
597000,4,2.5,2280,2432,1520,760,47.6605,-122.355
661000,2,1,1260,5800,1260,0,47.6501,-122.409
362764,3,2,1460,4350,1460,0,47.696,-122.026
427000,4,2.5,1600,14000,1310,290,47.7258,-122.326
405000,3,1.75,2020,8531,2020,0,47.7691,-122.199
157000,3,1.5,1170,11530,1170,0,47.4211,-122.29
246500,3,1.5,1170,11530,1170,0,47.4211,-122.29
386500,2,1.5,1280,11071,850,430,47.6351,-122.033
300000,4,2.5,2680,15508,2680,0,47.3025,-122.39
240000,3,1.75,1770,8571,1270,500,47.3109,-122.339
818500,5,3.5,4790,12957,3110,1680,47.5469,-122.194
249000,3,1.75,1300,8500,1300,0,47.209,-122.005
580000,4,2.25,2610,7700,1700,910,47.5659,-122.089
2.34E+06,4,2.5,4500,35200,4500,0,47.5477,-122.126
333000,4,2.5,2100,7366,2100,0,47.3703,-122.107
230000,2,2,1340,7605,1340,0,47.1936,-121.981
360500,3,1,970,6180,970,0,47.5658,-122.291
265000,3,1.75,2200,7200,1270,930,47.3745,-122.276
490000,2,1,990,5000,990,0,47.5666,-122.403
600000,2,1.75,1180,5000,880,300,47.6749,-122.398
307500,3,1,980,6530,980,0,47.7133,-122.213
670000,4,2.25,2370,9636,1660,710,47.6497,-122.194
247200,3,1.5,1910,10583,1910,0,47.2782,-122.212
2.6E+06,4,4.5,5270,12195,3400,1870,47.5696,-122.09
440000,3,1.75,1430,8400,1430,0,47.6073,-122.127
700000,4,2.5,2490,7694,2490,0,47.567,-122.016
756100,4,2,2000,8317,2000,0,47.5394,-122.379
555000,4,2.75,2600,19275,1620,980,47.5523,-122.162
830000,5,3.5,2880,3750,2270,610,47.5905,-122.292
180000,3,1,1010,8863,1010,0,47.1955,-121.999
775000,5,3.5,3290,5600,2670,620,47.7056,-122.119
220000,4,1.75,1530,18400,1530,0,47.329,-122.219
650000,4,2.75,2020,15810,1620,400,47.5921,-122.155
410000,3,1.75,1340,9975,1340,0,47.7012,-122.169
339995,4,2.5,2180,5367,2180,0,47.3775,-122.022
1.16E+06,5,1.75,2870,9680,1440,1430,47.6122,-122.111
440000,3,2.75,2070,9697,1330,740,47.4327,-122.283
275000,2,1.75,930,7080,930,0,47.5224,-122.36
766000,3,2.5,2270,9822,2270,0,47.6685,-122.137
231500,3,2.25,1630,7900,1130,500,47.3076,-122.377
472000,3,2,2770,89298,2770,0,47.4291,-121.842
1.325E+06,4,2.5,4010,37076,4010,0,47.7139,-122.106
265000,4,1.75,1970,8390,1140,830,47.4861,-122.251
325000,2,1,790,6000,790,0,47.5543,-122.273
364500,3,1.75,1740,8424,1040,700,47.7508,-122.352
322500,2,1,1130,8184,1130,0,47.7473,-122.32
338900,3,1.75,1180,4000,1040,140,47.5226,-122.284
910000,5,2.5,2350,4000,2350,0,47.6265,-122.296
1.015E+06,5,2.5,2350,4000,2350,0,47.6265,-122.296
459950,3,1.75,1850,6869,1100,750,47.4648,-122.363
584950,4,3,3220,6224,3220,0,47.4813,-122.129
252000,3,1.75,2050,11313,1520,530,47.2837,-122.358
270000,3,2.5,1430,8470,1190,240,47.1943,-121.991
750000,4,2.5,3210,8938,3210,0,47.582,-121.971
775000,3,1.75,3520,12350,1530,1990,47.5837,-122.382
325000,3,2.5,2260,8120,2260,0,47.2924,-122.357
810000,5,3.25,3290,6422,3290,0,47.5933,-122.061
409000,2,2.25,1640,2128,1640,0,47.753,-122.252
400000,4,1.75,1580,5340,1130,450,47.6003,-122.306
530000,4,2.25,1940,8270,1940,0,47.7567,-122.333
580000,3,2.25,1580,8506,1580,0,47.686,-122.185
491300,3,1.75,1750,11340,1300,450,47.6099,-122.058
272000,4,2.75,1810,7350,1200,610,47.3703,-122.171
599950,3,2.5,1970,106722,1970,0,47.2498,-122.003
464000,3,2.5,1770,5146,1770,0,47.5704,-121.999
471001,3,1.75,1800,6000,900,900,47.6867,-122.349
230000,3,1.5,1500,11616,1100,400,47.4062,-122.174
358000,3,1,940,6695,940,0,47.6195,-122.12
510000,3,2.25,2340,6183,1210,1130,47.6979,-122.31
86500,3,1,840,9480,840,0,47.3277,-122.341
199950,3,1,840,9480,840,0,47.3277,-122.341
1.7125E+06,3,3.25,2940,5432,2440,500,47.6299,-122.354
850000,3,2.75,3180,3680,2190,990,47.577,-122.38
542000,4,2.5,2020,3440,1480,540,47.6885,-122.376
102500,2,1,820,4320,820,0,47.514,-122.359
718000,3,1.75,4060,136290,2810,1250,47.4843,-121.719
625000,4,2.25,2660,22194,2180,480,47.6142,-122.107
350000,3,1,1010,11244,1010,0,47.7467,-122.321
216000,2,1,710,5120,710,0,47.5224,-122.357
340000,3,1,980,7228,980,0,47.7294,-122.353
505000,3,1,1100,5400,1100,0,47.6604,-122.396
372000,5,2.5,2840,6010,2840,0,47.3161,-122.27
263850,4,2.25,2300,7524,2300,0,47.313,-122.388
1.35E+06,4,3.25,5370,20388,5370,0,47.405,-122.331
325000,4,2.5,2280,9899,2280,0,47.461,-122.148
289000,2,1,1010,7740,890,120,47.5323,-122.355
364000,3,2.25,1420,6600,1160,260,47.77,-122.265
610000,4,2.5,2100,8800,1250,850,47.6909,-122.186
531500,4,2.75,3110,49765,3110,0,47.3343,-122.044
402500,3,2.25,2160,9540,2160,0,47.7668,-122.243
375000,2,1,820,6250,820,0,47.5479,-122.384
537500,5,2.5,4340,9108,2170,2170,47.5384,-122.276
375000,3,1.75,2100,9066,1440,660,47.4294,-122.292
293550,4,1.75,1250,8840,910,340,47.4138,-122.317
585000,6,3,3870,43787,2700,1170,47.7642,-122.098
225000,2,2.5,1360,2693,1360,0,47.3492,-122.025
185000,4,1,1400,8684,1400,0,47.4887,-122.344
402000,3,1.5,1450,7375,1010,440,47.7212,-122.179
585000,5,1.75,1880,16617,960,920,47.6003,-122.132
549000,2,2.5,1380,953,1380,0,47.6654,-122.355
1.81E+06,3,2.25,2910,15626,2510,400,47.6534,-122.412
345000,3,1.75,1380,10529,1380,0,47.7119,-122.233
302500,3,2.25,3100,11985,1790,1310,47.3825,-122.31
218500,4,1.75,1400,25500,1400,0,47.36,-122.164
705000,2,2,1650,6840,1650,0,47.6512,-122.338
191000,3,1,840,5525,840,0,47.3607,-122.085
695000,3,2.5,2550,45254,2550,0,47.6498,-121.964
350000,2,2.75,2820,11770,1630,1190,47.5102,-122.324
480000,3,1.75,1710,4080,1130,580,47.5563,-122.392
220000,3,1,820,5200,820,0,47.363,-122.094
535000,4,2.25,2620,33578,2620,0,47.5921,-122.013
1E+06,2,1.75,2430,23400,2430,0,47.7616,-122.372
592000,3,1.75,1560,7424,1560,0,47.6981,-122.374
775000,4,2.5,3060,6826,3060,0,47.7006,-122.112
320000,3,2.5,1680,4584,1680,0,47.4794,-122.182
760000,3,3.25,3320,15022,3320,0,47.429,-122.341
640000,3,2.5,2390,8315,2390,0,47.6271,-122.028
253200,3,1,1360,5840,1360,0,47.4945,-122.166
228000,2,1,1800,9236,1800,0,47.3792,-122.198
325000,3,1,1160,9525,1160,0,47.7431,-122.073
530000,4,3.25,4160,35654,2760,1400,47.4683,-122.008
300000,4,2.25,1660,3200,1660,0,47.3666,-122.019
418000,3,2,1410,6030,1410,0,47.6994,-122.347
415000,4,1.75,2230,9625,1180,1050,47.508,-122.244
384000,3,2.5,1700,4000,1700,0,47.5327,-121.871
325000,3,2.5,2070,8337,2070,0,47.3658,-122.176
600000,3,1.75,2300,12682,2300,0,47.7588,-122.27
760000,4,2.25,3040,9690,1940,1100,47.5923,-122.169
168000,2,1.5,1220,3568,1220,0,47.3804,-122.318
405000,3,1,960,3960,960,0,47.6465,-122.404
479000,3,1,1480,10094,1480,0,47.5942,-122.136
549000,3,2,1560,5130,1150,410,47.6913,-122.333
215000,3,1.5,1100,33600,1100,0,47.3185,-122.29
550000,2,1.5,900,5750,900,0,47.5623,-122.384
389000,4,1.75,2400,7700,1500,900,47.7125,-122.332
447500,3,2.5,2320,15024,2320,0,47.4829,-121.766
540000,5,3,2570,5590,1580,990,47.7271,-122.228
273500,4,2.75,1300,9638,1300,0,47.3683,-122.109
257000,5,2.75,2930,10148,2930,0,47.4887,-122.145
199000,2,1,720,7200,720,0,47.4763,-122.177
339100,4,2.5,2350,10655,2350,0,47.3284,-122.171
435000,4,2.5,2940,7590,2940,0,47.4341,-122.16
400000,3,2.5,2020,3000,1010,1010,47.5621,-122.291
356000,2,1,1430,365904,1010,420,47.513,-121.857
395000,3,1,950,6951,950,0,47.7263,-122.3
575000,2,1,1250,4320,850,400,47.6549,-122.352
515000,3,1.75,1300,5120,1300,0,47.5589,-122.394
618250,4,3.25,2520,3360,1550,970,47.6801,-122.315
245000,3,1.5,1330,7125,1330,0,47.7308,-122.194
690000,3,2.75,2480,3240,1890,590,47.6399,-122.311
465000,5,2.25,3020,10010,1510,1510,47.5249,-122.044
280000,3,1.75,1770,8240,1240,530,47.3066,-122.378
285000,3,1.75,1930,6533,1230,700,47.4883,-122.221
320000,3,2.25,1650,7047,1650,0,47.3826,-122.027
355000,4,3,2580,9601,2130,450,47.3726,-122.433
670000,3,2,2570,10078,2570,0,47.6275,-122.12
550000,1,1,2880,7560,1440,1440,47.537,-122.375
765000,4,2.75,2660,4500,1860,800,47.6864,-122.347
430000,3,1,1560,5225,1260,300,47.5554,-122.279
950000,3,2.5,3080,8448,3080,0,47.6469,-122.389
525000,4,1.75,2540,7200,1270,1270,47.5579,-122.271
300000,6,2.5,3080,8163,1580,1500,47.3859,-122.221
345000,3,2.75,2190,7258,2190,0,47.3486,-122.301
838000,3,3.75,2930,150945,2930,0,47.4658,-122.115
1.795E+06,5,2.75,2880,20274,1660,1220,47.6267,-122.222
390000,3,1.75,2160,98445,2160,0,47.35,-122.162
1.15E+06,3,2,2110,18815,2110,0,47.5836,-122.042
295000,4,2.25,1830,5720,1830,0,47.3604,-122.179
775000,4,4,3180,7650,2530,650,47.6887,-122.319
380000,3,2.5,1880,6047,1880,0,47.3722,-122.044
550000,3,1,1140,8180,1140,0,47.5851,-122.172
199900,5,1.75,1798,11232,1798,0,47.3266,-122.291
329900,3,1.75,1670,5209,1670,0,47.5362,-122.271
898000,3,2.25,2580,11060,2580,0,47.6113,-122.164
875000,4,2.25,3720,12384,1860,1860,47.5836,-122.074
375000,4,2.5,2790,7956,2790,0,47.3681,-122.31
365000,3,2.5,2190,5091,2190,0,47.3506,-122.039
530000,4,2.75,2280,2850,1540,740,47.6871,-122.307
225500,3,1,1100,5200,1100,0,47.3643,-122.081
318000,4,2.25,2180,7000,1680,500,47.4651,-122.192
910000,4,2.5,2770,9798,2770,0,47.562,-122.081
207000,3,1,1980,18730,1280,700,47.3221,-122.282
1.8867E+06,5,3.5,4180,17935,4180,0,47.5873,-122.202
624500,6,3,3030,31920,1670,1360,47.575,-122.033
640000,3,2.5,1690,1553,1690,0,47.6443,-122.385
500000,3,2,1990,65340,1990,0,47.4726,-121.99
390000,5,1.75,2250,8970,1500,750,47.7217,-122.188
284000,3,2.25,2080,2050,1550,530,47.4199,-122.157
620000,3,2,2460,41343,2460,0,47.5142,-122.021
306000,3,2.5,2588,5702,2588,0,47.3453,-122.151
495000,4,1.75,2570,12039,1910,660,47.626,-122.048
499950,3,2.5,2370,12753,2370,0,47.7359,-121.984
330000,3,1,1070,10563,1070,0,47.7687,-122.166
665000,3,2,1940,5820,1150,790,47.6638,-122.362
850000,3,2.5,2650,2387,1830,820,47.6315,-122.362
599950,4,2.5,2290,6318,2290,0,47.57,-122.02
360000,4,2.5,2050,9143,2050,0,47.4597,-122.355
699000,3,2.5,2680,5497,2680,0,47.7043,-122.128
475000,3,1.75,1520,8100,760,760,47.6966,-122.375
575000,3,2,2690,435600,2690,0,47.3477,-122.519
345000,2,1.5,1180,844,990,190,47.5998,-122.3
367950,4,2.5,3030,9500,3030,0,47.3511,-122.287
374500,3,2.25,1400,11400,1400,0,47.7428,-122.231
607500,4,2.5,3000,8100,3000,0,47.7151,-122.305
374000,3,1,1200,9800,1200,0,47.7412,-122.109
390000,3,1,1000,6947,1000,0,47.7142,-122.319
705000,4,3.25,2740,5339,2740,0,47.6706,-122.356
467000,3,2.5,1990,4978,1990,0,47.5323,-121.856
243500,3,3,2110,7794,2110,0,47.4005,-122.293
593000,3,2.75,1830,1850,1690,140,47.5307,-122.074
223000,3,1,940,7980,940,0,47.5107,-122.345
574000,4,2.5,2980,10179,2980,0,47.3895,-122.033
400000,3,2,2260,11305,1130,1130,47.4544,-122.204
772000,4,2.75,3470,70131,1750,1720,47.6339,-122.18
593777,3,1.75,1510,10450,1510,0,47.684,-122.113
539500,4,3.5,2710,5722,2040,670,47.5591,-122.302
550000,3,2.5,2080,2625,2080,0,47.5469,-121.997
265000,2,2,1860,10856,1260,600,47.4989,-122.265
428000,3,1.75,2120,9350,1280,840,47.7562,-122.145
505000,3,2,1110,8375,1110,0,47.6978,-122.297
925000,5,5.5,5190,12637,5190,0,47.5424,-121.872
230000,3,1.75,1520,15344,1520,0,47.3308,-122.365
695000,4,2.5,2650,9990,2650,0,47.5605,-122.016
700000,4,2.75,3350,7857,3350,0,47.5398,-121.859
712500,3,1.75,1770,2800,1770,0,47.6631,-122.357
480000,3,2.5,2200,4692,2200,0,47.7761,-122.169
470000,3,2.5,2000,8424,1300,700,47.7089,-122.201
335000,3,1.75,1730,15003,1150,580,47.6923,-121.92
270000,3,1.5,1300,7907,900,400,47.3737,-122.224
810000,5,3.25,2950,67475,2530,420,47.7233,-122.117
589000,3,3,1720,954,1460,260,47.648,-122.358
415000,2,1,880,4558,880,0,47.6803,-122.287
197000,4,2.25,1790,13200,1220,570,47.4672,-122.185
235500,3,1.5,1380,7600,790,590,47.3489,-122.306
460000,3,2.25,1530,1840,1240,290,47.587,-122.301
572500,5,1.75,2330,4947,1380,950,47.5352,-122.392
302000,5,2,1540,9629,1540,0,47.4915,-122.143
870000,3,2.5,3210,8630,2530,680,47.6939,-122.189
485000,3,1,1130,5758,960,170,47.6413,-122.401
240000,3,2,1460,7526,1460,0,47.3463,-122.304
383000,3,1.75,1410,7215,1410,0,47.7343,-122.193
750000,4,2.75,1750,5080,1750,0,47.6143,-122.305
409950,2,1.75,1370,5125,1370,0,47.6926,-122.346
246000,3,1.5,1780,23819,1780,0,47.4912,-122.312
860000,4,1.75,1890,4500,1490,400,47.6751,-122.289
339950,3,2.25,1630,12295,1630,0,47.4279,-122.161
315000,5,1.75,2320,8100,1160,1160,47.4631,-122.341
698000,3,2.5,2580,4636,2580,0,47.6201,-122.025
419000,2,2.5,1470,2034,1470,0,47.6213,-122.153
372000,3,1,2298,10140,2298,0,47.6909,-122.083
425000,3,2.5,1960,4709,1960,0,47.5322,-121.871
386500,3,2.25,2950,8036,1950,1000,47.7239,-122.313
348000,2,1,670,7312,670,0,47.7145,-122.285
754000,5,3.5,3020,15305,2230,790,47.5627,-122.216
269950,4,3,2390,7309,2390,0,47.294,-122.218
891500,3,2.5,3090,20785,3090,0,47.5602,-122.03
349950,4,1.75,1780,5000,890,890,47.5329,-122.292
360000,2,1,1420,81892,1180,240,47.4342,-122.195
975000,4,2.25,2420,15482,2420,0,47.5907,-122.196
449250,4,2,1480,3844,1480,0,47.7042,-122.352
350000,4,2.25,2190,3850,2190,0,47.4854,-122.16
790000,4,1.75,1820,6137,1690,130,47.6681,-122.36
990000,3,1.75,1810,24586,930,880,47.5314,-122.222
834000,3,2.25,2550,4089,2550,0,47.6272,-122.297
466950,3,1,1360,3880,1060,300,47.6837,-122.391
262500,3,1.75,2259,26831,1491,768,47.2741,-122.266
762300,4,2.5,3880,14550,3880,0,47.6378,-122.04
733000,6,2.75,2730,5000,1780,950,47.6751,-122.38
439000,4,2.5,2800,17279,1560,1240,47.7596,-122.269
1.16E+06,5,3.25,4290,7019,3590,700,47.6439,-122.302
420000,3,2.5,1770,3993,1770,0,47.6027,-122.02
549000,3,2.25,1920,10961,1920,0,47.6432,-122.057
518000,4,2.5,2320,4000,1510,810,47.6048,-122.298
695000,4,2.5,2961,12146,2961,0,47.5839,-122.052
485000,3,2.5,1680,7385,1680,0,47.6194,-122.041
280000,3,1.75,1590,27200,1590,0,47.4238,-122.052
306500,2,1,1420,16400,1420,0,47.3221,-122.344
720000,2,1,1370,9460,1370,0,47.6238,-122.191
277500,3,2.5,2620,4558,2620,0,47.1944,-121.974
649000,3,2,1810,17006,1810,0,47.4663,-122.369
3.395E+06,4,3.5,4730,47870,2940,1790,47.6967,-122.216
267800,2,1,700,6000,700,0,47.7515,-122.316
625000,4,2.75,2390,6979,2390,0,47.5703,-121.996
600000,4,2.5,2070,8127,1590,480,47.7316,-122.289
395000,4,2,1780,8149,1780,0,47.745,-122.302
212000,4,2.5,1900,21780,1900,0,47.3776,-122.314
425000,2,1,1040,4040,940,100,47.6829,-122.393
870000,4,1.75,2370,5000,1770,600,47.6779,-122.357
420000,3,2.5,1970,3667,1970,0,47.5321,-121.851
800000,4,2.25,2120,9921,2120,0,47.5593,-122.082
575000,3,2.5,1960,9535,1960,0,47.7371,-122.215
915000,3,3.25,2660,4000,2170,490,47.6186,-122.288
400000,3,2.25,1180,14258,1180,0,47.7112,-122.238
750000,3,2.5,2390,6550,1440,950,47.5714,-122.408
235000,3,1,1250,7592,1250,0,47.3604,-122.111
599950,5,3,2600,13674,1300,1300,47.7176,-122.302
481203,2,1,940,3800,940,0,47.6798,-122.292
1.815E+06,5,3,3880,13000,3880,0,47.5467,-122.234
379000,3,2.5,1530,2913,1530,0,47.6939,-122.184
626000,3,1.75,2430,5000,1760,670,47.6785,-122.372
535000,2,1,1030,4841,920,110,47.686,-122.341
1.225E+06,4,2.5,2740,16007,2740,0,47.6353,-122.229
410000,2,1.5,1180,1034,1120,60,47.678,-122.322
940000,4,2.5,3090,9238,1680,1410,47.5654,-122.163
326250,3,1,1060,9663,1060,0,47.7244,-122.226
200000,2,1,790,5985,790,0,47.4941,-122.24
880000,4,2.5,3070,8250,2100,970,47.5935,-122.172
370000,2,2,2100,58488,2100,0,47.72,-121.402
190000,2,2.5,1100,1737,1100,0,47.4499,-122.189
160000,2,1,1070,4200,1070,0,47.3336,-122.215
625000,4,3,2190,12825,1520,670,47.7107,-122.229
590000,4,3.5,3450,6873,2750,700,47.459,-122.118
575000,3,2.5,2070,3599,2070,0,47.6679,-122.165
470000,2,1,1190,5200,1190,0,47.6939,-122.348
130000,2,1,600,1500,600,0,47.5289,-122.033
229000,3,1,940,8400,940,0,47.5108,-122.165
279900,3,1,1280,12928,1280,0,47.3215,-122.399
307000,3,1,1370,7500,1370,0,47.6499,-121.915
399950,3,1.75,2450,15001,1980,470,47.6957,-121.913
405000,4,2.25,1970,15743,1370,600,47.7673,-122.202
539950,4,2.75,2910,9000,2130,780,47.544,-122.176
129000,2,1,760,5240,760,0,47.388,-122.234
340000,3,1.75,1270,8422,1270,0,47.7601,-122.197
214950,3,1.75,1570,4875,1310,260,47.3621,-122.094
450000,4,2.75,2310,5650,1330,980,47.513,-122.252
515000,3,1.75,1900,5000,950,950,47.5677,-122.363
1.4E+06,4,2.25,3780,5160,2510,1270,47.6275,-122.308
230000,3,1,1060,9946,1060,0,47.4432,-122.282
681000,3,1.75,1880,10032,1880,0,47.5527,-122.16
255000,3,1,1160,8636,1160,0,47.5097,-122.357
580000,2,1,860,4013,860,0,47.6652,-122.338
295000,2,2,1590,8000,910,680,47.459,-122.205
286000,2,1,1170,6543,1170,0,47.537,-122.385
425000,3,1.5,1190,8100,830,360,47.7146,-122.311
170000,2,1,1300,11400,1300,0,47.3459,-122.299
380000,3,2,1660,8281,1660,0,47.5568,-122.382
506000,3,2,1160,6120,1160,0,47.6853,-122.293
315000,3,2.5,1950,9618,1950,0,47.4068,-122.18
449950,4,2.5,2470,3811,2470,0,47.5362,-121.877
255000,3,1,1430,12420,1430,0,47.5116,-122.191
289000,3,2.5,1970,9607,1090,880,47.3462,-122.286
389000,3,1.75,1400,10018,1400,0,47.5327,-122.032
327000,3,1.5,1510,344124,1510,0,47.2156,-122.029
2.885E+06,7,3,5350,14400,5020,330,47.6295,-122.285
210000,3,1,920,6612,920,0,47.548,-122.284
1.68E+06,4,3.75,7620,29536,5980,1640,47.5571,-122.14
360000,4,2.5,2490,4751,2490,0,47.4813,-122.188
875000,4,2.5,3030,16000,3030,0,47.7125,-122.081
550000,4,2.25,1650,7200,1650,0,47.6384,-122.116
257500,3,1.5,1210,12500,1210,0,47.503,-122.351
1.075E+06,4,2.75,2990,7389,2090,900,47.5711,-122.284
202950,2,1,1060,5144,1060,0,47.3613,-122.088
622000,4,1.75,2680,6120,1340,1340,47.6965,-122.393
455000,4,1.75,1790,45738,1410,380,47.7453,-122.129
805000,3,2.5,2690,17461,2690,0,47.654,-122.088
257000,2,1,770,9497,770,0,47.7407,-122.351
744500,5,2.5,2700,16570,1750,950,47.6144,-122.167
885000,4,2.5,2620,9157,2620,0,47.6916,-122.203
355000,2,2.25,930,747,630,300,47.5844,-122.316
240000,3,1,1340,7000,1340,0,47.3742,-122.149
169000,3,1.5,1470,18459,1470,0,47.3302,-122.36
639900,3,2.5,2330,4160,2330,0,47.6367,-122.109
292000,3,1.75,1730,11325,1730,0,47.3921,-122.182
563500,4,2.5,2780,7838,2780,0,47.5312,-121.861
389000,2,2,1200,7131,1200,0,47.7199,-122.022
2.75E+06,4,3.25,4430,21000,4430,0,47.6398,-122.237
661000,3,2,1820,4418,1820,0,47.6947,-122.19
344000,2,2,1300,4659,1300,0,47.7132,-122.033
510000,1,1,680,6600,480,200,47.6567,-122.392
289000,2,1,780,4132,780,0,47.5324,-122.387
365000,3,2.25,2430,7614,1900,530,47.5065,-122.191
410000,3,1.5,1750,32500,1750,0,47.5316,-121.959
535610,3,1,1610,5100,1010,600,47.6765,-122.386
397950,4,1.75,2120,7620,2120,0,47.457,-122.346
284000,3,1.75,1430,4850,930,500,47.5472,-122.303
201000,4,1.5,1360,8100,1360,0,47.4931,-122.305
734000,4,2.25,2530,5000,1690,840,47.6806,-122.36
357500,5,3,3270,9146,3270,0,47.3342,-122.169
550120,5,2.5,2620,8050,1520,1100,47.6919,-122.115
300000,3,1.5,1810,8232,1810,0,47.3195,-122.273
374950,3,2.5,2120,9653,2120,0,47.3843,-122.213
602500,4,1.75,2190,41000,2190,0,47.5755,-122.033
221000,3,1,980,7606,980,0,47.4356,-122.29
920000,5,3,2230,4400,1730,500,47.6404,-122.325
235000,4,2,1540,9279,1540,0,47.5163,-122.268
375000,3,1,980,7296,980,0,47.7292,-122.231
599000,4,2.5,2120,3640,2120,0,47.5521,-121.996
562100,3,2.25,2090,12112,2090,0,47.7015,-122.13
640000,3,2.5,1620,1377,1100,520,47.6195,-122.299
294000,3,2,1650,11256,1250,400,47.4707,-122.26
714000,4,2.5,3230,7766,3230,0,47.7069,-122.131
970000,4,3.25,2790,5420,1130,1660,47.7698,-122.386
280000,4,2.25,1600,7916,1600,0,47.194,-121.981
260000,4,2.5,1790,4358,1790,0,47.3994,-122.204
294000,3,1.5,2060,15050,2060,0,47.3321,-122.373
255500,4,1,1370,41194,1370,0,47.2716,-122.144
3.3E+06,5,4.75,6200,13873,4440,1760,47.605,-122.112
450000,3,2,1510,43560,1510,0,47.7218,-122.079
368000,3,1,1280,9898,1280,0,47.7677,-122.163
830000,4,2.25,2180,11056,1370,810,47.6042,-122.193
282500,2,1.75,1440,11210,1130,310,47.498,-122.35
335000,3,2.25,1580,16215,1580,0,47.5643,-121.897
558000,2,2,1580,5750,790,790,47.5668,-122.384
270000,4,1.5,1730,8505,1730,0,47.4905,-122.347
152000,2,1,700,13500,700,0,47.3882,-122.208
493000,4,1.75,2030,18295,2030,0,47.7326,-122.179
740000,4,2.5,2500,10330,2500,0,47.5595,-122.114
789800,3,2.5,2605,2216,2090,515,47.6536,-122.203
275000,2,1,910,4191,910,0,47.6929,-122.36
1.5E+06,6,2.5,3560,6480,3560,0,47.627,-122.304
424000,3,1.75,1140,3395,620,520,47.6712,-122.393
715000,2,1,1000,3513,1000,0,47.5935,-122.39
600000,4,2.5,3010,7953,3010,0,47.522,-122.19
802000,2,1.75,2110,8700,1760,350,47.4912,-122.365
165000,3,1,910,8700,910,0,47.449,-122.29
750000,4,3.25,2050,5000,1370,680,47.6235,-122.298
405000,2,1,1090,10481,780,310,47.632,-122.03
521900,3,2.5,2100,12338,2100,0,47.7412,-122.168
275000,3,1,1000,8018,1000,0,47.7285,-122.198
600000,5,3.25,4410,58157,2330,2080,47.4395,-122.111
442500,3,1.75,1800,10200,1800,0,47.4496,-122.146
229950,2,1,920,7716,920,0,47.5028,-122.243
274950,3,2,1410,7265,1410,0,47.3654,-122.076
407185,3,1.75,1860,48076,1860,0,47.5051,-122.461
468000,4,2.5,2100,8400,1240,860,47.735,-122.17
450000,2,1,1030,4365,1030,0,47.6875,-122.387
219950,2,1,940,8997,940,0,47.2005,-121.999
275000,2,2.5,1340,5995,1340,0,47.7366,-122.233
229950,2,1,850,6000,850,0,47.4972,-122.224
675000,3,1.75,2130,4400,1430,700,47.6417,-122.325
412950,4,2.5,2430,6796,2430,0,47.4499,-122.127
670000,5,2.25,2290,39000,2290,0,47.7012,-122.12
420000,3,1.75,1230,10005,1230,0,47.621,-122.114
358000,3,1.5,1150,27319,1150,0,47.3933,-122.454
680000,3,2.5,2120,3600,2120,0,47.6649,-122.082
380000,2,1,980,3400,980,0,47.6688,-122.323
515000,3,2.5,2130,219978,2130,0,47.7754,-122.032
325000,2,1,1050,4800,1050,0,47.5128,-122.388
875000,3,2.5,1820,6848,1820,0,47.6287,-122.207
426000,3,2.5,2210,5750,1710,500,47.5525,-122.366
868500,5,2.5,2490,9639,1610,880,47.551,-122.22
657500,4,2.75,4140,24190,4140,0,47.3062,-122.15
366000,2,1,1210,3090,860,350,47.5532,-122.277
385000,2,1,1010,4000,1010,0,47.5536,-122.267
300000,4,2,2050,8750,1300,750,47.4324,-122.171
810000,3,1.75,2060,3300,1500,560,47.6498,-122.32
460000,4,1.75,1560,7200,860,700,47.7001,-122.279
459000,3,2.5,1780,4000,1780,0,47.5677,-122.003
260000,3,1.75,1460,10000,1460,0,47.342,-122.195
557865,4,2.5,3030,6813,3030,0,47.6296,-122.029
295000,4,1,980,3000,980,0,47.5892,-122.312
375000,4,2.25,1450,7245,1450,0,47.7643,-122.343
2.11E+06,3,2.25,3230,17833,3230,0,47.5683,-122.188
307300,2,2,1520,1020,1520,0,47.7292,-122.343
225000,4,1,1410,7000,1410,0,47.3767,-122.287
290000,3,1.75,1390,13200,1390,0,47.4429,-121.771
690000,4,2,2230,5000,1510,720,47.5772,-122.292
825000,4,2.25,2110,12653,2110,0,47.536,-122.225
645000,3,1.75,2270,11472,1370,900,47.7057,-122.374
590000,4,2.25,2530,10611,1320,1210,47.5698,-122.132
667000,5,2,1900,5470,1180,720,47.6666,-122.303
664000,4,2.5,2390,8432,2390,0,47.6027,-122.024
452100,4,2.5,3160,6540,1580,1580,47.5037,-122.24
290000,2,1,900,2728,900,0,47.5877,-122.298
950000,3,3,3610,17483,3610,0,47.4852,-122.357
662500,3,2,2070,4200,1670,400,47.6624,-122.333
475000,4,2.5,1850,5444,1850,0,47.7227,-122.16
450000,3,1.5,1440,9711,1140,300,47.7394,-122.252
538250,3,2.25,2590,15229,2590,0,47.3948,-122.325
329950,2,1,1140,5250,1140,0,47.731,-122.341
1.10399E+06,4,3.5,2760,5040,2760,0,47.6756,-122.401
307000,5,1.5,1310,4800,1110,200,47.5545,-122.365
433000,3,1.75,1870,7189,1270,600,47.5412,-122.27
212000,3,2.25,1900,18000,1280,620,47.3251,-122.354
750000,5,2.75,2860,6000,2380,480,47.5906,-122.316
279000,3,2,1640,5650,1640,0,47.3736,-122.13
476000,3,1,1140,5500,1140,0,47.6606,-122.395
368000,5,1.75,2590,9394,1390,1200,47.3941,-122.307
228950,4,3,2160,5200,1320,840,47.3627,-122.091
568450,5,3.5,3260,58806,3260,0,47.3703,-122.159
619000,4,1.75,1660,3800,1660,0,47.6883,-122.314
275000,3,2.25,1640,6044,1640,0,47.2844,-122.205
321500,4,2.5,2620,5457,2620,0,47.3148,-122.27
230000,3,1.75,950,6000,790,160,47.5271,-122.316
179500,3,1,900,8100,900,0,47.2866,-122.221
460000,3,2.25,1650,7313,1220,430,47.7375,-122.194
286000,3,2.5,1800,3980,1800,0,47.4006,-122.162
427500,3,1,1480,4200,1480,0,47.6147,-122.298
400000,3,1,1040,6250,1040,0,47.5526,-122.385
675000,3,3.5,2300,5611,2300,0,47.7122,-122.026
350000,3,1,2480,8906,1240,1240,47.5366,-122.289
385000,4,1.75,1970,10358,1540,430,47.7719,-122.255
525000,2,1.75,1530,3503,830,700,47.6368,-122.371
315000,2,1,970,18557,970,0,47.5116,-122.37
820000,4,2.5,2920,252648,2920,0,47.4784,-122.048
205000,3,1,970,7700,970,0,47.3793,-122.304
500000,2,1,680,5250,680,0,47.7013,-122.359
599000,4,2.5,2640,6738,2640,0,47.5787,-122
2.225E+06,3,4,4200,30120,3600,600,47.6379,-122.311
299000,1,2.5,1980,7521,1180,800,47.4343,-122.192
947500,3,2.75,2980,27144,2180,800,47.4522,-122.378
385000,3,3.25,1630,1677,1630,0,47.7048,-122.353
639950,2,1.75,1780,4520,890,890,47.5798,-122.404
824000,2,1,1210,8400,780,430,47.6503,-122.393
199950,3,1,1010,7245,1010,0,47.3338,-122.306
1.005E+06,3,2.5,2570,5000,1480,1090,47.6578,-122.285
950000,4,2.25,2770,5320,2440,330,47.5283,-122.385
822000,3,2.5,2290,9158,2290,0,47.5476,-122.14
473600,4,1.5,1780,8400,1080,700,47.5173,-122.385
490000,5,2,2150,4500,2150,0,47.5582,-122.388
245000,3,1.75,1920,9306,1000,920,47.3319,-122.267
199000,4,1,1220,11730,1220,0,47.3229,-122.283
1.34E+06,3,3,2960,5500,2440,520,47.6356,-122.402
418000,3,1.75,1500,19113,1500,0,47.6976,-121.916
450000,7,3.5,2830,8625,1830,1000,47.7493,-122.355
280000,3,2.5,1580,7000,1580,0,47.3659,-122.17
273000,3,2.25,1230,11601,910,320,47.1955,-121.991
549000,4,2.5,2910,6338,2910,0,47.4804,-122.126
913888,5,2.25,2370,15512,2370,0,47.5555,-122.15
689888,4,2.25,1930,3500,1540,390,47.6167,-122.29
305000,4,2,1780,5043,870,910,47.7045,-122.342
602500,4,2.5,2760,6850,2760,0,47.5346,-122.185
355000,2,1.75,1620,3640,900,720,47.543,-122.299
756000,3,2.5,2160,7525,2160,0,47.6608,-122.145
289950,4,2.25,2190,6906,1040,1150,47.319,-122.373
800000,3,2.5,3240,7857,3240,0,47.5857,-122.038
403000,2,1,720,3255,720,0,47.6823,-122.348
350000,3,2.25,1410,1340,1370,40,47.6108,-122.113
1.285E+06,5,3.5,2980,5100,2370,610,47.6782,-122.299
525126,5,2.25,1950,8025,1150,800,47.6159,-122.114
241450,3,1,1100,8138,1100,0,47.7393,-122.325
320000,3,1.5,1400,9087,1400,0,47.7711,-122.34
234000,4,2,1710,7455,1030,680,47.3965,-122.173
441000,5,2.5,2000,3600,1150,850,47.5971,-122.295
474500,5,2.5,2000,3600,1150,850,47.5971,-122.295
705000,3,1,1440,2618,1440,0,47.6582,-122.336
517500,4,2.5,1520,3370,1520,0,47.5696,-122.004
142500,4,0.75,1440,13300,1440,0,47.4761,-122.337
310000,2,1.5,1010,10005,1010,0,47.5118,-122.189
749500,4,2.5,2440,9727,2440,0,47.6613,-122.132
360000,5,3,2480,7200,1560,920,47.4586,-122.283
267500,3,1,1090,22080,1090,0,47.3991,-121.964
290000,3,1,1480,32700,1380,100,47.4949,-122.327
850000,5,2.5,2800,11325,1400,1400,47.6166,-122.172
815000,4,1.75,1820,4500,1820,0,47.6429,-122.36
2.2E+06,5,4,5840,11652,4410,1430,47.5835,-122.202
1.625E+06,4,3.25,2980,3600,2150,830,47.6352,-122.284
175000,3,1.5,1220,7300,1220,0,47.3341,-122.279
429950,3,1.75,1830,9758,1300,530,47.7107,-122.23
675000,4,2.5,2900,5505,2900,0,47.6063,-122.02
580000,3,2.25,1940,5980,1520,420,47.5476,-122.075
240000,4,2,1750,7800,1750,0,47.4791,-122.347
374000,3,2.5,1850,17808,1210,640,47.3631,-122.271
862500,4,2.5,3220,4400,2180,1040,47.6325,-122.394
140000,2,1,1080,6052,1080,0,47.3857,-122.215
740000,5,3.75,3990,18897,3090,900,47.7228,-122.31
589000,3,1.75,920,3600,820,100,47.6386,-122.365
275000,3,1.75,1290,9760,1290,0,47.4265,-122.148
489900,4,2.5,2090,4196,2090,0,47.7453,-122.192
545000,3,2.5,1900,3366,1900,0,47.6679,-122.184
235000,4,1,1360,7132,1360,0,47.5054,-122.301
230000,3,1,1000,4000,1000,0,47.5523,-122.286
655000,4,2.25,2170,4080,1920,250,47.6124,-122.293
185000,2,1,820,16030,820,0,47.2039,-122.003
196000,3,1,1090,7400,1090,0,47.2923,-122.19
572000,3,2.25,1830,7897,1290,540,47.6914,-122.103
615000,4,2.5,3010,6903,3010,0,47.5213,-122.193
1.95E+06,4,3.75,4150,17424,3130,1020,47.639,-122.236
1.225E+06,6,2.25,2930,4320,2130,800,47.6295,-122.306
375000,3,2.5,1520,5649,1520,0,47.7221,-122.162
295000,3,1.75,1250,9486,1250,0,47.4341,-122.446
760000,4,2.5,2760,6000,2230,530,47.6877,-122.295
347000,3,1.75,1330,7848,1330,0,47.4463,-122.127
712000,3,2,1700,5100,1500,200,47.679,-122.39
495000,4,2,2050,4000,1210,840,47.5799,-122.306
925000,4,2,3140,10437,2040,1100,47.5786,-122.229
775000,3,1,2030,4080,1840,190,47.6765,-122.308
429000,4,2.5,2100,7920,1400,700,47.5293,-122.371
229000,3,1,1010,12705,1010,0,47.3348,-122.303
400000,4,1.5,1980,113691,1980,0,47.5606,-121.853
625000,4,2.25,2100,8290,2100,0,47.5595,-122.129
130000,2,1,840,6654,840,0,47.7319,-122.335
349000,3,1.75,1690,5080,1190,500,47.5312,-122.348
365000,3,2,2140,26600,2140,0,47.4066,-122.169
487500,3,2.5,1810,1988,1350,460,47.6513,-122.385
475000,3,2.5,2600,7210,2600,0,47.5123,-122.151
685000,3,1.75,1650,8400,1470,180,47.5766,-122.236
960000,3,1.75,2460,4800,1230,1230,47.6343,-122.282
1.1E+06,5,2.25,4320,7620,2880,1440,47.6824,-122.287
428000,3,2.25,2600,15000,2600,0,47.3719,-122.056
435000,3,2.5,1930,5790,1930,0,47.7733,-122.17
769950,3,2,2190,5400,1260,930,47.6737,-122.4
385000,3,1,1420,10980,1200,220,47.574,-122.138
352000,3,2.5,2090,3002,1670,420,47.745,-121.984
622500,3,2.5,2290,14374,2290,0,47.5886,-122.074
660000,3,3,2470,11900,2290,180,47.641,-122.057
105000,3,1,840,8400,840,0,47.3277,-122.343
420000,2,1,2100,4480,1400,700,47.574,-122.372
499950,3,1.5,1360,11250,1360,0,47.5697,-122.177
975000,6,3,3420,22421,2270,1150,47.5508,-122.189
665000,3,2.75,1930,2960,1490,440,47.6659,-122.287
540000,4,2.5,2180,10140,1180,1000,47.6822,-122.111
400000,4,2,1670,12056,1670,0,47.7418,-122.244
469950,4,2.75,2720,6427,1650,1070,47.4931,-122.354
777000,4,2.5,3170,9900,3170,0,47.6181,-122.147
346500,2,1.75,1610,6300,1010,600,47.554,-122.304
685000,3,2.5,2370,4950,2370,0,47.5465,-122.013
396500,3,2.5,2590,18980,2590,0,47.3839,-122.153
783500,3,2.5,2850,7130,1990,860,47.603,-122.289
575000,4,2,1660,4800,1660,0,47.6556,-122.345
1.5E+06,4,4.25,5550,12968,5550,0,47.5305,-122.135
515000,3,1.5,2200,7620,1130,1070,47.7263,-122.363
300000,3,2.5,2020,6628,1250,770,47.4934,-122.332
272000,3,1.5,1760,9600,1760,0,47.4085,-122.195
355000,4,2.25,1810,4970,1810,0,47.5003,-122.156
223000,3,2,1310,8440,1310,0,47.5003,-122.269
397000,4,2.5,3000,8584,3000,0,47.369,-122.032
460000,2,2,1080,5000,1080,0,47.6826,-122.394
848000,3,2.75,2170,2738,1550,620,47.6389,-122.349
392800,2,1,740,4275,740,0,47.688,-122.308
1.69E+06,3,3.25,5290,224442,4540,750,47.6671,-122.051
1.8E+06,3,3.25,5290,224442,4540,750,47.6671,-122.051
577000,3,2.25,2370,7878,2370,0,47.7281,-122.168
570000,3,1,1890,3330,1390,500,47.6597,-122.352
250000,3,1.75,1160,6134,1160,0,47.3414,-122.218
645000,4,1.75,1550,7350,1550,0,47.5795,-122.235
567500,3,2.5,3090,67082,3090,0,47.4032,-122.023
337000,4,2.5,2610,5240,2610,0,47.345,-122.042
280000,3,1.75,1230,8250,1230,0,47.4526,-122.176
167000,3,1.5,1280,5547,1280,0,47.3344,-122.215
280000,2,1,1880,7560,940,940,47.5261,-122.374
317500,2,1.5,1220,8409,1220,0,47.7534,-122.324
405500,2,2.75,1350,1252,1120,230,47.522,-122.39
495000,4,2.5,2370,15336,2370,0,47.5633,-121.901
691000,4,3,3040,11651,3040,0,47.6348,-122.038
480000,5,1.75,2080,217800,2080,0,47.3884,-122.404
549010,2,1.75,1560,4141,880,680,47.6863,-122.382
750000,5,3.5,2980,5809,2980,0,47.5537,-121.996
365000,2,1,870,5689,870,0,47.6988,-122.351
412500,3,1.75,1660,10716,1100,560,47.7326,-122.234
425000,3,2.25,1870,9000,1440,430,47.7373,-122.198
920000,3,1,1410,9656,960,450,47.6354,-122.208
340000,4,2.25,2180,8000,1630,550,47.317,-122.378
405000,4,2.5,2620,8960,1520,1100,47.7642,-122.335
537100,3,2.5,2450,7051,1870,580,47.5308,-122.171
353500,4,2.5,3250,4650,3250,0,47.4004,-122.203
522000,3,1,1150,7080,1150,0,47.7106,-122.288
710000,4,2.75,2780,6978,2780,0,47.6881,-122.04
329950,3,1.75,1360,13320,1360,0,47.4625,-122.069
830000,5,2.5,2810,14207,1540,1270,47.5742,-122.11
800500,4,2.5,1780,11130,1780,0,47.5931,-122.178
168500,3,1,1100,10125,1100,0,47.367,-122.107
490000,3,2.5,2230,5348,2230,0,47.5347,-121.866
579000,3,2.5,1710,1904,1140,570,47.5827,-122.387
600000,4,2.5,2620,9873,2620,0,47.5822,-122.051
445000,4,1.75,1990,4725,1190,800,47.5275,-122.38
362500,4,1.75,1450,8450,1450,0,47.5289,-122.028
234000,4,2,1630,9010,1050,580,47.317,-122.196
321500,1,1,730,1942,730,0,47.5939,-122.299
660000,3,1.75,1980,3300,1140,840,47.6733,-122.298
319000,4,1,1730,36356,1730,0,47.4135,-122.199
314000,3,1.75,1350,217852,1100,250,47.2628,-122.03
517950,3,2,1410,5000,740,670,47.6752,-122.361
525000,5,2.5,2360,10081,1180,1180,47.5552,-122.178
319500,3,1,1190,8450,1190,0,47.4807,-122.157
1.58E+06,4,3.25,3760,10920,2400,1360,47.6687,-122.264
325000,1,1,1220,12426,1220,0,47.4047,-122.331
795000,4,2.5,2920,32219,2920,0,47.7439,-122.041
850000,2,1.75,1590,5136,1320,270,47.6424,-122.411
1.01E+06,5,3.25,3510,10930,3510,0,47.6914,-122.21
475000,3,2.5,1320,1310,1320,0,47.6719,-122.38
375000,3,1,1610,11250,1090,520,47.7391,-122.256
405000,3,1,1410,8053,1410,0,47.704,-122.367
420000,4,2.5,2170,10500,1570,600,47.7512,-122.295
775000,4,1.75,1890,4800,1390,500,47.6405,-122.367
800000,4,2.75,3260,5000,3260,0,47.5395,-121.997
436800,3,1.75,2080,12714,1540,540,47.7056,-122.162
620000,3,1.75,2040,4005,1740,300,47.6885,-122.38
230000,3,1,1250,9035,1250,0,47.275,-122.302
165000,1,1,850,8050,850,0,47.5427,-122.288
490000,1,1,850,8050,850,0,47.5427,-122.288
480000,3,1.75,1600,8400,1600,0,47.5479,-122.179
570000,3,2.5,2400,6975,2400,0,47.534,-122.179
615000,3,2.25,1870,4894,1750,120,47.6943,-122.19
280000,3,1,1720,9605,860,860,47.7439,-122.242
326000,3,1,1030,9834,1030,0,47.7676,-122.164
550700,2,2.25,1190,1499,1100,90,47.6666,-122.285
600000,2,1,910,2002,910,0,47.6188,-122.306
450000,3,1,1290,47044,1150,140,47.5655,-121.998
546000,2,2.25,1530,1324,1280,250,47.6032,-122.311
585000,3,2.5,2330,33750,2330,0,47.4787,-121.723
489000,3,1.75,2090,7667,1200,890,47.7007,-122.312
765000,3,2,1570,7000,1050,520,47.6061,-122.286
519000,3,1.75,1560,26099,1560,0,47.5023,-122.467
262000,2,1,1500,4120,880,620,47.4857,-122.2
550000,4,2.75,2160,5005,1430,730,47.6971,-122.302
285000,2,1,780,5000,780,0,47.5112,-122.357
476000,4,1.75,2340,17541,1360,980,47.745,-122.229
2.2E+06,3,2,3570,30456,2070,1500,47.6413,-122.24
335000,1,1,720,5100,720,0,47.6821,-122.38
510000,4,2,2990,102366,2990,0,47.3068,-122.088
291000,3,2.25,1860,13939,1860,0,47.3746,-122.217
335000,4,1.75,1950,13440,1950,0,47.5232,-121.821
415000,3,1.5,1860,9003,1490,370,47.7624,-122.26
430000,3,2,1550,6039,830,720,47.5436,-122.378
270000,3,1.75,1610,6205,1210,400,47.3004,-122.383
760000,3,2,1810,4500,980,830,47.681,-122.359
450000,2,2,1730,4248,1730,0,47.5933,-122.308
425000,3,2.5,1230,23522,1230,0,47.515,-122.162
725000,4,2.5,2130,3420,1730,400,47.649,-122.336
700000,3,2.75,2190,11060,1610,580,47.6893,-122.208
998000,5,4.5,4130,10404,4130,0,47.5556,-122.03
396000,3,2.25,1680,9766,1680,0,47.7341,-121.981
547000,3,2.5,1480,8381,1480,0,47.7078,-122.288
302000,4,1.5,1790,10200,1210,580,47.3774,-122.225
999000,5,3.5,2810,2700,1900,910,47.6799,-122.363
633000,4,2.5,2360,10000,1980,380,47.573,-122.374
265800,3,1.75,1460,7361,1460,0,47.7436,-121.979
530000,3,2.25,2160,8114,1460,700,47.7176,-122.35
605000,6,2,2610,9132,1320,1290,47.622,-122.14
489000,4,2.5,2170,4587,2170,0,47.5396,-121.889
305000,2,1,2160,12960,1360,800,47.4702,-122.261
513000,4,2.75,2020,7070,1010,1010,47.5202,-122.378
765000,4,2.5,2980,5000,2980,0,47.5431,-121.997
550000,2,1.5,1300,2970,990,310,47.6233,-122.319
974350,4,2.5,3090,10730,2420,670,47.5458,-122.141
653675,4,2.25,2280,7229,2280,0,47.5609,-122.081
245000,3,1.75,1260,8614,1260,0,47.3586,-122.056
700180,2,1.75,1530,4387,1020,510,47.6726,-122.264
510000,3,2.5,1830,8133,1390,440,47.7478,-122.247
390000,3,2.5,1610,10292,1190,420,47.5349,-122.174
606500,3,2.5,2170,5500,2170,0,47.5975,-122.018
1.5E+06,4,4.25,5020,26319,5020,0,47.6008,-122.01
290000,3,2.25,1620,7772,1620,0,47.3521,-122.302
115000,3,1.75,1080,7942,1080,0,47.3141,-122.355
500000,3,2.5,1940,37565,1940,0,47.4801,-122.063
139950,0,0,844,4269,844,0,47.2781,-122.25
580050,3,2.5,2360,4638,2360,0,47.6837,-122.321
550000,3,2.5,2010,2261,1390,620,47.5514,-121.998
465000,3,1,800,3060,800,0,47.6769,-122.389
354950,3,1,970,5922,970,0,47.719,-122.321
980000,4,3.25,3720,7150,3720,0,47.5359,-122.069
500000,3,2.25,2010,7447,2010,0,47.747,-122.248
667750,4,1,1430,4080,1430,0,47.6696,-122.324
735000,3,1.75,2250,11520,2250,0,47.7619,-122.268
361000,3,1.75,2130,8742,1330,800,47.5057,-122.231
276750,3,2,1620,12482,1290,330,47.3584,-122.086
760000,4,3.25,3140,3680,2310,830,47.5319,-122.076
475000,2,1,870,7975,870,0,47.6698,-122.361
234000,4,2.5,1820,8217,1120,700,47.263,-122.242
234950,3,2,1510,9153,1510,0,47.3412,-122.273
269950,2,1.75,1320,7540,1320,0,47.3634,-122.052
495000,3,2.5,1800,7318,1800,0,47.5747,-122.008
438000,2,1,1120,6380,1120,0,47.6951,-122.316
260000,3,1.75,2160,22702,2160,0,47.7355,-121.982
697000,4,2.5,3220,6399,3220,0,47.5883,-121.991
212625,2,1,960,5000,960,0,47.5188,-122.372
593000,5,2.5,2640,4400,1840,800,47.605,-122.3
410000,4,3,2430,7243,2430,0,47.3533,-122.016
445434,2,1,1470,7137,1020,450,47.7008,-122.352
200126,3,2.5,2040,15463,1340,700,47.3334,-122.322
290700,3,2.5,1670,6666,1670,0,47.3488,-122.033
248000,4,1,1010,7515,1010,0,47.4174,-122.316
345000,1,1,540,10125,540,0,47.7739,-122.358
525000,3,1,1240,4800,800,440,47.6563,-122.353
400000,3,1.75,1510,8385,1510,0,47.7279,-122.195
532000,3,1,1820,5750,1120,700,47.5773,-122.383
159995,2,1,1000,5026,760,240,47.297,-122.225
287000,5,1.5,2040,11772,1030,1010,47.5015,-122.166
1.115E+06,4,2.5,3690,11191,2190,1500,47.6434,-122.412
765000,3,2.5,2310,11993,2310,0,47.5438,-122.139
185000,3,1.5,1090,9605,1090,0,47.3609,-122.028
430000,3,1,1150,3000,1150,0,47.6867,-122.345
346000,4,2.5,2100,3916,2100,0,47.4324,-122.185
607000,4,2.75,2150,16728,1240,910,47.6915,-122.183
417000,3,1.5,2500,6000,1730,770,47.5297,-122.354
930000,5,2,3530,9385,3530,0,47.5774,-122.285
573300,2,1.75,1290,6600,870,420,47.531,-122.39
260000,4,1.75,2010,10816,1410,600,47.5048,-122.251
280000,1,0.75,420,6720,420,0,47.552,-122.311
825000,4,2.5,2180,4000,2180,0,47.6186,-122.288
307000,4,1,1150,8184,1150,0,47.7431,-122.319
595000,4,1.75,2000,5100,1130,870,47.6798,-122.391
528000,5,1.75,2780,7786,1390,1390,47.6694,-122.157
600000,2,1.75,1550,7764,1550,0,47.358,-122.446
275000,2,1,2180,12875,1480,700,47.3757,-122.303
782000,2,1.5,1570,3600,1320,250,47.6366,-122.363
610000,3,2.5,2260,33042,1660,600,47.7634,-122.086
488000,3,1,1600,3200,1600,0,47.653,-122.331
320000,3,1,1630,5000,930,700,47.5497,-122.295
153500,3,1,890,4810,890,0,47.5153,-122.266
414500,3,1,1350,9450,1350,0,47.7186,-122.236
750000,5,1.75,2850,11860,2850,0,47.7503,-122.28
349990,3,1,1350,165092,1350,0,47.2217,-122.063
645000,3,2.25,3280,79279,3280,0,47.3207,-122.293
425000,2,1,1090,6000,1090,0,47.5886,-122.292
785000,4,2.5,2990,9374,2990,0,47.6287,-122.024
290000,3,1.75,1340,63597,1340,0,47.4379,-122.011
415000,3,1.75,1340,63597,1340,0,47.4379,-122.011
248500,2,1,720,5160,720,0,47.5274,-122.357
325000,3,2.5,2330,8627,1480,850,47.4543,-122.21
272925,2,1,1280,5728,1280,0,47.7477,-122.232
500000,2,2.25,1570,1269,1280,290,47.6514,-122.385
250000,4,1.75,1510,5500,1510,0,47.535,-122.359
470000,4,2.5,2470,8536,2470,0,47.7699,-122.292
440000,2,1,1190,3400,990,200,47.5539,-122.268
299999,4,2.5,1981,4828,1981,0,47.3252,-122.167
255000,3,1.75,1590,7810,1590,0,47.2932,-122.22
415950,3,1.75,1150,7700,1150,0,47.6048,-122.121
402000,5,2.75,2160,7200,1220,940,47.5576,-122.273
729000,3,1.5,1770,30689,1770,0,47.7648,-122.37
635000,2,2.5,2470,8840,1780,690,47.5693,-122.301
479000,3,2.5,1710,8998,1710,0,47.7236,-122.11
462370,2,2.25,1860,2670,1860,0,47.5436,-122.187
171500,3,1,1150,6480,1150,0,47.2642,-122.258
925000,5,3,3850,9457,2910,940,47.727,-122.362
675000,5,3,3410,9600,1870,1540,47.6358,-122.103
320000,4,1.5,1890,43560,1890,0,47.3267,-122.166
499950,5,3.5,3200,43560,3200,0,47.475,-122.093
435000,5,1,2170,65340,1670,500,47.7555,-122.204
359800,4,2.5,2390,6426,2390,0,47.2586,-122.221
239900,3,2,1410,7566,1410,0,47.3674,-122.182
295000,2,1,740,4459,740,0,47.5704,-122.409
380000,3,2.5,2150,25705,2150,0,47.4514,-122.089
435000,4,2.5,2180,6500,1410,770,47.5365,-122.37
508000,2,1,820,5040,820,0,47.6498,-122.388
2.4E+06,6,4.5,5480,10800,4430,1050,47.6307,-122.367
234500,4,2.5,1960,7875,1220,740,47.3427,-122.274
355000,2,1,1270,3200,960,310,47.6565,-122.348
230000,3,2,1710,5200,1030,680,47.3651,-122.094
345000,3,1.75,1930,9000,1150,780,47.4539,-122.348
430000,3,1.75,1200,4500,1200,0,47.5553,-122.316
500000,3,1.5,1680,17409,1680,0,47.6766,-122.176
378000,4,1,1300,6075,1300,0,47.773,-122.349
345000,3,2.5,1540,3237,1540,0,47.5299,-121.878
410000,2,1.75,870,4000,870,0,47.5657,-122.376
750000,2,2.25,1890,5400,1610,280,47.6688,-122.31
485000,4,1.75,2050,8913,1330,720,47.6735,-122.151
105000,3,1,880,18109,880,0,47.3634,-122.101
1.025E+06,3,2.75,2780,4000,1960,820,47.6565,-122.355
360000,3,1,1160,10988,1160,0,47.6818,-122.165
294000,5,2.75,2300,7600,1400,900,47.3084,-122.372
400000,4,2.5,3140,12792,3140,0,47.3863,-122.156
325000,3,1.75,2300,6200,1150,1150,47.4176,-122.323
770000,3,2.5,2900,23550,1490,1410,47.5708,-122.153
443000,3,2.25,1920,8223,1920,0,47.735,-122.201
325000,3,1,1150,7486,1150,0,47.7261,-122.219
760000,4,2.5,3120,8792,3120,0,47.5699,-121.993
640000,4,2,2560,7798,1890,670,47.6914,-122.296
415000,3,2,1410,4303,1410,0,47.5541,-122.317
156000,3,1,970,8580,970,0,47.3363,-122.311
996000,3,3.25,3620,8131,2730,890,47.5776,-122.214
415000,2,1,880,5100,880,0,47.694,-122.346
615000,3,1.75,1900,3783,1110,790,47.5742,-122.315
717000,4,2.5,2540,4241,2540,0,47.7073,-122.112
548000,4,1.75,1690,7794,1090,600,47.6888,-122.203
425000,3,1.5,1120,6653,1120,0,47.7321,-122.334
325250,4,2.75,2130,9339,1330,800,47.3788,-122.316
1.225E+06,3,2.5,3420,79279,3420,0,47.7225,-122.126
557500,3,1.75,1900,11165,1900,0,47.5789,-122.118
1.2605E+06,4,2.5,3730,16950,3730,0,47.5678,-122.228
249950,3,3,1790,2003,1480,310,47.5421,-122.321
260000,4,2.75,2250,7345,1320,930,47.2895,-122.37
1.989E+06,3,2.5,2880,13500,1520,1360,47.6281,-122.216
442900,4,1.75,1780,2788,890,890,47.6511,-122.4
475000,3,2.25,1580,12177,1200,380,47.6254,-122.045
365000,5,2.75,3260,9253,3260,0,47.3674,-122.07
780000,4,2.5,3180,9603,3180,0,47.7717,-122.277
930000,3,1.75,2460,4240,1230,1230,47.6593,-122.337
2.888E+06,5,6.25,8670,64033,6120,2550,47.7295,-122.372
350000,3,1,1020,4980,850,170,47.7039,-122.34
357500,3,1.75,1630,9403,1630,0,47.757,-122.316
520000,4,2.5,3290,11446,3290,0,47.7399,-122.234
330000,4,2.5,1940,3784,1940,0,47.4513,-122.119
310000,3,2,1350,11150,1110,240,47.446,-121.776
279000,3,1,1110,6060,1110,0,47.4705,-122.352
540000,4,1.5,2993,19400,2233,760,47.4692,-122.365
322000,4,2.5,2280,7200,2280,0,47.3829,-122.207
380000,5,3.25,3800,15500,2490,1310,47.3862,-122.28
320000,2,1,850,8400,850,0,47.4696,-122.359
400000,3,1.75,1560,8456,1560,0,47.7769,-122.25
412000,3,1,1000,3844,900,100,47.7031,-122.349
887200,3,1,1400,5100,1400,0,47.6677,-122.333
395000,4,1.75,1540,5120,770,770,47.5359,-122.372
895000,4,3,3570,10273,2630,940,47.6394,-122.077
195000,2,1,800,5280,800,0,47.205,-121.995
390000,3,1,1160,3750,1160,0,47.5652,-122.359
165000,3,1,1010,7690,1010,0,47.4501,-122.176
255000,3,1,1010,7690,1010,0,47.4501,-122.176
589000,4,2.25,2390,57599,2390,0,47.6651,-122.067
505000,3,2.5,1610,4611,1610,0,47.5678,-122.004
335750,3,3,2400,7260,1440,960,47.5045,-122.251
719000,3,1.75,1800,5816,900,900,47.6529,-122.407
796000,4,3.25,2110,3000,2110,0,47.6769,-122.328
95000,2,1,960,7000,960,0,47.3864,-122.307
525000,3,3,2600,5238,1890,710,47.3448,-122.327
417000,3,1.5,1340,10224,1340,0,47.5752,-122.157
410000,3,1,1410,5000,980,430,47.5769,-122.397
984000,4,2.25,2390,12292,2390,0,47.5528,-122.221
325000,2,1.5,1180,834,1180,0,47.7074,-122.356
314950,3,1,1040,16986,1040,0,47.4812,-122.097
350000,3,2.25,1840,9929,1200,640,47.7408,-122.236
1.045E+06,4,2.25,2630,4000,1810,820,47.6393,-122.317
657000,4,2.5,2640,25038,2640,0,47.5277,-122.174
234950,2,2.5,1720,3132,1720,0,47.3728,-122.157
410000,4,1.75,2320,7500,1220,1100,47.7574,-122.343
625000,3,1.75,1840,5664,1270,570,47.6899,-122.283
706000,5,2.5,2890,15891,2890,0,47.5286,-122.16
485000,3,1.75,2200,7706,2200,0,47.3878,-122.326
685000,4,2.75,1660,5150,1280,380,47.6835,-122.362
242050,3,2.5,2170,9900,1690,480,47.3634,-122.031
770000,3,3.25,3310,5000,3310,0,47.5558,-122.001
557000,2,1.5,1450,3840,950,500,47.684,-122.381
246000,3,1.75,1440,11325,1440,0,47.3503,-122.279
194000,4,2,1760,7700,1760,0,47.3299,-122.318
720000,3,2.5,3170,7187,3170,0,47.6934,-122.166
449000,2,1,1250,4576,1040,210,47.5387,-122.266
925000,4,2.5,3280,209088,3280,0,47.6553,-122.023
570000,4,3,2460,10401,1700,760,47.7106,-122.285
395000,3,2,1470,10125,1470,0,47.7751,-122.222
1E+06,4,2,1780,15648,1780,0,47.5849,-122.198
406000,4,1,1580,8475,1580,0,47.5104,-122.254
574800,3,1.5,1630,2946,1630,0,47.6865,-122.31
309000,4,2,2240,9240,1120,1120,47.3666,-122.288
770000,3,2.5,2430,54059,2430,0,47.4664,-121.992
525000,3,1.5,1940,5625,1440,500,47.6818,-122.388
419000,3,2.5,1970,4058,1970,0,47.5308,-121.853
479000,4,2.5,2050,6705,1230,820,47.7242,-122.217
160000,3,1,1340,18552,1340,0,47.7129,-121.325
333000,4,1.75,1880,9880,1880,0,47.4551,-122.151
310000,2,1,860,12160,860,0,47.5267,-122.361
666000,3,2.5,2140,2868,1770,370,47.6668,-122.132
2.23E+06,3,3,3620,28064,2370,1250,47.5516,-122.398
310000,4,2.75,2370,7320,2370,0,47.3071,-122.36
350000,3,2.5,1860,21876,1860,0,47.6455,-121.901
610000,4,3,2110,5000,1640,470,47.5195,-122.391
564800,3,2.25,1990,8501,1990,0,47.5707,-121.996
438000,3,2.25,1820,9150,1320,500,47.737,-122.334
855000,3,2,3120,9400,1820,1300,47.5612,-122.15
229000,3,2.5,1190,3000,1190,0,47.4933,-122.275
260000,3,2,1170,5450,1170,0,47.5276,-122.273
609000,3,2.5,2630,10131,2630,0,47.7695,-122.259
277000,4,1,1450,6250,990,460,47.5131,-122.357
283000,4,2,2100,8160,1200,900,47.5145,-122.365
334000,2,1.75,1680,8367,840,840,47.6976,-122.288
267000,4,1.75,2000,7350,1100,900,47.3428,-122.303
385000,3,1,1030,3000,830,200,47.6813,-122.317
640000,5,1.75,2020,6565,1120,900,47.6821,-122.283
532500,4,2,2220,23750,2220,0,47.7759,-122.214
335000,4,2.5,1750,8476,1240,510,47.4447,-122.137
415000,3,2.5,1710,4920,1710,0,47.5347,-122.376
1.098E+06,6,3.25,3560,107362,2760,800,47.6356,-122.15
1.4425E+06,2,2.5,2720,16637,2160,560,47.5499,-122.264
180000,3,1,1010,10215,1010,0,47.4872,-122.345
335000,4,2.5,1830,4500,1830,0,47.3504,-122.005
835000,4,3,4480,42717,4480,0,47.7711,-122.088
592500,4,1.5,2080,4400,2080,0,47.606,-122.299
418900,3,1.5,1470,11112,1470,0,47.7462,-122.294
340000,3,1,1600,7324,1600,0,47.5054,-122.19
545000,3,2,1340,7200,1340,0,47.5601,-122.265
1.378E+06,5,3.5,3680,8680,3680,0,47.6575,-122.197
183750,3,2.5,1770,3451,1770,0,47.4325,-122.197
295000,4,2,980,10640,980,0,47.4462,-121.773
625000,4,3,2530,5625,1470,1060,47.7094,-122.233
290000,4,3,2390,4500,2390,0,47.4872,-122.204
760000,4,2.5,3600,155509,3600,0,47.3538,-121.986
560000,4,2.5,3270,24750,1690,1580,47.5221,-122.178
475000,5,2.5,2300,28480,2300,0,47.6403,-121.964
620000,3,1,1710,4050,1710,0,47.6732,-122.331
330000,4,2,1170,4000,1170,0,47.5797,-122.305
620000,3,2.25,1990,6256,1390,600,47.6903,-122.206
320000,4,1.75,1710,10480,1710,0,47.4743,-122.143
525000,3,2.5,1740,2350,1120,620,47.6206,-122.297
802500,4,3.75,3320,8030,3320,0,47.5818,-121.972
569500,4,1,1960,3194,1960,0,47.6005,-122.296
850000,6,3.5,2820,5400,1620,1200,47.6791,-122.374
630000,3,1,1590,4080,1590,0,47.662,-122.326
454800,4,2.25,2490,10720,1400,1090,47.6137,-122.06
177000,3,1,870,5200,870,0,47.3695,-122.081
275000,3,1.75,1860,15681,1860,0,47.3191,-122.339
460000,3,2,2930,29136,2240,690,47.3102,-122.042
729000,3,1,1580,3840,1580,0,47.6192,-122.319
935000,4,3.25,4110,15488,4110,0,47.5493,-122.117
481450,3,2,1410,4800,1410,0,47.6852,-122.378
860000,3,2,2090,4190,1490,600,47.6178,-122.284
274000,3,1.75,1400,8364,1400,0,47.4918,-122.178
499000,3,3.5,1690,1432,1360,330,47.6513,-122.4
696500,5,2.25,3210,61419,3210,0,47.7632,-122.09
390000,3,1,1190,85226,1190,0,47.365,-122.462
265000,3,1,960,9748,960,0,47.5259,-121.815
470000,4,2.25,2380,17199,1530,850,47.7668,-122.27
168500,2,1,1020,7742,1020,0,47.499,-122.301
220000,3,1.75,1290,8250,1290,0,47.3353,-122.27
295000,3,2,1830,17321,1100,730,47.5072,-122.272
1.475E+06,5,4,4770,31570,4770,0,47.5468,-122.123
1.295E+06,2,2.5,2910,19449,1940,970,47.7729,-122.393
285000,3,1,950,10723,950,0,47.4899,-122.133
294950,3,1,1160,8950,1160,0,47.7499,-122.338
1.465E+06,4,4,4930,22093,4930,0,47.5874,-121.965
565500,3,1.75,1780,5850,980,800,47.5589,-122.392
230000,3,2,1410,10625,1410,0,47.3649,-122.117
569950,4,3.5,2700,443440,2700,0,47.333,-122.098
721000,2,1.5,1790,4250,920,870,47.6367,-122.301
565000,3,2.5,4040,8653,2900,1140,47.7378,-121.975
438000,3,1.75,1990,9885,1030,960,47.6722,-122.162
369900,3,1.75,2150,19127,1650,500,47.5061,-122.324
405000,4,2.5,1850,9136,1850,0,47.4943,-122.157
282000,3,2.5,1680,15711,1240,440,47.423,-122.171
380950,2,1,1430,7819,1110,320,47.7307,-122.302
349810,3,1,960,8855,960,0,47.7689,-122.328
690000,4,2.5,2700,8810,2700,0,47.7041,-122.116
653000,2,1.5,1290,5141,1050,240,47.6878,-122.29
526500,3,2.5,1860,43170,1860,0,47.7712,-122.136
1.04E+06,4,3.5,4320,8490,3280,1040,47.5568,-122.029
335000,3,1,2130,3825,2130,0,47.5506,-122.281
570000,2,1.75,2870,102366,1770,1100,47.4847,-122
1.08E+06,5,3.5,3740,11340,3740,0,47.6628,-122.143
475000,3,2.5,2130,8022,2130,0,47.7252,-122.106
315000,4,2,1210,4250,1210,0,47.5275,-122.321
405000,6,2,2800,29985,1400,1400,47.4398,-122.08
562000,5,2.25,3040,8111,3040,0,47.7157,-122.103
295000,3,2.5,1570,6932,1570,0,47.3902,-122.049
383000,3,2.25,2090,15000,2090,0,47.4885,-121.783
242000,3,2.25,1690,7292,1250,440,47.2639,-122.303
352500,3,1.5,1470,17577,1470,0,47.4695,-122.116
239950,4,1,1460,6000,730,730,47.4952,-122.224
998000,4,2.5,3030,6820,2530,500,47.6695,-122.266
515000,3,1.75,1190,4500,1190,0,47.5576,-122.388
590000,5,1,1840,6710,1840,0,47.5686,-122.378
1.16E+06,4,3.75,3560,13959,3560,0,47.5575,-122.211
289000,3,1.75,1580,9750,1580,0,47.427,-122.331
424000,3,1.5,1230,7200,1230,0,47.7281,-122.311
199000,4,2,1440,9477,1440,0,47.5093,-122.182
730000,4,3.5,4420,7902,3350,1070,47.5327,-121.86
244000,3,1,910,5250,910,0,47.4729,-122.352
240000,2,1,670,10920,670,0,47.5128,-122.372
797000,4,2.75,2650,8610,2650,0,47.6155,-122.121
350000,4,2.25,2220,6953,2220,0,47.3509,-122.041
415000,3,1.75,1640,6435,1190,450,47.7197,-122.217
378510,2,1,770,5185,770,0,47.5459,-122.379
1.195E+06,4,3.5,3960,6654,2850,1110,47.6461,-122.389
379900,2,1.5,1140,7620,1140,0,47.5277,-122.351
620000,3,2.5,2480,9041,2480,0,47.6797,-122.035
524500,3,1.5,1580,3172,900,680,47.6796,-122.393
270000,4,2.75,1990,7252,1270,720,47.2839,-122.202
236000,4,2.25,1830,9485,1200,630,47.2995,-122.387
308500,2,2,840,14564,840,0,47.5499,-122.36
989900,5,2.25,3320,11350,1660,1660,47.5749,-122.213
299000,4,2.25,2050,26000,2050,0,47.3423,-122.063
295000,2,1.75,1560,43748,1560,0,47.5729,-121.676
110000,2,1,800,15000,800,0,47.4932,-122.316
295950,2,1,1190,6200,1190,0,47.7634,-122.34
270000,3,1.75,1300,4127,650,650,47.5353,-122.352
712000,4,2.5,3400,247421,3400,0,47.3623,-121.971
475000,2,1.5,1170,1250,1170,0,47.6719,-122.38
410000,4,2.5,2510,5258,2510,0,47.4818,-122.188
588000,4,2.25,2510,19550,1810,700,47.7041,-122.241
420000,3,2.5,2390,3903,1970,420,47.7515,-122.174
355000,4,2.25,2200,3404,2200,0,47.3895,-122.034
446000,2,1,2550,21675,1610,940,47.4013,-122.319
765000,4,2.25,2560,12100,1760,800,47.631,-122.108
967500,3,3.75,3250,5797,2370,880,47.6481,-122.405
381000,2,2,1340,4447,1340,0,47.7175,-122.033
490000,3,2.25,2840,107157,2840,0,47.2848,-122.118
716000,4,2.25,2480,9780,1900,580,47.6388,-122.099
605000,5,3.5,3060,8862,3060,0,47.5322,-122.185
312200,4,2.5,2910,8596,2910,0,47.2596,-122.304
327000,4,1,1900,9000,1290,610,47.4629,-122.361
229950,4,1.75,1300,21000,1300,0,47.3067,-122.285
160000,3,1.5,1480,7000,1000,480,47.2866,-122.368
255000,3,1,1250,9472,1250,0,47.495,-122.154
530000,4,2.5,2000,4700,1220,780,47.6902,-122.368
239000,3,1.5,1330,6540,900,430,47.4239,-122.292
285000,3,2.25,1840,6214,1270,570,47.4043,-122.185
537000,4,2,1560,7104,1140,420,47.6714,-122.28
530000,3,2.5,3150,21893,3150,0,47.6455,-121.901
213675,3,2.25,1560,6013,1560,0,47.2862,-122.352
530000,5,2.5,2910,9636,1690,1220,47.5803,-122.119
780000,3,2.5,2940,15875,2940,0,47.5947,-122.016
390000,3,1,950,3621,950,0,47.575,-122.289
450000,2,1,1200,4000,1070,130,47.5766,-122.378
420000,2,1,1000,5375,1000,0,47.5404,-122.268
550000,3,2,1490,3880,1490,0,47.662,-122.363
110000,2,1,600,6120,600,0,47.4997,-122.317
700000,2,1.75,2320,5500,1720,600,47.586,-122.292
807500,4,2.5,3190,24170,3190,0,47.6209,-122.052
179000,2,1,990,8760,990,0,47.3302,-122.305
1.6125E+06,4,2.75,5470,18200,3730,1740,47.5316,-122.263
655000,4,2.75,2890,46609,2890,0,47.7454,-122.061
472500,3,2,1790,6800,1240,550,47.728,-122.339
299000,4,2.5,2350,6958,2350,0,47.3321,-122.172
740000,4,2.5,3430,10157,3430,0,47.723,-122.158
860000,3,1.75,2600,15064,1700,900,47.64,-122.204
620000,4,3,2130,6325,1440,690,47.5683,-122.396
410000,3,1.75,1660,5987,960,700,47.5107,-122.381
343000,5,3.5,2473,9282,2473,0,47.3966,-122.308
465000,2,2.75,1430,1425,995,435,47.621,-122.298
273950,3,2.25,1570,3109,1570,0,47.3258,-122.186
825000,2,1,1240,42247,1240,0,47.5169,-122.201
255000,3,2.5,1720,6200,1720,0,47.2137,-121.989
250000,3,2,1140,11161,1140,0,47.209,-122.012
635000,4,3.25,2690,7200,1720,970,47.7341,-122.288
240000,3,1.75,1520,9600,1520,0,47.3263,-122.365
670000,4,2.25,2040,7031,2040,0,47.7016,-122.17
713414,3,2.5,2830,6000,1730,1100,47.5751,-122.378
245000,3,1.5,1340,7391,1340,0,47.3837,-122.317
600000,4,2.5,2520,10850,1680,840,47.7751,-122.284
270000,3,2.5,1660,5550,1660,0,47.375,-122.304
190000,2,1,880,6900,880,0,47.4903,-122.191
435000,3,2,980,5000,980,0,47.595,-122.308
560000,4,1,1360,5814,1360,0,47.6038,-122.314
998000,3,3.75,3710,34412,2910,800,47.5888,-122.04
725000,3,1,940,8377,940,0,47.5974,-122.2
210000,2,1,970,8874,970,0,47.4943,-122.178
513000,3,2.25,1500,1312,1500,0,47.6534,-122.346
290000,5,2.5,2780,9652,1390,1390,47.3444,-122.271
1.26E+06,3,2.5,3110,9930,1640,1470,47.6112,-122.226
330000,3,2.25,1860,11227,1860,0,47.3879,-122.031
189000,3,1,1010,7560,1010,0,47.4497,-122.176
907500,3,2.25,2850,6281,1900,950,47.6911,-122.326
410000,3,2.25,2280,200811,2280,0,47.6522,-121.941
1.05E+06,4,3,3080,10757,3080,0,47.5671,-122.159
622100,4,2.5,2280,14290,1510,770,47.7054,-122.297
250000,3,1.5,2030,14400,1310,720,47.2639,-122.285
1.18E+06,4,3,2570,4000,1750,820,47.6743,-122.313
925000,3,2.75,3640,10300,2060,1580,47.5612,-122.146
554000,3,2,1760,4046,960,800,47.6876,-122.381
545000,3,2.5,2760,17377,2760,0,47.4929,-122.188
660000,3,2.5,2650,11250,2650,0,47.7644,-122.29
1.9E+06,5,4.5,5160,44315,5160,0,47.6568,-122.154
260000,4,2,1480,8625,1480,0,47.462,-122.193
219900,3,1,860,6664,860,0,47.4931,-122.247
373500,4,2.5,2610,4978,2610,0,47.3438,-122.04
380000,2,1,1470,81021,1470,0,47.4771,-122.03
1.06E+06,4,2.5,4570,16015,4570,0,47.6246,-122.067
2.6E+06,3,3,3410,16015,2220,1190,47.5721,-122.239
450000,3,2.25,1760,10013,1760,0,47.5336,-122.189
379950,3,1.75,2040,12065,2040,0,47.3756,-122.044
834800,3,3.5,3470,4171,3470,0,47.711,-122.229
365000,2,1,680,4800,680,0,47.6084,-122.304
465000,2,2,1494,19271,1494,0,47.4728,-122.497
452000,3,1.5,1250,4000,1250,0,47.6916,-122.379
840000,3,3,3570,6250,2710,860,47.5624,-122.399
465000,4,2,2000,6250,1480,520,47.5532,-122.389
295000,3,2.5,2030,4867,2030,0,47.3747,-122.128
396000,3,1,1390,6160,1390,0,47.7289,-122.338
397000,2,1,1030,12350,1030,0,47.6984,-122.324
240000,3,1,1280,9000,1280,0,47.4915,-122.338
300523,3,2.5,2370,6840,2370,0,47.6503,-122.366
215500,3,2,1380,9000,1380,0,47.2613,-122.248
552500,5,3,2320,7229,1370,950,47.697,-122.097
375000,5,1.5,2050,9360,1520,530,47.436,-122.195
160000,3,1,1210,103237,1210,0,47.4208,-122.445
1.07E+06,4,2.5,3270,35445,3270,0,47.548,-122.121
952000,3,2.5,2450,4400,1800,650,47.6439,-122.319
523460,5,1.75,1890,5000,1090,800,47.6711,-122.372
305950,4,2.5,2007,4968,2007,0,47.3301,-122.191
220000,3,2.5,1430,9044,1430,0,47.1956,-121.986
289000,2,1.75,2056,52333,1048,1008,47.2592,-122.291
648000,5,2.5,2210,10772,1430,780,47.7383,-122.288
825000,5,1.75,2330,6000,2080,250,47.6461,-122.392
400000,4,2,2070,10800,2070,0,47.7264,-122.237
420000,2,2.5,1480,1369,1480,0,47.676,-122.121
389000,2,1.75,1160,4848,1160,0,47.542,-122.265
865000,4,2.5,2520,4950,2520,0,47.6814,-122.359
345000,2,1,1770,16660,1220,550,47.3346,-122.354
700000,3,2.5,3110,123710,2430,680,47.3879,-122.002
550000,3,2.5,1680,10455,1680,0,47.7229,-122.11
201500,3,1,1320,5000,1320,0,47.5711,-122.386
459000,3,1,1320,5000,1320,0,47.5711,-122.386
327000,3,2.5,1810,7350,1310,500,47.4434,-122.125
540000,1,1,1140,6700,1140,0,47.6958,-122.357
805000,5,2.5,4600,19831,2300,2300,47.7608,-122.378
521000,3,2,1840,6000,1840,0,47.5508,-122.392
375000,3,1.5,2000,7294,1520,480,47.5297,-122.267
235000,3,1.75,1480,6592,1080,400,47.2982,-122.378
240000,4,2.5,2040,11841,2040,0,47.3691,-122.074
575000,4,2.25,2060,12155,2060,0,47.6378,-122.117
1.52E+06,6,3.5,3720,11690,3720,0,47.5699,-122.226
394500,4,2.5,3002,6042,3002,0,47.4231,-122.186
174950,3,1,1060,5200,1060,0,47.3636,-122.093
383000,4,2,1830,21183,1060,770,47.4826,-122.128
249950,3,2,1550,15040,1550,0,47.4873,-122.099
431000,3,2.5,1690,2752,1690,0,47.6332,-122.108
459900,3,1.75,2580,11000,1290,1290,47.5646,-122.181
475000,5,2.5,2510,8050,1490,1020,47.7212,-122.172
605000,3,2.25,1290,2500,1290,0,47.6229,-122.298
234950,4,2,1450,7560,1450,0,47.3375,-122.276
419000,4,2.5,2690,7947,2690,0,47.4248,-122.153
910000,4,3.25,3340,10890,2240,1100,47.6677,-122.136
392000,4,2.5,2600,8921,2600,0,47.4423,-122.178
915000,3,2.5,3140,9808,2500,640,47.6383,-122.097
630000,3,3.25,3800,13995,3800,0,47.7741,-122.203
416100,4,1.75,2320,5490,1160,1160,47.5091,-122.241
285000,4,2.5,2360,7350,1440,920,47.3417,-122.277
353000,4,1.5,1100,9600,1100,0,47.7,-122.175
297950,3,2,1390,5127,1390,0,47.4504,-122.206
750000,2,2,2180,21392,2180,0,47.7162,-122.246
525000,3,3,1730,1074,1730,0,47.6692,-122.392
495000,5,1.75,2760,18112,1510,1250,47.7363,-122.298
710000,3,1.75,2430,11448,1620,810,47.6971,-122.391
310000,3,2,2010,12950,2010,0,47.7222,-122.229
205000,5,1.75,1730,5200,1050,680,47.3628,-122.089
530000,3,3,2450,211266,2450,0,47.2215,-122.067
725000,4,2.5,3300,28433,3300,0,47.5072,-122.112
195000,2,1,720,9520,720,0,47.7678,-122.316
401000,3,2,1240,11172,1000,240,47.6364,-122.037
1.03E+06,5,2.5,3050,8200,1650,1400,47.5647,-122.155
251000,3,1.5,1590,21600,1590,0,47.2159,-121.966
667500,3,2,2040,4841,1020,1020,47.6778,-122.302
300000,4,2.5,1840,5550,1840,0,47.3937,-122.183
610000,4,2.25,1960,9021,1960,0,47.6349,-122.096
1.04203E+06,4,5,4110,43560,4110,0,47.6353,-122.18
430000,3,2.25,1830,19965,1400,430,47.7412,-122.088
455000,2,1,1330,92782,1330,0,47.6624,-121.868
600000,5,2,2190,9072,1110,1080,47.6696,-122.149
638000,3,3.25,1720,1587,1410,310,47.6187,-122.299
561000,3,1.75,1710,5000,1360,350,47.5492,-122.389
625000,3,2.5,2180,5000,1240,940,47.5828,-122.396
263950,3,1.75,1700,11613,1180,520,47.2874,-122.187
740000,3,2.5,2960,9350,2960,0,47.6218,-122.094
234999,3,1,1330,8912,1330,0,47.4493,-122.274
380000,4,2.5,1940,3200,1940,0,47.4583,-122.118
329500,3,2.25,1500,9656,1170,330,47.7327,-121.982
464950,4,2.5,2230,64438,1230,1000,47.4754,-122.007
500000,3,2.25,1700,9008,1340,360,47.7161,-122.317
415000,4,1.5,1840,11367,1840,0,47.7656,-122.358
437500,3,2.25,2100,205603,2100,0,47.3668,-122.505
599000,7,2.5,2580,5750,1880,700,47.6025,-122.294
367000,4,2.5,2350,8182,2350,0,47.3697,-122.106
530000,2,1,760,3000,760,0,47.6633,-122.357
989000,5,3.5,3280,4000,2440,840,47.689,-122.396
462600,3,2,1320,4000,1020,300,47.5515,-122.262
875000,3,2.5,1690,10592,1690,0,47.58,-122.231
335000,3,2.25,2060,47318,1600,460,47.2758,-122.265
393000,4,2,1450,5456,1450,0,47.5442,-122.297
1.34E+06,4,3,2760,4905,1840,920,47.6591,-122.27
590000,3,2.5,2830,5788,2830,0,47.7604,-122.235
671000,4,2.75,1890,1475,1200,690,47.6472,-122.383
925000,3,3.25,2610,4500,1660,950,47.6701,-122.339
245000,3,2.25,1900,7250,1250,650,47.4869,-122.344
392500,3,1,930,6572,930,0,47.6889,-122.301
505000,4,2,2730,12000,1410,1320,47.7733,-122.271
702000,4,2.5,2650,6240,2650,0,47.6885,-122.021
337000,2,1,1010,4000,1010,0,47.5311,-122.382
920000,4,2.5,3550,10233,3550,0,47.5499,-122.1
495500,3,1.75,2130,6360,1720,410,47.7059,-122.301
245000,2,1.75,1840,7230,1570,270,47.3815,-122.228
395000,2,1,1320,1824,1320,0,47.585,-122.294
335000,3,1,990,6315,990,0,47.7116,-122.214
187000,2,1.75,1020,10346,1020,0,47.1958,-122.002
450000,4,2,1570,7320,1570,0,47.5967,-122.14
280000,4,2.25,1930,7207,1360,570,47.3783,-122.182
1.375E+06,5,4,3760,22763,1910,1850,47.5333,-122.22
265000,2,1,1000,31505,1000,0,47.7659,-121.899
795000,3,1.75,1930,9600,1930,0,47.5747,-122.237
510000,3,1.5,2240,3800,1370,870,47.6887,-122.307
699900,4,2.5,2190,11500,1430,760,47.5668,-122.147
839000,4,2.75,2400,12469,1760,640,47.5861,-122.112
396000,4,1.75,1970,12409,1220,750,47.7489,-122.236
365000,3,2.25,2860,8458,2860,0,47.4269,-122.148
440000,3,2.25,1900,7225,1220,680,47.6394,-122.113
405000,4,2.5,2090,6667,2090,0,47.4648,-122.15
295000,3,1.5,850,2500,850,0,47.5677,-122.36
275000,4,2.5,1840,1562,1400,440,47.5345,-122.364
295000,2,1,820,288367,820,0,47.4196,-122.165
1.5E+06,5,3.5,4370,12240,3270,1100,47.582,-122.199
795000,3,3.5,3190,10223,2560,630,47.6968,-122.102
650000,5,3.5,3480,36615,2490,990,47.5741,-122.05
260000,3,1,1690,13184,1690,0,47.476,-122.343
382000,2,2.5,1650,2710,1650,0,47.5173,-121.878
790100,4,2.5,2590,9341,2590,0,47.6496,-122.114
220000,4,2.5,2160,8005,2160,0,47.2668,-122.231
799000,4,3.5,3500,8547,2500,1000,47.5613,-122.126
1.48E+06,4,2.25,3920,7200,3120,800,47.5731,-122.284
367300,4,2.75,2190,14937,2190,0,47.3535,-122.273
805000,4,2,1890,4500,1490,400,47.6684,-122.356
730000,2,1,1860,3400,1010,850,47.6714,-122.329
402000,3,2,1720,7704,1160,560,47.7368,-122.195
750000,4,2.75,2600,4674,1560,1040,47.6782,-122.286
458000,3,1.5,1570,12196,1570,0,47.4866,-121.786
898000,3,2.5,3530,9753,3530,0,47.5539,-122.103
308000,4,2.5,1960,5642,1960,0,47.3167,-122.187
385000,3,2.5,2230,8296,2230,0,47.4386,-122.116
1.02E+06,4,3,2720,4800,1790,930,47.6595,-122.283
1.425E+06,5,3,2840,6240,2440,400,47.6285,-122.309
240000,3,1.75,1260,7362,1260,0,47.3602,-122.052
217000,3,1.5,1860,8505,1860,0,47.3106,-122.365
972000,4,1.75,2010,6300,1610,400,47.6457,-122.412
361280,2,1,820,6400,820,0,47.55,-122.379
385000,3,1.75,1220,1450,620,600,47.6361,-122.368
475000,3,2.5,2220,60984,2220,0,47.4802,-122.052
724950,4,2.5,2860,3638,1720,1140,47.6631,-122.361
935000,5,4.5,4230,9701,4230,0,47.5444,-122.131
169950,3,1,840,8470,840,0,47.3275,-122.338
585000,3,2.5,2290,5089,2290,0,47.5443,-122.172
585000,3,2.5,2290,5089,2290,0,47.5443,-122.172
480000,5,3.5,3480,12821,2890,590,47.2641,-122.215
635000,4,2.5,4260,36360,4100,160,47.764,-122.302
368750,3,2.5,2230,5717,2230,0,47.4388,-122.117
432500,6,2,3080,5500,3080,0,47.6031,-122.296
589000,3,2.5,2250,4337,2250,0,47.5908,-122.017
840000,4,3.25,3160,6327,2280,880,47.536,-122.066
316500,3,2.5,1770,3873,1770,0,47.4648,-122.144
536000,4,2.5,2880,8833,2880,0,47.5388,-121.89
563750,4,2.75,2690,25000,1750,940,47.5537,-122.026
152500,4,1,1730,7350,1730,0,47.3467,-122.307
267950,4,1,1730,7350,1730,0,47.3467,-122.307
1.64E+06,5,4,4780,118047,4780,0,47.7243,-122.052
269950,4,2.5,2540,8400,2540,0,47.3754,-122.277
731688,4,3,2630,5772,2630,0,47.6952,-122.133
240000,3,1.5,1890,9000,1190,700,47.4425,-122.272
555950,2,1,1220,5040,1220,0,47.6957,-122.364
289000,2,1,710,6300,710,0,47.5155,-122.374
525000,3,2.5,2970,11985,1770,1200,47.6359,-122.052
745000,3,2.5,2970,11985,1770,1200,47.6359,-122.052
397000,2,1,1000,7664,1000,0,47.7001,-122.311
233000,3,1,1980,8505,1030,950,47.538,-122.353
625000,4,2.25,1920,8259,1920,0,47.5616,-122.088
535000,3,2,2740,23505,2740,0,47.319,-122.26
270000,3,2.25,1740,7345,1380,360,47.3663,-122.285
360000,3,1.75,1300,7770,1300,0,47.7347,-122.192
1.105E+06,4,1.5,2740,4000,1930,810,47.6343,-122.352
970000,4,1.75,4060,4000,2890,1170,47.6375,-122.389
915000,5,2.5,3490,18850,1840,1650,47.5955,-122.176
412000,4,1.75,1430,10500,1130,300,47.6083,-122.132
265000,4,1.75,1860,9112,1110,750,47.3792,-122.282
426000,4,2.25,2120,7700,1490,630,47.7207,-122.165
266000,4,2.25,1860,12693,1140,720,47.3114,-122.395
325000,3,2,2330,4950,1430,900,47.5585,-122.29
615000,3,1.75,1670,5100,990,680,47.5898,-122.291
310000,3,1.75,2130,7140,1580,550,47.3074,-122.341
340000,4,1.75,1900,7313,1900,0,47.7311,-122.232
562500,2,1,1170,2800,1170,0,47.6574,-122.345
447000,2,1,980,1600,980,0,47.638,-122.375
2.45E+06,7,4.25,4670,23115,4670,0,47.6183,-122.227
250000,4,1.5,2500,6300,1500,1000,47.3781,-122.284
633000,4,2.5,2020,8044,2020,0,47.6247,-122.043
310000,3,2,1290,886,1290,0,47.7161,-122.295
439000,2,1.75,1620,113862,1620,0,47.4821,-121.719
470000,3,3.25,1710,2381,1360,350,47.5477,-122.004
270000,3,2.5,1720,8550,1720,0,47.2837,-122.207
299500,3,1.75,1820,8813,1820,0,47.2622,-122.303
227000,3,1,1130,10018,1130,0,47.3733,-122.275
735000,4,2.75,3040,2415,3040,0,47.5188,-122.256
537000,3,3,2410,7479,2410,0,47.7394,-122.288
699000,4,2.5,2440,14470,1660,780,47.6401,-122.168
330000,2,1,800,4533,600,200,47.6979,-122.325
229000,3,1,1030,7800,1030,0,47.473,-122.324
200000,3,1,1480,5600,940,540,47.5045,-122.27
522500,3,1.75,1710,9707,1710,0,47.623,-122.105
1.295E+06,3,2.75,3450,5350,2590,860,47.6389,-122.407
2E+06,3,3.25,2610,16387,2610,0,47.7175,-122.278
200000,2,0.75,780,55764,780,0,47.442,-122.105
352000,3,1.75,1260,7200,1260,0,47.7189,-122.178
855000,4,3,2590,6250,2240,350,47.6774,-122.267
267000,3,2.5,1580,12250,1580,0,47.3771,-122.315
484000,2,1.75,1660,6000,1160,500,47.6624,-122.291
402000,4,2.75,2950,15540,2120,830,47.3845,-122.152
905000,4,2.25,2240,5000,1770,470,47.6027,-122.295
274000,4,1.75,1940,7500,1720,220,47.3736,-122.215
475000,3,1.75,1850,26445,1850,0,47.3412,-122.051
1.535E+06,4,4.5,5770,10050,3160,2610,47.677,-122.275
628000,4,2,2280,6010,1140,1140,47.6034,-122.289
675000,6,1.75,2740,6360,1370,1370,47.5062,-122.385
429900,4,3.25,3760,4675,2740,1020,47.3862,-122.048
260000,3,1.5,1580,8184,1140,440,47.4294,-122.331
690000,3,1.75,1600,4400,1030,570,47.6348,-122.281
1.081E+06,4,2.25,2100,12172,2100,0,47.5458,-122.227
360000,4,2.5,2610,7333,2610,0,47.2721,-122.293
499000,3,1.75,1840,5000,920,920,47.6808,-122.376
159000,3,1,1320,6534,1320,0,47.4806,-122.223
430000,3,1.75,1540,8100,940,600,47.749,-122.351
1.05E+06,5,2.75,2520,18625,1660,860,47.6409,-122.207
725000,5,2.5,3780,20000,1890,1890,47.7603,-122.273
150000,3,1,1200,9527,1200,0,47.5112,-122.316
840000,4,2.25,2720,8712,2720,0,47.5616,-122.153
499000,4,2.5,3100,5700,3100,0,47.3696,-122.058
285000,3,1.75,1630,4000,1100,530,47.5351,-122.353
340000,4,2.5,1910,7201,1210,700,47.3908,-122.316
405100,4,2,1580,7300,1580,0,47.7598,-122.328
464000,3,2.5,1690,4898,1690,0,47.6834,-122.038
723000,4,2.25,1960,8680,1290,670,47.6076,-122.192
430000,8,3.25,4300,10441,2800,1500,47.4786,-122.131
645000,3,1.75,1840,4255,940,900,47.58,-122.392
1.58E+06,4,2.75,3480,19991,2630,850,47.6354,-122.214
925000,5,3,2710,4200,1890,820,47.6754,-122.307
759000,4,1.75,2100,4750,1340,760,47.6695,-122.333
690000,4,2,1760,7800,1760,0,47.6945,-122.38
358800,4,2.5,2155,8140,2155,0,47.4204,-122.201
683000,5,1.5,1720,4000,1520,200,47.6197,-122.287
650000,3,1,1430,4240,1430,0,47.6595,-122.337
288000,5,2.75,2790,4807,2140,650,47.3098,-122.223
209950,3,1.5,1180,7300,1180,0,47.2857,-122.197
939000,3,3.5,2450,9248,1960,490,47.5476,-122.397
320000,3,1,1330,5850,930,400,47.5498,-122.298
283748,3,2.25,1940,9560,1940,0,47.2998,-122.387
370000,3,2.25,1600,7620,1280,320,47.774,-122.208
399950,4,2.75,3210,41689,1610,1600,47.3493,-122.062
360000,5,2.5,2880,6902,1680,1200,47.4332,-122.144
365000,2,1.5,1160,8060,1160,0,47.5146,-122.386
396900,3,2,1360,3120,1360,0,47.6943,-122.307
321000,3,2.5,2014,4500,2014,0,47.3371,-122.256
245000,3,2,1440,7008,1440,0,47.3702,-122.182
502000,2,1,1570,4704,1570,0,47.5256,-122.392
257000,4,2.75,2330,7642,1800,530,47.2946,-122.37
423000,4,1.75,1880,7303,1010,870,47.7129,-122.203
485000,4,2.25,1850,9911,1850,0,47.6019,-122.116
500000,4,2.5,2230,8560,2230,0,47.4877,-122.143
442000,2,1,990,4313,990,0,47.5677,-122.38
475000,3,1.75,1720,3825,1720,0,47.666,-122.327
625000,4,2.25,3230,9935,3230,0,47.7685,-122.257
194000,3,1,1180,6050,820,360,47.4945,-122.249
410000,3,2.25,1450,19206,1450,0,47.62,-122.052
1.0345E+06,4,2.5,2370,10858,2370,0,47.6336,-122.192
490000,4,2.5,2570,6157,2570,0,47.5389,-121.89
348500,4,1.75,1870,7575,1480,390,47.7205,-122.218
380000,3,1,1220,3000,1220,0,47.6506,-122.346
660000,3,2,1770,2150,1770,0,47.6102,-122.314
525000,3,1,1500,6800,1500,0,47.6706,-122.268
235000,3,2,1110,8724,1110,0,47.3056,-122.206
1.21E+06,4,3.75,4980,18069,4980,0,47.5348,-121.856
397950,4,1.75,2360,8116,1180,1180,47.7635,-122.335
268000,3,1.75,1600,7711,1600,0,47.284,-122.202
525000,3,1,1450,4000,950,500,47.5554,-122.266
549950,3,2.5,2680,5860,2680,0,47.7557,-122.223
370000,3,1.75,1150,6600,1150,0,47.6709,-122.185
299000,4,2.25,1870,6693,1870,0,47.2774,-122.299
715000,6,2.75,3400,5000,2860,540,47.6728,-122.362
430000,4,1.5,1810,7200,1810,0,47.7207,-122.186
345000,3,1.75,1860,7191,1260,600,47.4338,-122.168
1.6E+06,3,3.25,3790,19000,3790,0,47.724,-122.373
534640,3,2.5,2130,3500,1210,920,47.736,-122.159
1.225E+06,3,2.5,2860,4500,1980,880,47.6463,-122.371
351000,4,2.5,2370,7274,2370,0,47.3982,-122.171
745000,4,2.25,2290,10409,2290,0,47.6351,-122.168
320000,2,1,1120,5329,750,370,47.5421,-122.378
555700,3,2,1810,12420,1810,0,47.5888,-122.127
690000,4,2.5,3220,35400,3220,0,47.7547,-122.114
449000,3,1.75,1660,9697,1660,0,47.7564,-122.286
308500,2,1,850,6174,850,0,47.7352,-122.328
340000,4,2.5,2665,5868,2665,0,47.3831,-122.185
937750,4,2.75,2580,3560,1710,870,47.6753,-122.304
725126,4,2.5,3200,12369,3200,0,47.5273,-122.143
135000,3,1,840,3000,840,0,47.494,-122.275
635000,4,2.5,2970,7961,2020,950,47.7118,-122.29
245500,2,1,790,7500,790,0,47.7644,-122.198
230000,6,1.5,2140,36509,2140,0,47.2668,-122.252
1.77E+06,3,2.5,2580,14603,2580,0,47.6199,-122.212
425000,5,2.5,2180,7875,1200,980,47.7543,-122.341
220000,2,1,1060,10423,1060,0,47.705,-122.313
370000,3,2,1860,9100,1860,0,47.7522,-122.304
390000,3,2,1840,16815,960,880,47.4837,-122.11
239000,3,1.75,1340,16480,1340,0,47.364,-122.162
345000,4,2.25,2320,7350,2320,0,47.4512,-122.131
289000,3,2.5,2110,8304,2110,0,47.3558,-122.173
285000,5,1.5,1840,8050,1840,0,47.3668,-122.312
147400,3,2,1080,9225,1080,0,47.4842,-122.346
600000,2,1,1290,4636,1290,0,47.6393,-122.301
245000,3,2.25,2210,10794,1540,670,47.4911,-122.224
520000,3,2.25,2210,10794,1540,670,47.4911,-122.224
352500,3,2.25,1410,14110,1170,240,47.5336,-121.76
448000,5,3.5,3740,24684,2760,980,47.3832,-122.057
270000,4,2.75,2440,7150,1200,1240,47.3662,-122.282
872500,3,2.5,2040,6000,1840,200,47.6334,-122.35
2.1525E+06,4,3.25,3840,6214,2590,1250,47.6388,-122.406
225000,3,1.5,1660,7221,980,680,47.4962,-122.32
735000,4,2,1640,6000,1640,0,47.6505,-122.375
375000,3,1,1310,8400,1310,0,47.7253,-122.197
169000,3,1.75,1720,9775,1720,0,47.3731,-122.286
279950,3,1.75,1720,9775,1720,0,47.3731,-122.286
1.95E+06,4,2.75,4020,18745,2830,1190,47.6042,-122.21
310000,3,2.25,1960,2345,1750,210,47.5419,-122.288
975000,4,2.5,3240,35083,3240,0,47.6337,-122.154
650000,10,2,3610,11914,3010,600,47.5705,-122.175
930000,2,1.5,1800,4500,1000,800,47.6305,-122.347
412000,4,1.5,1960,5000,980,980,47.5688,-122.363
225000,3,1,1250,10200,1250,0,47.4902,-122.256
507000,3,2.5,2120,7201,2120,0,47.7174,-122.337
1.755E+06,4,4,3860,67953,3860,0,47.7469,-122.378
230000,3,2.5,1340,3011,1340,0,47.3839,-122.038
316000,1,2,1780,188465,1780,0,47.4506,-121.768
616200,5,3.25,3920,4832,3030,890,47.5202,-121.885
509900,3,1.75,1690,53578,1690,0,47.6546,-122.049
370000,4,2.5,2570,7753,2570,0,47.4237,-122.162
619100,3,1.75,1870,7030,1870,0,47.6999,-122.17
805000,3,2.25,2860,11250,2290,570,47.4534,-122.372
612125,2,1.5,1670,6000,1090,580,47.6517,-122.374
350000,2,1.5,1070,937,1070,0,47.6761,-122.3
225000,2,1,940,15000,940,0,47.4312,-122.195
335000,3,2.5,2588,5701,2588,0,47.3449,-122.151
972800,5,3.25,3500,10457,3500,0,47.5198,-122.157
500000,3,1.75,1690,48096,1690,0,47.6745,-122.061
2.2E+06,4,3.75,3790,7200,2530,1260,47.6264,-122.289
415000,3,1.5,1090,8400,1090,0,47.6219,-122.115
399000,3,3,2240,10479,1710,530,47.5529,-122.356
376000,2,1,1150,4000,1150,0,47.6575,-122.394
340000,3,2,1870,3378,1120,750,47.5371,-122.393
490000,5,2.75,2990,7200,2990,0,47.4955,-122.16
374000,4,2.5,2580,6260,2580,0,47.4858,-122.185
852000,4,1,2220,3588,1470,750,47.6854,-122.308
473000,3,2.25,1620,12309,1620,0,47.6188,-122.029
540000,3,1.75,2590,25992,1970,620,47.5521,-122.03
431000,2,2,1390,12530,970,420,47.7499,-122.29
435000,4,3,2270,7245,1410,860,47.7722,-122.315
1.051E+06,4,3,2920,33976,1460,1460,47.6164,-122.104
450000,3,2.75,1250,892,1040,210,47.5826,-122.387
157500,3,1,1100,27008,960,140,47.4963,-122.249
244000,3,1.75,1500,7475,1500,0,47.3155,-122.365
550000,3,2.5,2800,10603,2800,0,47.7528,-122.195
975000,4,2.5,3420,183387,3420,0,47.633,-121.972
426500,4,2.75,2100,88426,2100,0,47.399,-122.011
350000,3,1,1790,3876,1090,700,47.575,-122.288
615000,3,1,1790,3876,1090,700,47.575,-122.288
542000,3,2.25,2220,12056,2220,0,47.7148,-122.101
710000,4,1.75,2000,6000,1000,1000,47.6428,-122.348
289950,3,2.5,1770,9450,1770,0,47.3196,-122.272
1.9E+06,4,2.75,4280,12668,3900,380,47.6185,-122.219
528000,2,1,1260,5100,1120,140,47.6805,-122.384
471000,2,1,840,5100,840,0,47.6779,-122.384
250000,4,2.75,1830,6643,1830,0,47.2601,-122.286
155000,3,1.5,970,8400,970,0,47.3284,-122.331
515000,4,1.5,1740,8160,1400,340,47.7243,-122.363
336600,3,2.25,1654,8464,1654,0,47.3618,-122.033
915000,3,2.25,2390,2750,1580,810,47.6339,-122.354
350000,2,1.75,1080,7242,1080,0,47.7065,-122.235
1.3E+06,4,1.75,2610,21600,2610,0,47.6245,-122.227
175000,3,1,1070,6164,1070,0,47.3377,-122.291
545000,2,2,1430,3880,1430,0,47.6844,-122.392
475000,4,3,2400,5400,1600,800,47.5099,-122.26
390000,2,1,670,11505,670,0,47.499,-122.157
645000,4,2.5,2860,14000,2860,0,47.7306,-121.973
410000,3,1.5,2270,8187,1420,850,47.7573,-122.278
480000,4,2.5,2180,9861,2180,0,47.4817,-121.802
725000,3,1.75,1860,6000,1860,0,47.5981,-122.288
1.15E+06,6,4.5,6040,219542,4100,1940,47.5622,-122.003
300000,2,1,1010,11919,1010,0,47.7461,-122.322
752000,4,2.5,2570,8178,1710,860,47.5483,-122.261
585000,4,2.5,1950,3720,1950,0,47.5503,-121.997
678700,3,1.75,1970,10548,1300,670,47.6669,-122.179
603000,4,2.25,2110,11155,2110,0,47.6386,-122.058
715000,3,1.75,1650,7276,1150,500,47.6989,-122.399
1.395E+06,4,3,3520,128502,3520,0,47.7448,-122.117
1.085E+06,3,2.5,2840,7500,2840,0,47.7049,-122.224
467500,2,1.75,1490,4800,750,740,47.5496,-122.391
359000,3,2.25,1650,7218,1230,420,47.7237,-122.335
745000,4,2,1960,4520,960,1000,47.58,-122.405
450000,3,2.25,2450,42180,2450,0,47.3549,-122.111
935000,3,2,1720,2000,1060,660,47.6384,-122.35
615000,3,2.5,1980,3128,1890,90,47.5456,-122.016
1.031E+06,3,2.5,4110,35741,4110,0,47.6642,-122.171
283500,4,2.5,1990,5577,1990,0,47.3191,-122.191
340000,2,1,860,7102,860,0,47.7042,-122.369
370000,4,2.5,2320,9264,2320,0,47.4449,-122.274
1.15E+06,3,2.5,4190,9624,4190,0,47.5642,-122.127
265000,4,1,1940,9533,1080,860,47.4139,-122.208
480000,4,2.25,2520,2370,1690,830,47.6109,-122.303
667500,3,2,1880,3800,1030,850,47.6841,-122.309
1.398E+06,3,2.5,2910,10044,2910,0,47.5845,-122.199
2.3E+06,7,4.75,5310,8816,3650,1660,47.6221,-122.208
465000,3,2.25,2670,7500,1640,1030,47.4608,-122.354
192500,1,1,470,63737,470,0,47.2163,-121.984
345000,3,1,1060,5600,760,300,47.5116,-122.379
439800,3,1.5,1120,6900,1120,0,47.6023,-122.132
468000,4,1.75,2250,8580,1330,920,47.7633,-122.199
775000,4,2.5,2070,8473,1250,820,47.6608,-122.19
684680,4,2.25,2370,9360,2370,0,47.6518,-122.123
910000,4,3.5,3570,27699,3570,0,47.7173,-122.098
3.6409E+06,4,3.25,4830,22257,4830,0,47.6409,-122.241
375000,3,1.75,1160,22470,1160,0,47.7595,-122.23
250000,3,2.5,1610,6600,1610,0,47.2827,-122.302
3.065E+06,5,3,4150,7500,3510,640,47.6303,-122.362
442500,4,2.25,1840,7575,1390,450,47.7328,-122.198
900000,3,3.5,4080,217697,4080,0,47.2604,-122.139
699000,3,2,1820,4080,1820,0,47.6735,-122.401
360000,4,2,2680,18768,2680,0,47.3182,-122.279
1.675E+06,4,4.75,4790,25412,4790,0,47.603,-122.012
675000,5,2,2420,21000,2420,0,47.677,-122.165
345000,2,1,1130,8081,1130,0,47.7064,-122.355
229000,4,1,1320,5000,1320,0,47.5457,-122.363
300000,3,1,1290,12415,1290,0,47.3719,-122.461
392500,3,3.25,1600,1289,1600,0,47.6957,-122.375
552000,3,1,1120,2300,820,300,47.6797,-122.384
457000,2,1.75,2060,7192,1420,640,47.7038,-122.317
518000,4,2.5,2830,13760,2830,0,47.7334,-121.97
237000,3,2,1210,6634,1210,0,47.4097,-122.193
399950,3,2.25,1560,11997,1260,300,47.5378,-121.742
605000,3,2.25,2260,17114,2260,0,47.7537,-122.296
295000,4,2.5,1850,8198,1850,0,47.4079,-122.186
513000,4,2.5,1930,8040,1380,550,47.7283,-122.218
772500,4,2.5,3230,4290,3230,0,47.6874,-122.161
765000,4,2.5,3230,4290,3230,0,47.6874,-122.161
696950,4,2.75,2450,5376,1550,900,47.6865,-122.396
329000,3,1,1200,5650,1200,0,47.5065,-122.249
339999,3,2.5,2360,8093,2360,0,47.3257,-122.17
364500,3,1,1060,9506,1060,0,47.7317,-122.31
607500,5,1.75,2220,6000,1420,800,47.648,-122.384
550000,3,1,880,6664,880,0,47.6855,-122.199
479900,4,2,2510,9750,1630,880,47.7438,-122.229
1.12028E+06,4,4,2530,1774,2100,430,47.6362,-122.369
192000,2,1,700,10540,700,0,47.438,-122.336
250000,3,2,1500,5200,1060,440,47.3653,-122.09
340000,3,2,1130,9879,1130,0,47.635,-121.964
340000,3,2,1420,6060,830,590,47.5102,-122.372
635250,3,2.25,2210,22040,1510,700,47.5904,-122.194
324800,2,1,1170,5043,880,290,47.5492,-122.302
78000,2,1,780,16344,780,0,47.4739,-122.28
400000,4,1.75,1770,12875,1770,0,47.7438,-122.247
640500,3,1,1070,4505,1070,0,47.5305,-122.384
570000,3,2,1930,10929,1260,670,47.7657,-122.272
1.33E+06,3,1.5,1940,2885,1940,0,47.6308,-122.369
330490,3,2.75,1440,7350,1040,400,47.4431,-122.138
325000,3,2.5,1740,5267,1740,0,47.3777,-122.023
335000,3,2.5,1740,5267,1740,0,47.3777,-122.023
314000,5,2.75,2210,13500,1460,750,47.4468,-122.282
625000,4,2,2190,3622,1990,200,47.6887,-122.312
809000,3,2.5,2590,7720,2590,0,47.659,-122.146
535000,3,2.5,2790,19485,2790,0,47.4688,-122.124
275000,5,1.75,2180,9178,1140,1040,47.4364,-122.28
358000,4,2.75,2580,11900,1620,960,47.4475,-122.159
297975,3,2.25,2820,8100,1720,1100,47.4944,-122.304
492000,2,1.75,1300,22239,1300,0,47.4801,-122.092
210000,2,1,720,8040,720,0,47.4662,-122.359
622500,3,2.5,2260,4550,1380,880,47.5714,-122.376
550000,3,2.5,1550,1092,1390,160,47.6355,-122.324
190000,3,1.75,1390,7700,1390,0,47.4559,-122.183
340000,4,2.5,2380,9362,2380,0,47.3148,-122.349
678000,3,2.5,2640,5964,2640,0,47.7043,-122.128
275000,5,2,2260,11970,1250,1010,47.3896,-122.218
493000,3,2.75,1720,6720,1270,450,47.6138,-122.298
147000,3,1,1070,14000,1070,0,47.4971,-122.279
334000,3,2.25,2000,7225,2000,0,47.349,-122.167
605000,4,2.5,2800,10786,1420,1380,47.5959,-122.116
365000,3,1.75,1450,61419,1450,0,47.3343,-122.16
345000,3,1,1620,10610,1620,0,47.474,-122.125
999000,3,2.5,2710,23292,2080,630,47.7608,-122.374
470000,2,1.75,1520,4220,840,680,47.6876,-122.366
599000,5,2.75,2730,22572,2080,650,47.5951,-122.037
255000,3,2.25,1740,10378,1740,0,47.3815,-122.09
295000,4,1.75,1800,28650,1800,0,47.3926,-122.166
550000,4,3.5,4150,16197,4150,0,47.3423,-122.183
1.305E+06,5,3.5,3270,4080,2180,1090,47.6754,-122.327
225000,2,1,1070,6000,1070,0,47.495,-122.227
520000,4,0.75,1960,8277,1320,640,47.3648,-122.325
345000,3,3.25,1600,1882,1360,240,47.7151,-122.355
475000,4,1.75,1650,7775,1150,500,47.715,-122.354
497500,5,1.5,2170,8610,1230,940,47.6111,-122.126
649500,3,3,3730,383328,2230,1500,47.4257,-122.03
734500,4,2.75,3280,6845,3280,0,47.7042,-122.107
276000,3,1,870,8040,870,0,47.7048,-122.368
235000,2,1,900,28800,900,0,47.5245,-121.822
325000,2,1,1400,10800,1400,0,47.7726,-122.21
425000,4,2.75,1680,9545,1080,600,47.739,-122.243
307000,4,2,2390,23972,1720,670,47.3197,-122.343
635000,3,2.5,2300,5500,2000,300,47.5785,-122.293
223000,3,1.75,1340,7473,1340,0,47.3087,-122.206
425000,3,2.75,2600,10874,2600,0,47.3815,-122.146
190000,3,2.25,1640,7730,1220,420,47.3576,-122.039
275000,4,1.75,1960,6177,1960,0,47.3131,-122.383
450000,3,2.5,1480,1961,1480,0,47.5478,-122
1.468E+06,4,3.25,5010,34460,5010,0,47.5469,-122.127
550000,4,2,1540,5000,1540,0,47.6713,-122.3
835000,4,2.75,4030,10240,3310,720,47.7168,-122.365
900000,6,3,3020,13783,3020,0,47.5722,-122.226
290000,2,2,1590,9375,910,680,47.4585,-122.205
1.035E+06,4,2.5,2910,9131,2910,0,47.6826,-122.186
780000,4,2.5,3020,15164,1730,1290,47.5882,-122.192
572500,3,2,2290,11200,2290,0,47.6517,-122.124
389000,3,1.75,2180,9220,1090,1090,47.3547,-122.285
350000,4,1.75,2740,10086,1440,1300,47.5112,-122.329
476000,4,2.5,2740,33158,2740,0,47.3333,-122.074
1.04625E+06,2,3,2330,3600,1870,460,47.6316,-122.282
287000,3,2.25,2300,7200,1550,750,47.324,-122.328
707500,4,4,1550,6596,1550,0,47.6711,-122.398
464500,4,2.5,1750,11381,1610,140,47.7425,-122.321
720000,3,1.5,2180,5000,1090,1090,47.5787,-122.402
319000,3,2.5,1610,8544,1610,0,47.3714,-122.054
330000,3,1,1570,9136,1570,0,47.7688,-122.337
120750,3,1.75,1140,9628,1140,0,47.2933,-122.372
195000,3,1.75,1140,9628,1140,0,47.2933,-122.372
650000,4,1.5,2480,6383,1380,1100,47.6445,-122.374
530000,3,1.75,1690,8190,1690,0,47.5857,-122.172
825000,4,3,2910,8027,1800,1110,47.6939,-122.391
436000,4,2,1600,15044,1600,0,47.72,-122.216
658000,2,1,1010,14244,1010,0,47.5476,-122.399
547500,3,2,1850,9570,950,900,47.697,-122.322
762000,3,1.75,2150,2527,1400,750,47.6629,-122.329
340000,3,1.75,2650,7378,1460,1190,47.7525,-122.315
880000,4,1.75,2510,5800,1830,680,47.648,-122.41
1.22E+06,4,2.5,3240,3600,2060,1180,47.6405,-122.356
1.95E+06,4,2.5,3440,14554,2170,1270,47.7364,-122.286
382500,3,2,1150,6249,1150,0,47.7489,-122.284
344500,3,1.75,1890,9535,1210,680,47.4872,-122.223
375000,4,2.75,1430,7403,1030,400,47.5346,-122.344
276000,1,0.75,370,1801,370,0,47.6778,-122.389
500000,5,3.25,3130,12087,2180,950,47.5336,-122.052
330000,4,2.5,2105,6093,2105,0,47.3531,-122.147
328000,3,1,890,5965,890,0,47.7518,-122.279
450000,3,1.5,1340,7200,1340,0,47.718,-122.193
840500,4,2.25,2290,12174,1490,800,47.5114,-122.245
679000,3,2.5,2770,9350,2770,0,47.5253,-122.201
270000,3,1.5,1890,9450,1090,800,47.4829,-122.341
757500,5,2.25,3160,8065,3160,0,47.5678,-122.089
524950,2,2.5,1830,2856,1830,0,47.5524,-121.996
424900,4,2.75,2950,49658,2950,0,47.3596,-121.922
551100,3,1,1430,8640,1430,0,47.572,-122.147
421000,3,2,1420,12655,1420,0,47.5309,-122.186
635000,4,1.75,2460,7560,2460,0,47.7256,-122.367
255000,3,1,1340,6120,1340,0,47.5272,-122.322
419950,4,1,1530,7920,1030,500,47.4544,-122.36
325000,6,3,2650,12870,2650,0,47.2069,-121.989
281000,4,2.25,1677,3600,1677,0,47.32,-122.178
655275,3,1.75,2050,11856,1460,590,47.5735,-122.162
861000,3,2,2520,3959,1270,1250,47.6693,-122.289
850000,3,3.5,2620,11148,2060,560,47.5845,-122.115
246000,3,2.5,1650,6675,1290,360,47.2899,-122.372
380000,2,1,700,4836,700,0,47.7139,-122.288
813000,4,2.5,3430,7508,3430,0,47.6866,-122.11
990000,4,2.5,3140,11049,3140,0,47.5817,-122.192
650000,3,2.5,2350,3750,1740,610,47.6767,-122.365
273000,4,3,1990,6180,1990,0,47.3083,-122.36
398000,4,2.5,2050,14724,2050,0,47.73,-121.969
200000,2,1,930,8665,930,0,47.4822,-122.318
839000,3,1,1230,12305,1230,0,47.6095,-122.195
502000,3,2.5,1870,9135,1250,620,47.6269,-122.06
305000,3,2.25,2110,7665,1360,750,47.3082,-122.372
574950,5,3.25,3160,10000,3160,0,47.52,-122.047
311000,3,1,1120,8631,1120,0,47.7077,-122.314
1.65E+06,3,2.25,2750,6203,1620,1130,47.6163,-122.068
387000,3,1,1230,9568,1230,0,47.539,-122.179
375000,3,1.5,1190,20672,1190,0,47.4459,-122.359
175000,2,1,740,3434,740,0,47.2088,-121.992
248000,4,2.5,1770,5855,1770,0,47.3483,-122.053
336750,4,2.25,1720,7803,1350,370,47.5119,-122.337
685000,4,2.5,2770,45514,2770,0,47.7751,-122.088
645000,4,2.75,2330,3917,2330,0,47.5527,-121.99
279000,3,2.5,1660,7388,1660,0,47.3865,-122.027
479000,2,2.5,1730,1037,1730,0,47.5594,-122.285
466000,3,2.25,1880,7279,1280,600,47.7574,-122.322
361500,4,2.75,2190,6740,2190,0,47.3804,-122.027
404000,3,1.75,1720,7202,1720,0,47.5044,-122.19
319000,4,3.25,2360,8344,2360,0,47.4403,-122.126
320000,3,1.5,1490,10132,1490,0,47.4779,-122.145
1.311E+06,4,3.75,3490,5625,2610,880,47.6685,-122.332
1E+06,3,2.75,2370,8900,1670,700,47.5648,-122.156
660000,4,2.5,2290,9120,2290,0,47.5613,-122.128
546000,4,3,1790,3600,1790,0,47.6117,-122.313
300000,4,1.75,1820,5015,1190,630,47.5569,-122.31
500000,2,1.5,1760,12000,1760,0,47.6288,-122.109
381500,4,2.5,2430,5556,2430,0,47.3762,-122.126
990000,3,2.25,2630,12899,2630,0,47.5479,-122.233
278226,4,2.5,2390,4639,2390,0,47.3527,-121.999
340000,2,1.75,1500,4158,1220,280,47.7006,-122.35
305000,4,2.5,2510,12000,1520,990,47.3086,-122.384
760000,4,2.5,2420,10285,1700,720,47.4871,-122.36
195000,4,1.5,2170,9948,2170,0,47.4263,-122.331
564000,4,1.75,1960,6138,1260,700,47.6968,-122.299
539500,4,2.25,2280,8550,1660,620,47.701,-122.231
299980,4,1.5,1580,10230,790,790,47.5002,-122.246
290000,4,2.5,1850,5674,1850,0,47.3536,-122.142
257000,2,1,770,11084,770,0,47.7482,-122.321
518500,4,3,2120,5520,1420,700,47.7085,-122.286
657000,4,2.75,3060,35380,1810,1250,47.6198,-122.038
590000,3,2.25,2680,41250,2680,0,47.4817,-121.749
526000,4,1.75,2220,6350,1110,1110,47.7136,-122.29
254500,2,1,1150,11250,1150,0,47.486,-122.264
575000,2,1,980,3663,980,0,47.6645,-122.288
464550,3,1.5,1690,10500,1690,0,47.7018,-122.165
409950,3,1.75,1320,6030,1320,0,47.6993,-122.13
100000,2,1,910,22000,910,0,47.2777,-122.252
365000,2,1.5,820,1270,820,0,47.5925,-122.295
208000,3,1,1300,7420,1300,0,47.2899,-122.219
497950,4,2.5,1950,3000,1550,400,47.565,-122.281
405000,5,3.5,3672,9742,3006,666,47.3255,-122.192
568000,3,2.5,2740,22499,2740,0,47.4597,-122.153
334000,2,1,890,6000,890,0,47.5437,-122.281
235000,3,2,1090,8400,1090,0,47.4942,-122.322
295000,2,1,1170,10621,1170,0,47.497,-121.78
610000,4,3,2600,29539,2600,0,47.746,-122.231
453500,4,1.75,2000,6032,1300,700,47.5132,-122.389
1.22E+06,4,3.75,3520,3944,2200,1320,47.6424,-122.348
175000,2,1,1410,7000,1410,0,47.4908,-122.223
335000,2,1,1410,7000,1410,0,47.4908,-122.223
275000,3,1.5,1950,7620,1010,940,47.4594,-122.346
400000,2,1,980,2130,860,120,47.6769,-122.366
915000,3,2.75,3390,7000,1740,1650,47.5701,-122.408
619850,4,2.5,2270,9247,1500,770,47.5602,-122.176
225900,3,1,1510,8800,1010,500,47.329,-122.33
525000,2,1.5,960,7200,960,0,47.649,-122.403
215000,4,2.25,1900,9600,1900,0,47.4208,-122.2
802000,3,2.5,2580,13096,2580,0,47.6616,-122.144
330000,4,2.5,2340,11784,2340,0,47.384,-122.149
549800,3,2.25,1580,11680,1580,0,47.5872,-122.17
195500,4,1,1230,8636,1230,0,47.3231,-122.219
338000,3,2.5,1590,7819,1590,0,47.4367,-122.199
3.2E+06,4,3.25,7000,28206,3500,3500,47.5928,-122.086
480000,4,2.25,1770,7000,1770,0,47.7193,-122.218
383000,4,2.5,1850,8310,1200,650,47.7717,-122.29
257000,3,1.75,1430,7210,1430,0,47.4189,-122.168
335000,4,2.75,2190,9209,2190,0,47.3341,-122.188
422000,4,2.5,2310,6650,2310,0,47.4513,-122.267
560000,3,1.75,2000,10182,1400,600,47.6616,-122.175
680000,4,2.75,3620,35429,3620,0,47.4238,-122.098
320000,2,1,1210,7040,1210,0,47.745,-122.297
665000,3,2.5,2330,15536,2330,0,47.655,-122.087
751000,3,2.5,2840,6854,2840,0,47.6006,-121.978
320000,6,2.75,2410,10763,1310,1100,47.4429,-122.282
290000,4,1.75,1820,22043,1820,0,47.7606,-122.28
250000,4,2,1470,7412,1470,0,47.3702,-122.318
423000,3,1.75,1100,10005,1100,0,47.5374,-122.173
601002,4,2.5,2050,8094,1050,1000,47.6614,-122.138
352900,2,1.5,1240,1892,1240,0,47.5915,-122.295
509950,3,2.5,2210,70567,2210,0,47.6087,-121.895
360000,2,1.75,1340,1050,1340,0,47.7053,-122.343
1.075E+06,4,2.75,2580,8100,1780,800,47.5387,-122.215
349950,3,2.5,2390,6441,2390,0,47.3659,-122.029
395000,4,2.5,2250,6840,2250,0,47.4398,-122.151
273500,3,1.5,2000,15265,1540,460,47.387,-122.281
700000,4,1.75,1870,6000,1670,200,47.6435,-122.399
699000,3,2.5,2370,10968,2370,0,47.6679,-122.172
537000,4,2.25,2640,8800,1620,1020,47.7552,-122.148
405000,3,1.5,1240,9975,1240,0,47.5667,-121.905
269500,2,1,800,1200,800,0,47.6969,-122.347
260000,4,2.5,2050,12500,1300,750,47.42,-122.319
266750,3,2.25,1650,10000,1650,0,47.3862,-122.315
1.8E+06,5,3.75,4320,39094,4320,0,47.7519,-122.276
779000,2,2.25,2130,5920,1830,300,47.6792,-122.275
500000,3,2.5,2840,48716,1870,970,47.6832,-121.915
365000,4,1.75,3080,32997,3080,0,47.498,-122.321
724000,2,1,1560,5000,1560,0,47.7006,-122.386
890000,4,2.75,3220,15467,3220,0,47.7128,-122.083
431000,4,2.5,1450,3600,1250,200,47.5985,-122.298
242000,2,1,960,21850,960,0,47.4122,-122.267
415000,4,2.5,2670,8279,2670,0,47.4292,-122.328
727160,7,3.75,2310,5000,2310,0,47.6781,-122.376
1.11E+06,4,3.25,3520,19354,2010,1510,47.5572,-122.147
265000,2,1.75,1090,3272,1090,0,47.3794,-122.32
519000,3,1.75,2000,5680,1080,920,47.6805,-122.366
262000,4,1.5,1840,9009,1840,0,47.406,-122.318
1.19E+06,4,2.5,3160,13194,3160,0,47.5472,-122.233
295000,3,1.75,1520,6559,1170,350,47.35,-122.037
615000,3,1.75,2110,56192,1480,630,47.7701,-122.138
1.1E+06,4,2.75,3410,7750,1710,1700,47.5718,-122.406
575000,4,2.5,2630,6247,2630,0,47.5662,-122
388000,3,1.75,1350,2325,1350,0,47.6965,-122.35
750500,4,2.5,2860,9159,1530,1330,47.6923,-122.2
527500,3,1.75,2310,78844,1760,550,47.5406,-122.066
503000,3,2,2590,108900,1980,610,47.4088,-122.055
1.047E+06,4,3.5,3500,4000,2560,940,47.628,-122.299
325000,2,1,800,7260,800,0,47.5359,-122.367
402000,3,1.75,1580,6127,1580,0,47.7192,-122.32
370000,3,1.5,1560,6774,1060,500,47.7024,-122.35
329950,3,1,1750,7800,1150,600,47.4596,-122.343
135000,2,1,600,6120,600,0,47.5,-122.317
482500,4,3,1630,7626,1110,520,47.7168,-122.308
259000,4,1.5,1260,7248,1260,0,47.433,-122.292
210000,3,2.25,2140,9775,1470,670,47.306,-122.379
459000,4,2.75,2790,6600,2790,0,47.4362,-122.109
375000,3,1.75,2530,35150,1800,730,47.3913,-122.121
295000,3,2.25,1330,7200,900,430,47.5102,-122.364
910000,3,2,2700,6120,1350,1350,47.6731,-122.327
470000,4,1,1740,37238,1740,0,47.5651,-121.902
565000,4,2,2070,7980,2070,0,47.5092,-122.386
339950,4,2.25,2670,9040,2170,500,47.4666,-122.326
547000,5,3,2200,103237,1160,1040,47.7726,-122.111
125000,2,1,810,8382,810,0,47.5033,-122.358
2.3E+06,4,4.75,3970,9778,3390,580,47.6312,-122.366
348000,3,2.5,2370,7500,1620,750,47.4091,-122.331
175000,3,1,1460,11880,1460,0,47.3762,-122.219
439950,3,2.5,1770,2875,1770,0,47.5631,-122.397
230000,3,1,1120,32250,1120,0,47.447,-122.482
207000,3,2.5,1520,2550,1520,0,47.5245,-122.33
320000,5,2.5,3020,21441,1510,1510,47.3392,-122.131
1.089E+06,5,3.25,5600,107157,3440,2160,47.7341,-122.102
510000,4,1.5,1320,14250,1320,0,47.7016,-122.199
730000,4,1,1870,4992,1670,200,47.6437,-122.396
750000,3,3.75,2460,7630,1940,520,47.7147,-122.373
237000,3,1.5,960,7400,960,0,47.3798,-122.306
560000,3,2.5,3440,103672,3440,0,47.3895,-121.986
745000,3,2.75,3010,12432,1890,1120,47.6392,-122.108
1.825E+06,3,3.75,6030,39317,4440,1590,47.6055,-122.21
180000,3,2.25,1990,6350,1990,0,47.3822,-122.316
309950,3,2.25,1990,6350,1990,0,47.3822,-122.316
715000,4,1,1710,6050,1410,300,47.5569,-122.288
620000,4,2.25,1890,4300,1350,540,47.6649,-122.337
330000,3,2.5,1990,9995,1990,0,47.383,-122.305
525000,4,1.75,1600,7400,1210,390,47.7111,-122.309
611000,6,2.5,3820,53173,2040,1780,47.5209,-122.052
294000,4,2.5,2210,8465,1490,720,47.2647,-122.221
463000,3,1.75,2020,11095,1480,540,47.7351,-122.183
320900,3,2,1770,7251,1770,0,47.4087,-122.17
369950,4,2.5,2050,4502,2050,0,47.5002,-122.15
565000,4,2.75,3130,139392,3130,0,47.3535,-122.19
589500,4,1.5,3520,4933,2270,1250,47.5655,-122.315
400000,4,1.75,1810,9750,1810,0,47.7681,-122.311
458000,3,2.25,2150,9900,1450,700,47.6647,-122.149
436000,4,2.5,2495,5751,2495,0,47.7243,-121.957
310000,3,2,1290,6150,1290,0,47.5181,-122.257
398000,5,2.5,3004,5700,3004,0,47.3801,-122.185
625000,4,2.25,2070,7200,1390,680,47.697,-122.169
1.005E+06,5,3.25,4050,35600,4050,0,47.5465,-122.122
435000,2,1,960,6250,740,220,47.5378,-122.375
250000,3,2.25,1900,9990,1300,600,47.3478,-122.298
430000,3,1.5,1450,7316,1450,0,47.7725,-122.349
790000,4,3.5,2720,3000,2250,470,47.5371,-122.388
1.681E+06,5,5.25,4830,18707,3930,900,47.5858,-122.247
250000,4,2.75,1920,7102,1130,790,47.539,-122.356
1.12E+06,5,1.5,2540,6660,2340,200,47.5144,-122.393
383900,3,1.5,1600,8040,1050,550,47.7471,-122.337
330000,4,2.5,2210,5929,2210,0,47.35,-122.139
624000,3,2.5,2510,47044,1910,600,47.7531,-122.14
383000,5,2,2280,5750,1140,1140,47.5672,-122.39
687000,4,3.25,4400,186846,4400,0,47.1593,-121.957
558000,4,3.25,3160,8876,2460,700,47.5153,-122.178
275000,3,2,1380,3500,1380,0,47.5558,-122.27
687500,5,2.75,3320,10500,2020,1300,47.692,-122.166
275000,3,2.5,1870,6821,1870,0,47.3065,-122.358
700000,3,3.5,3030,11550,3030,0,47.5051,-122.381
342500,2,1.75,1210,7507,1210,0,47.7078,-122.234
483500,4,2.5,2740,45732,2740,0,47.74,-122.048
190000,3,1.75,1350,7370,1350,0,47.5336,-122.278
300000,3,1.75,1350,7370,1350,0,47.5336,-122.278
540000,3,2,1470,1691,1000,470,47.6743,-122.316
140000,3,1.75,1270,8991,1270,0,47.3563,-122.149
275000,4,1.75,1680,19405,1560,120,47.4552,-122.202
370000,3,2.75,2120,7650,2120,0,47.4923,-122.178
227000,2,1,1040,9100,1040,0,47.7407,-122.347
312000,4,1,1730,8706,1010,720,47.4586,-122.175
260000,2,1,1410,5650,1410,0,47.5159,-122.258
797000,3,2.5,1370,1911,1370,0,47.6375,-122.354
640000,6,2,2840,228690,2720,120,47.7158,-121.966
605000,4,1.75,3280,35160,2080,1200,47.6728,-122.061
329950,3,2.25,2070,7995,1350,720,47.403,-122.175
180000,2,1,960,87991,960,0,47.63,-121.9
220000,3,2.25,1470,7518,1160,310,47.2725,-122.3
723000,4,2.25,2430,4748,1630,800,47.5904,-122.389
375000,3,1.75,1430,8412,1070,360,47.7218,-122.299
388000,3,1.75,1760,9277,1760,0,47.4977,-122.358
249950,5,2,1730,7375,1730,0,47.4953,-122.238
390000,5,1.75,2290,7900,1190,1100,47.7577,-122.358
705000,4,1.75,1690,11739,1690,0,47.552,-122.219
590000,4,2.5,3220,7875,3220,0,47.626,-122.12
292000,4,1.75,2130,11097,1370,760,47.4629,-122.356
506000,3,2.5,2100,213008,2100,0,47.2984,-122.144
907500,4,2.5,2770,8642,2770,0,47.6599,-122.146
2.27115E+06,4,3.25,4040,18916,4040,0,47.6155,-122.238
319500,4,2.75,2500,5100,1420,1080,47.523,-122.332
265000,5,1.75,1580,5292,980,600,47.5677,-122.29
237000,3,1,1130,10650,1130,0,47.4363,-122.286
235000,5,1,1500,9282,1500,0,47.4702,-122.281
740000,4,2.25,2230,6000,1810,420,47.6464,-122.391
359000,3,1.5,1550,4980,1080,470,47.7035,-122.34
334950,4,2.5,2230,5500,2230,0,47.3533,-122.023
259950,2,1,790,8100,790,0,47.7159,-122.305
253000,4,2.5,2230,4541,2230,0,47.3848,-122.1
561000,3,2.25,1710,4140,1710,0,47.5498,-121.997
455000,2,1.5,1260,5100,1260,0,47.6914,-122.288
675000,4,2.5,2420,18470,920,1500,47.6001,-122.176
267000,3,1.5,1090,8160,1090,0,47.4551,-122.175
368000,4,2.5,2689,5724,2689,0,47.3799,-122.184
599995,3,1,1620,3000,1620,0,47.6888,-122.347
342500,3,1,940,10500,940,0,47.7268,-122.229
252000,4,1.75,1940,13370,1940,0,47.3215,-122.369
247200,3,1,1590,11200,1590,0,47.2894,-122.188
910000,3,3.5,3020,4082,2080,940,47.651,-122.409
419950,4,1.75,1870,16549,1870,0,47.7482,-122.083
160000,3,1,880,8976,880,0,47.3056,-122.368
799950,4,3.5,3030,5494,3030,0,47.7103,-122.109
400000,3,2.25,2140,11266,2140,0,47.7267,-121.966
210000,5,2,2050,10200,1430,620,47.4136,-122.333
475000,5,2,2050,10200,1430,620,47.4136,-122.333
355900,3,2.5,2090,3821,2090,0,47.3655,-122.017
420000,3,2.25,2520,26943,1760,760,47.7728,-122.25
710000,4,2.5,2630,8580,1700,930,47.5916,-122.166
518000,4,1.75,2560,15000,1880,680,47.5952,-122.053
375000,3,1,1200,5404,1200,0,47.6969,-122.368
185000,3,1.5,1010,7755,1010,0,47.4238,-122.332
402000,3,2.5,1520,3425,1520,0,47.6801,-122.161
585000,3,1.75,2170,153767,2170,0,47.3694,-122.065
500000,4,2,1980,4500,1980,0,47.6728,-122.379
1.715E+06,4,2.5,3070,7207,2670,400,47.6325,-122.29
1.68E+06,5,3.5,5170,7197,3520,1650,47.7561,-122.271
570000,2,2,1140,690,760,380,47.6205,-122.3
680000,8,2.75,2530,4800,1390,1140,47.6241,-122.305
345000,3,2.25,1690,14615,1690,0,47.4492,-121.78
355000,4,2.5,2150,3600,2150,0,47.3658,-122.019
390000,3,1.5,1180,7700,1180,0,47.6133,-122.133
128000,3,1,1400,9690,1400,0,47.3201,-122.398
448500,3,1.75,1300,4800,1300,0,47.5457,-122.383
346000,3,1.75,1590,9636,1590,0,47.754,-122.321
779000,3,1.75,1990,5600,1330,660,47.65,-122.415
335000,3,1.75,1510,9720,1510,0,47.7728,-122.258
1.85E+06,4,3.25,2910,1880,1830,1080,47.616,-122.282
799990,3,2.5,2850,21780,2850,0,47.6455,-122.04
1.075E+06,3,2.5,2830,56628,2830,0,47.7409,-122.198
371000,2,1.5,1110,1189,1110,0,47.6711,-122.377
620000,4,2.5,1900,9775,1900,0,47.6856,-122.168
343000,4,1.75,2290,10290,1340,950,47.5045,-122.369
265000,3,1,1010,14948,1010,0,47.4772,-122.144
1E+06,5,2.5,4670,15857,4670,0,47.63,-122.011
825000,3,2.5,3400,38400,1870,1530,47.7611,-122.372
889000,4,3.5,4070,10976,4070,0,47.5805,-121.97
305000,3,2.25,1630,10962,1100,530,47.3801,-122.166
407000,2,2.5,1700,6635,1700,0,47.6655,-122.13
613000,5,2.5,2070,12000,1340,730,47.626,-122.104
1.6375E+06,3,3.5,4660,21164,4660,0,47.4418,-122.354
645000,3,3.75,2050,6000,1550,500,47.6873,-122.332
1.16E+06,4,3.5,4680,9700,3360,1320,47.5703,-122.165
610000,3,2.25,2320,38186,2320,0,47.6645,-122.068
450000,3,2.5,3800,13071,2730,1070,47.3076,-122.397
300000,3,2,720,7598,720,0,47.5483,-122.36
1.12E+06,5,2.75,4400,18500,2250,2150,47.7424,-122.263
418200,3,2.5,2260,74297,2260,0,47.2704,-122.013
250000,3,2.5,1650,2802,1650,0,47.4328,-122.196
619000,3,2.5,2560,43608,2560,0,47.7614,-122.026
500000,4,3,3720,15048,3720,0,47.5116,-122.144
465000,4,2.5,2590,16437,2590,0,47.3714,-122.059
322000,4,1,1750,68841,1750,0,47.4442,-122.081
276900,3,2.5,1620,7320,1620,0,47.3617,-122.054
660000,3,2.25,1700,12615,1300,400,47.6965,-122.197
480000,3,2.5,2450,28185,2450,0,47.4665,-122.122
925000,3,1.75,1610,10796,1070,540,47.6272,-122.208
825000,3,3,3730,35900,2960,770,47.5814,-122.122
326000,2,1,1210,7440,780,430,47.7376,-122.322
205000,3,1,1300,9880,1300,0,47.3352,-122.297
150000,2,1,850,54000,850,0,47.2959,-122.377
593567,3,2.5,1770,3205,1770,0,47.6658,-122.084
440000,3,2.5,2060,11231,2060,0,47.7571,-122.141
751000,3,2.5,3090,13316,3090,0,47.588,-122.079
295000,2,1.75,1050,6500,1050,0,47.4727,-122.2
422500,3,2,1300,2250,1300,0,47.6923,-122.332
480000,3,1,1160,8800,1160,0,47.6112,-122.128
890900,4,2.5,3420,6233,3420,0,47.5416,-121.998
672500,4,2.75,2620,6707,2620,0,47.5965,-122.038
605000,4,1.5,1880,3500,1080,800,47.6835,-122.347
1.675E+06,5,3.25,4560,19080,2490,2070,47.6291,-122.226
565000,4,2.5,2330,7936,2330,0,47.6269,-122.03
725000,4,1.75,2350,7574,1720,630,47.5634,-122.087
640000,3,3,1560,1466,1560,0,47.6604,-122.352
253750,4,1,1380,7110,1380,0,47.3846,-122.226
799950,6,2.75,3040,36721,1760,1280,47.4488,-122.356
595000,4,1.5,1350,8113,1350,0,47.5807,-122.196
850000,4,2.5,3180,11652,3180,0,47.567,-122.212
366000,3,2.5,1790,4065,1790,0,47.7344,-121.965
715000,4,3,1986,6000,1746,240,47.5374,-122.39
300000,4,2.5,2400,7215,2400,0,47.2944,-122.371
960000,4,3,4590,9150,3490,1100,47.7234,-122.372
812000,3,2,1970,3420,1970,0,47.6762,-122.354
234950,3,1,1360,9948,1360,0,47.3422,-122.053
656500,4,2,2710,4750,1460,1250,47.6756,-122.305
255000,2,1.5,920,1598,920,0,47.7081,-122.342
538000,3,2.75,2000,7204,1250,750,47.565,-122.116
260000,3,2.25,1920,9680,1300,620,47.412,-122.195
546200,3,2.5,2678,6607,2678,0,47.738,-122.235
280500,3,1,1220,4541,890,330,47.5387,-122.294
295000,3,1.75,1440,4000,1050,390,47.5329,-122.354
700000,4,1.75,2420,520,2420,0,47.6209,-122.302
560000,3,2,2090,15790,2090,0,47.7296,-122.199
912000,4,2.75,4030,10888,4030,0,47.5651,-122.034
437000,3,1.75,1310,9282,1310,0,47.6844,-122.111
447000,3,2.5,1800,3074,1800,0,47.7631,-122.149
500000,4,1,1160,20100,820,340,47.5175,-122.201
508300,3,1,1160,5969,880,280,47.6844,-122.306
485000,3,1.5,1870,7853,1300,570,47.7045,-122.281
540000,7,5.75,3700,7647,3700,0,47.7393,-122.289
356000,3,2.25,2280,8765,2280,0,47.4419,-122.133
525000,4,2,1720,6099,860,860,47.6765,-122.287
962800,4,2.75,3630,11775,3630,0,47.6378,-122.066
315000,4,2.5,2040,6300,2040,0,47.3918,-122.185
525000,3,2.25,1750,1879,1750,0,47.6722,-122.391
325000,2,2.25,1550,2285,1550,0,47.5398,-122.369
965800,4,1.75,2500,8725,1500,1000,47.6304,-122.205
550000,4,1,1440,3600,1440,0,47.5694,-122.385
182200,4,1,1130,13927,1130,0,47.4939,-122.3
315000,3,1,1210,8505,1210,0,47.5389,-122.353
500000,2,1,960,5000,960,0,47.6755,-122.367
480000,5,2.5,2160,7737,2160,0,47.5381,-121.872
1.69E+06,3,1.75,3400,8965,1820,1580,47.6569,-122.273
525000,5,3.25,3960,321908,2690,1270,47.3984,-122.055
407500,4,2.5,1900,9075,1900,0,47.7776,-122.352
443000,4,3,2620,35124,2620,0,47.3067,-122.116
1.2565E+06,4,2.5,3150,13700,3150,0,47.5309,-122.224
642000,3,1,1040,4480,870,170,47.6461,-122.356
520000,3,1.75,1540,7558,1540,0,47.6707,-122.156
750000,3,2,1820,5000,1720,100,47.5845,-122.395
855000,5,1.5,1930,4500,1930,0,47.6401,-122.303
275000,4,1,1430,27153,1430,0,47.5372,-121.744
265000,5,2.75,2920,5250,1800,1120,47.3072,-122.221
894400,3,2.5,3100,45738,3100,0,47.6854,-122.048
546000,2,1,1200,12856,1200,0,47.5321,-122.034
699950,2,2.5,2390,7489,2390,0,47.7243,-122.032
435000,3,2,1270,10713,1270,0,47.7247,-122.181
259500,4,1.5,1300,7200,1300,0,47.4179,-122.181
359950,4,3.25,2290,4785,2290,0,47.3833,-122.037
517000,3,1.75,1740,10000,1740,0,47.617,-122.058
579000,3,1,1590,5400,1280,310,47.5509,-122.261
525000,4,2,2420,10735,2420,0,47.6899,-122.122
320000,4,2.5,2130,9653,1500,630,47.4068,-122.175
635000,4,1.75,1950,13320,1370,580,47.6196,-122.139
400000,4,2.5,2150,5397,2150,0,47.4644,-122.151
455000,3,1.75,1270,7700,1270,0,47.6711,-122.148
572000,3,1.75,1850,22767,1850,0,47.6144,-122.067
650000,2,1.5,1440,136778,1140,300,47.7608,-122.118
162500,3,1.5,1390,7417,1390,0,47.3369,-122.275
400000,2,2.5,1340,1240,1150,190,47.6858,-122.102
268300,3,1,1190,9000,1190,0,47.77,-122.264
989000,6,4.5,3830,4800,3050,780,47.6404,-122.361
342000,3,1.75,1780,10409,1280,500,47.4627,-122.168
315000,4,2.5,3130,5999,3130,0,47.3837,-122.099
485000,4,2.75,1830,8384,1320,510,47.733,-122.22
277500,4,2.5,2550,7500,1750,800,47.3165,-122.386
1.295E+06,4,3.5,3790,90169,3790,0,47.6587,-122.022
385000,4,1.75,1800,10890,1800,0,47.5312,-122.04
426000,2,1,1630,7680,830,800,47.7092,-122.291
310000,4,2,1870,6000,1870,0,47.7155,-122.315
449000,4,2,1870,6000,1870,0,47.7155,-122.315
375000,2,1,980,3915,980,0,47.5589,-122.29
1.1875E+06,3,2.25,2860,10625,1920,940,47.6915,-122.273
468000,3,2.25,1470,5597,1470,0,47.5674,-122.019
336000,1,1,1160,5000,1160,0,47.5883,-122.311
392000,4,2.75,1940,6555,1940,0,47.3701,-122.041
412500,4,2.25,1630,7969,1100,530,47.7336,-122.19
545000,4,2.5,2755,11612,2755,0,47.7394,-121.965
133000,5,2,1430,5600,1430,0,47.5192,-122.266
440000,5,2,1430,5600,1430,0,47.5192,-122.266
294450,4,2.25,1400,7341,1300,100,47.7565,-122.305
335000,4,2.5,2520,7205,2520,0,47.343,-122.316
362000,3,1,1290,10125,1290,0,47.7641,-122.265
322000,3,1.75,1400,18002,1400,0,47.725,-121.967
230500,2,1,740,8853,740,0,47.4793,-122.336
380000,4,2,1710,9996,1710,0,47.5472,-122.3
292000,4,2.75,2414,7693,2414,0,47.3046,-122.222
172500,3,1,1040,7500,1040,0,47.4206,-122.316
784000,4,2.75,3540,7091,1970,1570,47.6467,-122.394
525000,4,2.75,2530,11549,1700,830,47.6557,-122.197
600000,3,2.5,2320,7609,2320,0,47.5391,-122.069
435000,3,2.5,2530,16102,2530,0,47.371,-122.055
359900,5,2.75,2790,7600,2790,0,47.4999,-122.165
700000,4,1.75,1950,7139,1150,800,47.5121,-122.248
280000,3,2,1020,889,720,300,47.5434,-122.375
655000,4,2.5,3110,24466,3110,0,47.4898,-122.127
2.48E+06,4,5,5310,16909,3090,2220,47.5515,-122.113
499950,3,2.5,2580,23925,2580,0,47.2978,-122.376
540000,3,2.5,1380,1021,1160,220,47.6148,-122.309
970000,4,2.75,3980,9209,3980,0,47.6286,-122.064
330000,4,2.5,2080,7000,1400,680,47.4252,-122.163
474000,3,1.75,1530,8000,1530,0,47.6971,-122.13
670000,4,1.75,1930,9310,1930,0,47.6158,-122.108
1.3E+06,4,3.25,2330,9687,2330,0,47.6264,-122.283
1.16E+06,4,2.5,3860,10361,2940,920,47.5517,-122.147
440000,4,2.5,2880,8061,2880,0,47.439,-122.152
411000,2,2.5,1590,2088,1590,0,47.6897,-122.175
500000,3,1.5,2150,4000,1470,680,47.5733,-122.312
1.335E+06,4,1.75,2300,13342,2300,0,47.7308,-122.282
696000,6,3.25,2900,6400,2300,600,47.6464,-122.401
465000,3,2.25,1970,11088,1180,790,47.7651,-122.277
518000,4,2.5,1740,7500,1220,520,47.6927,-122.124
251000,3,1.75,1220,7250,1220,0,47.4887,-121.784
255000,3,2,1290,13282,1290,0,47.3787,-122.169
319000,2,1,780,8271,780,0,47.7,-122.3
719000,4,2.75,2210,3400,1470,740,47.6826,-122.311
1.52E+06,5,3.5,5930,13288,3920,2010,47.5542,-122.097
322000,4,2.5,1950,4553,1950,0,47.5066,-122.175
205000,4,1,1340,7920,1340,0,47.2845,-122.267
229000,3,1,1590,6240,1060,530,47.4936,-122.337
395000,3,2.25,1780,9672,1350,430,47.7774,-122.35
183000,2,1,760,7272,760,0,47.3205,-122.33
583500,3,1.75,1720,7800,1170,550,47.6928,-122.125
312000,3,2.5,2070,25710,2070,0,47.2032,-121.964
539000,3,1.75,1790,9860,1410,380,47.6989,-122.12
409000,4,2.75,3230,12651,3230,0,47.3157,-122.251
510250,3,1.75,1400,4000,870,530,47.6913,-122.381
535000,2,2,1370,3827,1020,350,47.652,-122.404
280000,3,2.5,1600,7936,1600,0,47.3673,-122.017
286000,3,1,950,8400,950,0,47.5104,-122.166
710000,3,2.75,2210,7660,1460,750,47.5619,-122.4
395000,2,1,930,6380,930,0,47.6915,-122.321
237500,2,1,810,8494,810,0,47.7389,-122.324
464000,3,2,1630,6550,850,780,47.5452,-122.379
495000,3,1.75,1770,10080,1770,0,47.7218,-122.306
257500,1,1,710,6060,710,0,47.5621,-122.283
570000,4,3.5,3990,23544,2300,1690,47.3245,-122.38
362000,3,2.5,2310,7485,2310,0,47.439,-122.135
640000,33,1.75,1620,6000,1040,580,47.6878,-122.331
172500,3,1,1140,8800,1140,0,47.2629,-122.275
596000,2,1,1040,4880,1040,0,47.6809,-122.311
840000,4,2.5,2170,9796,1650,520,47.5505,-122.152
1.6E+06,3,2.25,3370,23065,1920,1450,47.7434,-122.263
435000,2,1.5,901,1245,901,0,47.6774,-122.325
251000,2,1,840,7870,840,0,47.7389,-122.326
282500,4,1,1650,9750,1650,0,47.4991,-122.164
265000,3,2.25,1380,7226,1140,240,47.3677,-122.091
330000,3,1,910,10240,910,0,47.6729,-122.064
435000,2,1,1230,3800,1230,0,47.6797,-122.292
827235,3,1.75,1740,8560,1500,240,47.6475,-122.409
249950,4,1,1290,5000,1290,0,47.513,-122.358
400000,3,2.5,1950,18533,1950,0,47.5647,-121.903
300499,4,2.5,2150,7944,2150,0,47.259,-122.215
449000,4,2,1560,5220,1560,0,47.6905,-122.305
500000,2,1,1120,3220,1120,0,47.6588,-122.344
865000,3,1.5,1790,7526,1790,0,47.6387,-122.207
899950,4,3.5,3290,5414,2360,930,47.7074,-122.219
370000,4,1,1540,9541,1540,0,47.7104,-122.213
442500,5,3.25,4240,226097,3410,830,47.6472,-122.017
310000,3,1,1010,9945,1010,0,47.5324,-121.763
1.565E+06,4,2.75,2970,12750,2130,840,47.6135,-122.213
245000,4,2.25,2190,9113,2190,0,47.3241,-122.275
254950,2,1,700,8100,700,0,47.7492,-122.311
510000,6,4.5,3300,7480,3300,0,47.6796,-122.104
299950,3,2.25,1370,5000,1370,0,47.7372,-121.981
379950,4,2.5,2680,4500,2680,0,47.3561,-122.056
350000,3,1,1390,4820,910,480,47.704,-122.343
300000,3,2.5,1700,3575,1700,0,47.5418,-122.295
994000,3,2.25,2510,6339,1810,700,47.6496,-122.391
315000,3,1.5,1700,8067,1250,450,47.7384,-122.324
480500,4,2.5,2180,11200,2180,0,47.7476,-122.086
373000,3,1,1770,5720,1140,630,47.5546,-122.377
728000,4,2.5,3290,5951,3290,0,47.5999,-121.976
415000,4,3.5,3040,7125,2240,800,47.492,-122.225
427500,4,2.5,2460,5091,2460,0,47.45,-122.121
339300,3,2,970,10000,970,0,47.6205,-122.063
313000,3,1.75,1320,6205,1320,0,47.7412,-122.343
431500,3,3.5,1900,1612,1430,470,47.544,-122.385
415000,3,1.5,1220,835,1220,0,47.6981,-122.341
490000,3,1.75,1470,9750,1470,0,47.6975,-122.12
1.425E+06,4,5,4630,24054,4630,0,47.587,-121.966
275000,3,1.5,1400,9750,1400,0,47.3768,-122.17
325000,2,1,1070,5080,1070,0,47.5224,-122.35
1.18E+06,5,3.75,3630,6000,2470,1160,47.6816,-122.199
690000,4,1.5,1970,4590,1970,0,47.666,-122.332
410000,4,2,2010,9474,2010,0,47.4234,-122.342
960000,4,2.5,2820,5934,1770,1050,47.5706,-122.403
299250,3,2.5,2530,8669,2530,0,47.3073,-122.395
239000,2,1,710,14000,710,0,47.4379,-122.337
235000,2,1,1210,9400,1210,0,47.5342,-122.36
587000,3,2.25,2370,217800,2370,0,47.6364,-121.984
431000,4,2.5,2300,6087,2300,0,47.5125,-122.192
1.636E+06,3,2.5,3110,6765,2550,560,47.6886,-122.276
285000,3,1.75,1990,6500,1090,900,47.488,-122.221
778000,3,3,2630,10156,2630,0,47.5481,-122.156
415000,3,1,1300,7975,1300,0,47.611,-122.122
550285,2,1.75,1680,4500,1680,0,47.7132,-122.032
910000,3,2.25,2180,9865,1660,520,47.5358,-122.235
860000,3,2.5,2770,9136,2770,0,47.5605,-122.115
765000,3,1.75,2120,5000,1980,140,47.6666,-122.331
782000,4,2.5,2830,20345,1980,850,47.6462,-122.191
525000,3,3.5,1370,1764,1180,190,47.6511,-122.368
745000,3,2.5,2810,435600,2810,0,47.4816,-121.701
470000,3,3.5,3520,35512,2760,760,47.2416,-121.979
345000,3,1.75,1990,5650,1320,670,47.5086,-122.252
279000,3,2.25,2070,7800,1170,900,47.3431,-122.305
500000,3,1.5,1320,8100,1320,0,47.7194,-122.371
237000,3,1,1300,8160,1300,0,47.511,-122.172
200500,3,1.75,1260,9346,1260,0,47.3713,-122.186
387500,4,1.75,2400,9900,1250,1150,47.4631,-122.362
392500,4,2,1950,8040,1950,0,47.7074,-122.29
305000,3,2,1430,12430,1430,0,47.4903,-122.178
981000,4,2.5,2110,10100,2110,0,47.567,-122.151
680000,4,2.5,2980,8770,2980,0,47.5814,-122.029
276000,4,2.5,2068,7242,2068,0,47.3318,-122.281
655500,4,3.5,3380,8330,3380,0,47.7741,-122.379
555000,5,2.75,2810,13144,1440,1370,47.6199,-122.141
235000,2,1,930,10505,930,0,47.4337,-122.329
325000,3,1,1300,8879,920,380,47.7465,-122.326
268950,3,1,1320,8100,880,440,47.4697,-122.351
264500,3,1.5,1580,14040,1050,530,47.2932,-122.267
240000,3,2.5,1620,5250,1620,0,47.3538,-122.301
819000,3,2.5,2750,226512,2750,0,47.4376,-122.456
850000,2,1.5,2210,5000,1530,680,47.6122,-122.288
294950,4,2.25,1740,9600,1160,580,47.432,-122.276
693000,3,2.25,2120,13644,1420,700,47.5574,-122.214
478000,4,2.5,2780,7290,2780,0,47.509,-122.157
222000,2,1,830,6893,830,0,47.7234,-122.328
635000,4,2.5,2070,11286,2070,0,47.5284,-122.173
469000,3,3.25,1390,1278,1140,250,47.6735,-122.375
350000,4,2.5,2610,5866,2610,0,47.3441,-122.04
180000,5,1,1460,11726,1290,170,47.5039,-122.361
490000,4,2.25,3390,39356,1640,1750,47.461,-121.992
360000,3,1.5,1360,6000,860,500,47.6846,-122.345
630000,4,2.5,2807,9430,2807,0,47.7449,-122.223
615000,4,1,1340,2006,1340,0,47.6357,-122.373
279950,3,2.25,1340,7202,1340,0,47.3563,-122.039
317000,3,1,1160,8813,1160,0,47.7257,-122.329
618000,4,2.25,2470,7350,1600,870,47.6936,-122.128
620000,5,1.75,2000,8713,1000,1000,47.5882,-122.117
345000,3,1,1110,6250,1110,0,47.6977,-122.292
608000,3,1.5,2240,3750,1220,1020,47.6624,-122.336
325000,4,2.25,1920,11603,1920,0,47.4315,-122.169
475000,3,1.75,2270,13000,2270,0,47.4474,-122.144
154000,3,3,1530,9997,1020,510,47.2861,-122.252
1.19E+06,5,3,3330,19126,2610,720,47.5485,-122.214
376950,4,2.5,2643,5750,2643,0,47.3519,-122.173
500000,2,2,1250,3360,1250,0,47.6526,-122.349
499950,3,2.5,3230,129578,2100,1130,47.682,-121.913
230000,3,1,880,9035,880,0,47.476,-122.151
652600,4,2.5,2220,5900,2220,0,47.6956,-122.36
185000,3,1.75,1130,7000,1130,0,47.307,-122.372
274950,3,1,1450,8820,1050,400,47.4698,-122.264
447000,2,1,760,6035,760,0,47.5443,-122.382
129000,2,1,1150,30184,1150,0,47.4492,-122.2
436000,5,3,2720,9856,2720,0,47.4778,-122.146
825000,3,1.75,2080,5000,2080,0,47.6717,-122.356
225000,3,1,1080,16000,1080,0,47.2873,-122.251
265000,3,2.5,1890,6088,1890,0,47.2886,-122.218
765000,3,1.5,1500,5111,1500,0,47.6118,-122.284
509000,4,2,1960,2166,1260,700,47.6545,-122.344
762450,4,1.75,2570,8640,2570,0,47.5956,-122.172
465000,5,1.5,1830,9000,1030,800,47.7488,-122.292
564000,3,1.75,1980,6250,1090,890,47.554,-122.385
384500,2,1,1130,5236,1130,0,47.5103,-122.386
415000,3,2,2010,33090,2010,0,47.2133,-122.007
345000,2,1.75,1820,8409,910,910,47.7538,-122.327
465950,4,2.5,2340,6896,2340,0,47.4896,-122.14
325000,3,1.75,1780,11096,1210,570,47.617,-122.051
500000,3,1.75,1780,11096,1210,570,47.617,-122.051
450000,4,2.5,2450,20348,1410,1040,47.5887,-122.064
475000,4,3,2410,8284,1210,1200,47.7202,-122.22
1.3464E+06,5,1.75,3380,20021,1690,1690,47.6395,-122.211
747000,3,1.5,1710,5120,1710,0,47.6801,-122.305
395000,3,1.75,1740,6220,1740,0,47.762,-122.362
505000,3,2.5,1995,1483,1760,235,47.6025,-122.31
215000,3,2,1760,9282,1100,660,47.3413,-122.29
775000,4,3.5,3970,210830,3970,0,47.4614,-121.713
540000,4,2.5,3000,5471,3000,0,47.4797,-122.126
392500,3,1.75,1540,8925,1540,0,47.7762,-122.337
987000,3,2,2160,15788,2160,0,47.6227,-122.207
1.19E+06,3,2,2160,15788,2160,0,47.6227,-122.207
252500,3,2,1810,10684,1810,0,47.4619,-122.153
730000,3,3.5,2440,3502,1970,470,47.589,-122.165
497300,6,2.75,3200,9200,1600,1600,47.492,-122.364
640000,4,2.5,2970,34981,2970,0,47.7365,-122.037
580000,5,2,2290,7125,1190,1100,47.634,-122.119
377000,3,1.75,1820,34800,1820,0,47.4616,-121.98
1.28E+06,4,3.5,3010,3600,2370,640,47.6341,-122.284
396500,3,1.5,1360,1488,1120,240,47.6526,-122.384
300000,4,2.5,2080,2999,2080,0,47.4909,-122.157
532000,3,1,1110,4800,1110,0,47.6857,-122.378
579000,2,1.75,1560,4500,1560,0,47.7128,-122.032
1.4E+06,4,2.5,3520,7815,3140,380,47.6429,-122.412
571000,5,1.75,2280,43560,1380,900,47.4558,-122.362
301950,3,1.75,1370,9288,1370,0,47.4824,-122.152
660000,3,3,2340,2970,2160,180,47.6868,-122.348
455000,4,2.5,3170,10688,3170,0,47.3179,-122.257
375000,3,1.75,1380,5060,1380,0,47.7059,-122.341
470000,4,2.5,2700,6769,2700,0,47.3753,-122.155
374990,3,2.5,1300,10484,1300,0,47.7768,-122.268
541500,2,2.5,1900,3690,1900,0,47.7082,-122.019
782500,3,2.5,3750,7821,3750,0,47.6325,-122.064
264000,3,2.25,1552,3677,1552,0,47.3205,-122.178
640000,4,2.5,2500,7417,2500,0,47.6251,-122.026
660000,3,2,1770,8141,1770,0,47.7232,-122.371
1.365E+06,5,3.5,4210,17258,4210,0,47.553,-122.114
389950,3,2.5,2170,8140,2170,0,47.385,-122.169
226000,2,1,1510,19874,1510,0,47.4924,-122.34
390000,3,1.75,1870,40250,1870,0,47.4038,-122.036
485000,3,2.25,1570,8111,1570,0,47.6324,-122.028
840000,4,2.5,2480,4602,2480,0,47.6835,-122.161
600000,5,3.5,3580,21343,2140,1440,47.7646,-122.302
331000,2,1,1480,6210,1080,400,47.774,-122.351
780000,3,2,2610,6000,1310,1300,47.675,-122.289
300000,3,1.75,1700,8481,1700,0,47.2623,-122.305
361810,3,1.75,1240,7620,1240,0,47.4576,-122.348
467000,3,1,1660,6582,1000,660,47.7169,-122.353
399000,3,1.75,1620,10000,1620,0,47.5091,-122.262
315450,3,1.75,1130,7500,1130,0,47.5254,-122.318
600000,3,1,1310,5000,1310,0,47.6624,-122.347
247500,4,2,1710,5200,910,800,47.3634,-122.09
330000,3,1,2140,5037,2140,0,47.5494,-122.274
500000,4,2.25,2350,7210,2350,0,47.7407,-122.183
367500,3,1,1570,10050,1570,0,47.736,-122.231
560000,3,2.5,2780,32880,2780,0,47.4798,-121.727
655000,4,1.75,2540,7620,1320,1220,47.5709,-122.406
530000,5,2.75,2500,7140,1250,1250,47.6225,-122.108
270000,3,2.25,2080,26574,1380,700,47.2846,-122.192
437500,3,2,1760,2875,1290,470,47.5602,-122.378
575000,3,1.75,1760,10349,1760,0,47.6347,-122.173
278000,4,2.5,1940,6887,1940,0,47.2911,-122.353
568500,4,2.5,3010,6181,3010,0,47.5212,-122.192
280000,4,3,2460,9606,2460,0,47.4889,-122.317
250000,2,1,750,6350,750,0,47.6938,-122.356
247500,3,0.75,1300,72309,680,620,47.567,-122.124
1.25E+06,5,2.75,3710,13874,2340,1370,47.5686,-122.154
535000,4,2.5,2360,15008,1920,440,47.7363,-122.254
814842,3,2.5,3190,6899,3190,0,47.7153,-122.221
340000,4,2.5,2181,5521,2181,0,47.3503,-122.291
359950,3,1.75,1890,9100,1890,0,47.7676,-122.339
750000,3,1.75,2610,5544,1680,930,47.684,-122.376
1.22E+06,4,2,3090,8125,3090,0,47.6851,-122.395
370000,2,1,860,5040,860,0,47.6977,-122.365
329950,3,1,1000,9170,1000,0,47.4405,-122.134
500000,3,2.5,2760,35171,2760,0,47.465,-122.123
734000,4,2.5,3490,18521,3490,0,47.7406,-122.07
385000,4,2.5,2960,5054,2960,0,47.3601,-122.035
230000,2,1,1280,4635,840,440,47.5532,-122.28
1.385E+06,4,3.5,3230,7200,1640,1590,47.6838,-122.212
210000,3,2,1830,4992,1230,600,47.5145,-122.27
293000,3,1.75,1420,13187,1420,0,47.4608,-122.065
465000,3,1,1580,3774,1580,0,47.6839,-122.361
449000,3,2.25,1960,44634,1130,830,47.7769,-122.253
325000,2,1.75,1670,10725,1670,0,47.4893,-122.229
180000,3,2,1670,7056,1670,0,47.3139,-122.212
650000,6,3,2960,5000,1790,1170,47.6971,-122.341
665000,4,2.75,2420,7102,1670,750,47.7042,-122.371
324450,3,2,1420,16000,1420,0,47.478,-122.358
588000,4,1.75,2170,5750,1370,800,47.5668,-122.383
200000,4,1,1310,5200,1160,150,47.5384,-122.37
383000,4,1.75,1830,11090,1060,770,47.7333,-122.246
499950,3,2,1360,2500,730,630,47.6753,-122.363
549000,5,2.5,3440,12350,1760,1680,47.3427,-122.325
465000,5,3,2010,7264,1290,720,47.6945,-122.33
450000,3,2.5,2450,19744,2450,0,47.3746,-122.026
799900,4,2.5,3030,7800,1580,1450,47.689,-122.196
495000,4,2.5,2480,91911,1470,1010,47.4579,-121.981
1.2E+06,3,3.5,4310,10842,3140,1170,47.7735,-122.386
637000,4,2.5,2120,15000,2120,0,47.7159,-122.1
589000,4,1,2210,4366,2210,0,47.6105,-122.309
305000,3,1.75,1400,10350,1400,0,47.479,-122.132
600000,4,2.25,2760,5200,1790,970,47.589,-122.313
587000,4,2.5,2550,6256,2550,0,47.7742,-122.166
1.425E+06,2,2.5,2220,4000,2220,0,47.6364,-122.28
250000,4,1,1320,11212,1320,0,47.3098,-122.209
515000,3,3,2440,3202,1640,800,47.7152,-122.342
833000,4,2.75,3780,10308,3780,0,47.589,-121.983
860000,3,3.25,4720,32467,3190,1530,47.508,-122.113
550000,4,3,2360,6678,1760,600,47.6919,-122.313
180000,2,1,890,6000,890,0,47.4976,-122.225
507000,4,1.75,1770,9375,1170,600,47.6935,-122.112
427000,3,2,1720,128066,1720,0,47.4487,-121.981
616950,3,3.5,2490,2722,2020,470,47.5893,-122.165
372000,4,1.75,1890,10550,1010,880,47.5147,-122.193
290000,2,1,1020,6380,1020,0,47.6971,-122.317
329990,4,2.75,2420,8438,2420,0,47.2089,-122.011
393500,3,1.75,1600,8156,1600,0,47.7397,-122.3
1.55E+06,5,3.25,3370,17458,2000,1370,47.5591,-122.229
240000,4,2.25,1720,8300,1720,0,47.3192,-122.385
285000,3,1,1090,8640,1090,0,47.459,-122.355
382500,3,1.5,1090,9862,1090,0,47.6256,-122.036
1.925E+06,4,3.75,3600,16101,3600,0,47.6308,-122.287
800000,3,2.5,2760,9471,1760,1000,47.676,-122.272
550000,4,3.5,2770,24140,2770,0,47.6585,-122.186
387846,4,1.75,2520,15205,2040,480,47.7642,-122.264
367500,4,2,1960,16015,1960,0,47.33,-122.22
780500,5,1,1760,4264,1760,0,47.6246,-122.312
680000,3,1.75,1090,6775,850,240,47.6934,-122.321
434400,5,1.75,1960,7875,1960,0,47.7256,-122.18
370000,2,1,1220,17172,1220,0,47.6934,-122.163
465000,3,1.75,1730,8073,1350,380,47.7694,-122.367
323000,3,2,1830,6925,1830,0,47.4445,-122.123
270000,4,2.5,1600,9921,1600,0,47.3678,-122.124
1.32E+06,3,1.75,2040,42693,2040,0,47.6479,-122.12
560000,4,2.5,2710,6583,2710,0,47.4922,-122.141
450000,3,1,1140,4500,840,300,47.5897,-122.314
290000,2,1,930,7740,930,0,47.7091,-122.292
354000,3,2,1010,21340,1010,0,47.6223,-122.043
705000,5,3,2380,5000,2380,0,47.6722,-122.389
445000,3,2.25,1860,7200,1240,620,47.7332,-122.192
229900,3,1,1440,11925,1440,0,47.2738,-122.3
610000,4,2.5,2980,5896,2980,0,47.6872,-122.036
535000,3,3.25,2670,5108,2670,0,47.5342,-121.866
437400,3,1.75,2150,8925,2150,0,47.6253,-122.119
540000,5,2.75,3160,10059,1740,1420,47.7477,-122.217
570000,3,2,1890,29185,1470,420,47.5621,-122.168
533000,3,2.5,2810,4607,2810,0,47.7735,-122.227
555000,3,2.5,2690,4819,2690,0,47.5302,-121.849
239950,3,1.75,1230,9600,1230,0,47.3675,-122.095
350000,3,1,950,9451,950,0,47.7308,-122.19
245000,2,1,1200,4880,980,220,47.5276,-122.346
456000,4,1.75,1670,9886,1670,0,47.7249,-122.287
465000,4,2.25,2140,7701,1470,670,47.7213,-122.171
445000,2,1.75,1440,4660,1440,0,47.7092,-122.015
517850,5,2.75,3050,7500,1800,1250,47.7249,-122.187
329000,5,2.75,2570,7260,2570,0,47.2622,-122.212
512500,3,2.5,1840,2875,1840,0,47.562,-122.393
365000,2,1,1250,8100,1250,0,47.7294,-122.329
450500,3,1,1410,9384,1410,0,47.7161,-122.33
915000,3,1,1560,8232,1560,0,47.623,-122.205
205000,3,1,960,7314,960,0,47.2891,-122.221
314000,4,2.5,1870,8449,1870,0,47.4435,-122.274
496000,2,1,900,9260,900,0,47.6695,-122.36
329950,4,1,2050,7590,1280,770,47.4916,-122.224
375000,4,2,2400,6000,2400,0,47.7607,-122.209
623000,3,2.5,1850,7777,1850,0,47.6908,-122.169
310000,4,1.5,1220,9600,1220,0,47.6462,-121.909
532500,3,3.25,3140,37120,1760,1380,47.5244,-121.842
960000,4,2.25,2410,4560,1800,610,47.6796,-122.402
598000,4,2.5,3130,40918,3130,0,47.4761,-121.723
683000,3,2.5,2300,9218,2300,0,47.5504,-122.077
425000,5,2.5,2840,9425,1590,1250,47.7609,-122.297
533000,5,2.75,1800,3780,1400,400,47.6831,-122.343
375000,3,1,1190,9486,1190,0,47.4319,-122.339
250500,3,2,1710,7225,1710,0,47.2917,-122.373
257000,4,1.75,1900,22896,1360,540,47.3102,-122.023
218000,3,1,880,18205,880,0,47.5013,-122.244
460000,3,2,2060,4437,1030,1030,47.5705,-122.376
255544,3,1,1360,6186,760,600,47.7503,-122.334
560000,2,2,1680,4647,1680,0,47.7088,-122.015
480000,4,2.5,2980,4074,2980,0,47.734,-121.965
1.3E+06,5,1.75,2130,19180,1500,630,47.638,-122.213
580000,3,2.75,2650,9752,2650,0,47.768,-122.259
475000,3,2.5,1700,9100,1160,540,47.5369,-122.378
1.3095E+06,4,2.5,2680,12215,1590,1090,47.4396,-122.353
700000,3,2.5,2530,623779,2530,0,47.4188,-121.949
590000,3,2.5,2520,10223,2520,0,47.631,-122.042
264500,3,2.5,1630,8346,1630,0,47.2622,-122.219
465000,2,1,730,2600,730,0,47.6751,-122.379
290000,3,1,910,7620,910,0,47.5278,-122.343
1.815E+06,4,4.5,4510,12873,4510,0,47.6491,-122.201
416000,3,1,1110,12150,1110,0,47.6034,-122.122
360000,4,2,1450,8940,1450,0,47.7304,-122.24
585083,5,2.75,2910,36250,1590,1320,47.5916,-122.076
840000,4,2.75,2600,2750,1620,980,47.6413,-122.357
81000,2,1,730,9975,730,0,47.4808,-122.315
1.285E+06,3,2.25,2440,9200,2440,0,47.6629,-122.269
326000,4,1.75,2290,7380,1390,900,47.5034,-122.245
447000,2,1,720,7500,720,0,47.5185,-122.392
185000,3,1,940,7125,940,0,47.3756,-122.297
439950,3,2.5,1540,7773,1540,0,47.722,-122.194
234000,3,1.5,1140,10300,1140,0,47.4452,-121.77
485000,4,2.5,2100,8886,2100,0,47.5947,-122.134
750000,4,1.75,2670,6250,2020,650,47.6499,-122.391
865000,4,2,2750,5527,2130,620,47.6513,-122.368
287500,4,2.5,2570,9000,1590,980,47.2986,-122.372
375000,3,1.75,1660,9673,1130,530,47.7628,-122.162
565000,3,2.25,1700,8800,850,850,47.6863,-122.189
260000,4,3,1530,8306,1530,0,47.3528,-122.146
190000,3,1,1260,10900,1260,0,47.491,-122.188
399950,5,2,2760,6420,1380,1380,47.5396,-122.276
275000,3,2.5,1830,7062,1830,0,47.2895,-122.352
528000,3,2.75,2160,4086,1380,780,47.5352,-122.38
315000,3,2,1770,9685,1770,0,47.4753,-122.342
614306,2,2.25,2210,5500,1410,800,47.697,-122.39
1.49E+06,3,3.5,4560,14608,4560,0,47.6995,-122.228
590000,3,2.5,2110,3870,2110,0,47.5513,-121.994
261500,3,1,1130,3600,1130,0,47.5978,-122.299
300000,4,2.5,1960,9898,1960,0,47.3834,-122.168
439000,3,2.25,2230,4551,1450,780,47.5078,-122.236
277554,5,2.25,2350,13000,2350,0,47.4939,-122.256
215000,3,2,1340,8505,1340,0,47.4727,-122.297
1.2E+06,2,2.25,2160,17861,2160,0,47.502,-122.385
420000,4,2,1700,6375,850,850,47.6973,-122.295
485000,3,2.5,1650,3436,1650,0,47.6819,-122.036
202500,3,2,1540,8316,1540,0,47.323,-122.216
710000,5,3.25,3920,8572,3920,0,47.5427,-121.887
535000,4,2.5,3250,6933,3250,0,47.4956,-122.151
260000,4,1.75,1360,7700,1360,0,47.4558,-122.177
254000,3,2,1480,7480,1480,0,47.3542,-122.055
600000,4,2.5,2360,5226,2360,0,47.712,-122.229
285000,3,2.5,1800,2516,1800,0,47.5401,-122.293
800000,4,3.75,2540,20662,2540,0,47.5882,-122.01
165000,3,1,1200,13100,1200,0,47.475,-122.258
216500,2,1,710,6960,710,0,47.4886,-122.246
387990,4,2.5,2640,5595,2640,0,47.3551,-122.054
500000,4,2.5,3010,5040,3010,0,47.709,-122.35
650000,4,2.5,2770,5612,2770,0,47.686,-122.036
646000,4,2.5,2310,4079,2310,0,47.6937,-122.361
323400,4,3,2060,9138,1430,630,47.321,-122.185
300000,3,2.5,1880,4200,1880,0,47.366,-122.017
712500,5,2,2280,5400,1340,940,47.6674,-122.279
550000,3,1.75,1380,3402,1380,0,47.6109,-122.302
400000,3,1,1180,7537,1180,0,47.7233,-122.221
255000,4,1.75,1650,7200,1100,550,47.3944,-122.187
660000,3,1.75,2030,9032,2030,0,47.586,-122.117
925000,4,2.25,2110,6375,1600,510,47.6819,-122.272
534000,4,2.25,2130,7210,1330,800,47.629,-122.117
215000,3,1,1690,7700,1690,0,47.3444,-122.304
1.95E+06,3,2.5,2510,12779,2510,0,47.6982,-122.231
1.4E+06,5,4.25,3530,7924,3530,0,47.5894,-122.243
212000,3,1.75,1470,8350,1470,0,47.2587,-122.253
265000,3,1.75,1840,7300,1840,0,47.3122,-122.369
400000,3,1.75,1860,5750,1300,560,47.5586,-122.383
311500,4,2.5,1940,10133,1940,0,47.3877,-122.171
2.328E+06,4,3.5,4420,20759,4420,0,47.6354,-122.221
225000,2,1,800,6050,800,0,47.5001,-122.242
1.25E+06,4,2.5,3700,21755,2620,1080,47.5662,-122.108
380000,3,1,1400,8710,1400,0,47.5066,-122.377
600000,4,2.5,2250,11370,2250,0,47.7115,-122.239
600000,3,2.25,2230,9053,2230,0,47.6594,-122.144
315000,3,2.5,1950,3000,1950,0,47.4938,-122.337
847000,5,1,2550,4623,2550,0,47.6092,-122.294
730000,4,2.5,2750,10351,2750,0,47.5894,-121.98
1.058E+06,4,2,2290,11137,2290,0,47.5887,-122.201
1.62E+06,4,2.25,2350,17709,2350,0,47.6232,-122.236
664000,2,1.75,1720,5785,860,860,47.5554,-122.274
454450,4,3,2810,6000,2810,0,47.3689,-122.057
341000,3,1,940,4200,940,0,47.6878,-122.35
276693,4,1,1190,8875,1190,0,47.7487,-122.303
185000,2,1,1390,11340,1390,0,47.4969,-122.3
160000,2,2.5,1660,2258,1660,0,47.3793,-122.146
270000,4,2.5,1920,8497,1920,0,47.2608,-122.209
300000,4,1.5,1460,8760,1460,0,47.4698,-122.36
264950,3,1.5,1370,10115,1370,0,47.2027,-122
209950,2,1,1050,6250,840,210,47.5024,-122.333
850000,3,2.5,3360,8708,3360,0,47.7037,-122.016
645000,4,2.5,3160,11380,3160,0,47.6318,-122.039
855000,4,2.25,2480,36974,2480,0,47.6441,-122.154
632500,4,1.5,2720,37258,2720,0,47.7402,-122.035
289950,3,2.5,2070,5013,2070,0,47.3202,-122.395
850000,2,1.75,2170,25732,2170,0,47.7542,-122.372
565000,4,2.75,3260,4900,3260,0,47.4812,-122.123
792000,3,2.5,2250,19270,2250,0,47.6569,-122.088
260000,3,2.25,1950,9600,1200,750,47.2762,-122.148
585000,3,2,2220,209523,2220,0,47.7586,-121.911
295500,3,1.75,1330,10523,1000,330,47.4605,-122.206
329000,4,2,1190,7877,1190,0,47.7538,-122.322
750000,3,1.75,2770,15232,1570,1200,47.5706,-122.16
495000,4,2.5,2310,7555,2310,0,47.7544,-122.303
672500,3,1.75,1580,5750,1330,250,47.6339,-122.392
1.307E+06,5,3.25,2800,3200,1910,890,47.6421,-122.35
405000,3,2.5,1500,9636,1500,0,47.75,-122.176
620000,3,1.75,2140,5808,1070,1070,47.6435,-122.373
615000,4,2.25,2330,7020,1450,880,47.562,-122.139
887000,6,2.25,3830,11180,2440,1390,47.5849,-122.113
1.057E+06,4,2.75,4510,5000,3270,1240,47.6852,-122.4
753000,4,1.75,2160,39430,1660,500,47.6378,-122.185
1.6E+06,3,2.25,3170,5000,2230,940,47.6349,-122.318
3.71E+06,4,3.5,5550,28078,3350,2200,47.6395,-122.234
365000,3,1.5,1520,8519,1520,0,47.7712,-122.339
870000,4,2.75,3410,23000,3410,0,47.5559,-122.149
321000,4,2.5,1830,9601,1830,0,47.3541,-122.015
280000,3,2.5,1550,4486,1550,0,47.3299,-122.269
288000,3,2.5,1520,3593,1520,0,47.3842,-122.042
248500,3,2,1240,12285,620,620,47.3219,-122.341
330000,4,2.5,2380,13550,2380,0,47.4486,-122.288
740000,5,3.5,2720,11454,1830,890,47.6466,-122.119
445000,3,2.5,2210,8010,2210,0,47.4845,-121.775
198500,2,1,1050,9600,1050,0,47.3274,-122.346
280000,7,2.5,1940,5458,1940,0,47.3191,-122.177
336500,3,2.25,1420,3433,1420,0,47.7245,-122.163
267000,3,2.5,1690,10336,1690,0,47.311,-122.003
315000,3,1,1160,9180,1160,0,47.7427,-122.072
545000,4,2.5,2040,7412,2040,0,47.6347,-122.026
274950,3,1.75,1840,16679,1840,0,47.3207,-122.275
500000,2,1,1440,7130,1210,230,47.6778,-122.267
299000,3,1,1390,9624,1390,0,47.7758,-122.301
420000,3,2.5,1470,1445,1160,310,47.5468,-121.998
620000,3,2.5,1776,1248,1604,172,47.6539,-122.352
575950,3,2.25,1640,12000,1180,460,47.6252,-122.104
666500,4,2.5,2860,6600,2860,0,47.6067,-122.017
180000,4,1.5,1740,7292,1020,720,47.4787,-122.302
261350,3,1.75,1390,18200,1390,0,47.3208,-122.337
1.03E+06,4,3.5,2730,5607,1660,1070,47.6387,-122.396
390000,3,1.75,1435,8960,1435,0,47.4525,-122.149
253500,3,1,1640,12384,1090,550,47.3256,-122.298
625000,4,2.5,2630,48706,2630,0,47.775,-122.125
255000,4,2.5,1580,7800,1580,0,47.481,-122.163
257000,3,2.5,1740,3721,1740,0,47.3363,-122.213
869000,2,1.75,1900,13122,1100,800,47.5121,-122.248
745000,4,2.5,3130,10860,3130,0,47.56,-122.04
1.35E+06,4,3.5,3500,9525,3500,0,47.5641,-122.221
350000,3,1.75,2130,7500,1090,1040,47.4593,-122.343
475000,3,2.5,950,1110,950,0,47.6226,-122.319
540000,3,2.5,1720,11656,1720,0,47.6791,-122.113
175000,2,1,830,2699,830,0,47.3839,-122.038
100000,2,0.75,660,5240,660,0,47.3881,-122.234
890000,5,1,2590,4652,2310,280,47.6038,-122.294
280000,3,2.5,1600,4271,1600,0,47.3303,-122.269
1.05E+06,4,4.25,4390,13833,3320,1070,47.5566,-122.026
486000,4,2.5,3560,12047,3560,0,47.3019,-122.341
670000,5,2.5,2860,68519,2860,0,47.5265,-121.835
480000,3,2.5,1640,7847,1640,0,47.5684,-122.018
440000,3,1.75,1500,6180,1060,440,47.5689,-122.284
1.5E+06,3,3.25,3990,8505,2870,1120,47.5744,-122.283
743700,4,2.5,2610,33206,2610,0,47.6662,-122.057
449950,3,1.75,1470,7590,1470,0,47.6964,-122.362
367000,2,1,700,2334,700,0,47.701,-122.39
1.185E+06,4,3.25,3960,12895,3960,0,47.5211,-122.151
201000,3,1,900,7576,900,0,47.2881,-122.22
575000,3,1.75,2010,3800,2010,0,47.6408,-122.307
295000,3,2.5,1940,10350,1420,520,47.3385,-122.256
190000,3,1,1510,8760,1510,0,47.3015,-122.216
742500,2,3,2020,5000,1350,670,47.6758,-122.375
875000,6,3.5,4430,11453,3000,1430,47.5156,-122.204
1.387E+06,4,3.5,4010,10880,3150,860,47.5359,-122.213
600000,4,2.25,3070,8400,3070,0,47.7316,-122.169
207000,3,1.5,1460,11100,1460,0,47.3253,-122.298
650000,4,2.75,3260,5335,3260,0,47.5414,-121.864
275000,2,1,830,5610,830,0,47.5674,-122.367
1.2E+06,4,2.5,2390,4200,2150,240,47.6272,-122.318
262500,3,2,1130,7200,1130,0,47.4779,-122.342
399000,2,1,1120,8661,1120,0,47.7034,-122.307
139000,4,1.5,1410,10648,1410,0,47.3736,-122.188
575000,3,2.5,1750,4797,1750,0,47.6954,-122.199
580000,2,1,1040,3200,1040,0,47.6558,-122.334
468000,3,2.25,1630,2490,1630,0,47.6807,-122.031
230000,3,1,1380,10112,940,440,47.3196,-122.351
675000,4,4,3680,18804,3680,0,47.6193,-122.014
318000,3,1,1250,20040,1250,0,47.7514,-122.108
332100,5,3.5,2660,6978,1980,680,47.2631,-122.212
175000,2,1,620,6600,620,0,47.4862,-122.33
817000,4,2.25,2600,10660,2600,0,47.5533,-122.156
1.2E+06,4,3,2150,8119,2150,0,47.6335,-122.236
525000,3,1.75,1470,6550,1070,400,47.5463,-122.381
189000,3,1,1380,7282,1380,0,47.3006,-122.223
629950,3,2.5,1680,1683,1120,560,47.6425,-122.374
641500,1,1,1000,9084,1000,0,47.5007,-122.382
490000,3,2.25,1630,7573,1230,400,47.7273,-122.211
415000,3,1.75,1790,15142,1360,430,47.7362,-122.172
250000,2,1,890,6380,890,0,47.691,-122.303
781000,3,1.5,1290,8175,820,470,47.6296,-122.205
400000,4,2.25,2420,7927,1400,1020,47.7583,-122.343
935000,4,3,3680,7105,2890,790,47.6956,-122.311
575000,4,2.5,3020,17810,1600,1420,47.7735,-122.281
1.66E+06,4,3.25,4240,11189,4240,0,47.6526,-122.191
302300,5,2.75,3130,9450,1580,1550,47.3099,-122.384
355000,2,1,900,6656,900,0,47.5467,-122.377
1.538E+06,3,2.25,2880,7599,1710,1170,47.6938,-122.215
926250,4,1.75,2390,17717,2390,0,47.5755,-122.218
300000,3,1.75,1450,7620,1050,400,47.4569,-122.354
361500,3,1.75,1070,9000,1070,0,47.6984,-122.132
616000,3,1.5,1740,9840,1740,0,47.5748,-122.237
395000,2,1.75,1210,1161,1210,0,47.5513,-121.998
245000,3,1.5,2100,10000,2100,0,47.4222,-122.331
206000,3,1,1060,9600,1060,0,47.2878,-122.358
706000,4,2.5,3280,16575,2190,1090,47.426,-122.285
578000,3,1.5,1660,6000,1660,0,47.6409,-122.401
341950,5,3,3070,5252,3070,0,47.3666,-122.128
305000,3,1,1150,9048,1150,0,47.6755,-122.177
575000,3,2.75,1710,3600,1590,120,47.642,-122.36
330000,3,1,1180,43124,1180,0,47.5278,-122.063
445000,4,2.25,2130,7200,2130,0,47.7152,-122.168
333000,3,1,1050,7560,1050,0,47.525,-122.371
598500,4,2.5,2520,3980,2520,0,47.5401,-122.07
225000,2,1,700,6000,700,0,47.4671,-122.212
570000,4,2.5,2640,4200,2640,0,47.6038,-122.02
630000,5,2,2330,6783,1310,1020,47.6955,-122.295
779000,5,2.25,2830,7738,2830,0,47.5582,-122.136
760000,4,3.5,3720,13591,3720,0,47.536,-121.858
322968,5,1.75,1890,9600,1890,0,47.7391,-122.241
595000,4,2.5,2910,7287,2910,0,47.5354,-121.869
321000,4,1,1300,18836,1300,0,47.5029,-122.188
653000,3,2.25,2770,57745,2770,0,47.775,-122.124
750000,4,1.75,2520,21834,1420,1100,47.4996,-122.378
530000,3,1,1340,4284,1080,260,47.6633,-122.324
352750,2,1.75,1060,1241,960,100,47.5999,-122.3
424950,4,2.5,2480,8563,2480,0,47.381,-122.033
427000,5,2.75,2220,4000,1230,990,47.5754,-122.305
558000,4,2.5,3220,5120,2420,800,47.5434,-122.27
438200,2,2,1600,5643,1600,0,47.6968,-122.279
340000,1,1,640,4800,640,0,47.5551,-122.382
830005,4,3.75,3610,7904,3290,320,47.6992,-122.385
548000,4,3.25,3420,5012,2330,1090,47.732,-121.982
411715,3,1.75,1840,5101,1040,800,47.5585,-122.317
865000,4,4,2790,16117,2790,0,47.6033,-122.155
1.75E+06,6,4.25,5860,13928,4150,1710,47.5382,-122.114
688000,3,3,3450,16200,3450,0,47.6319,-122.041
399950,4,2.5,2350,5100,2350,0,47.3507,-122.007
555000,3,1,1250,4590,970,280,47.6757,-122.327
677000,3,2,2000,3207,1100,900,47.6561,-122.341
539000,3,2,2260,9568,1780,480,47.6457,-122.058
410000,3,1.75,1510,6597,950,560,47.5938,-122.315
472000,2,2.25,1800,2748,1800,0,47.6104,-122.113
755000,3,2.5,2420,8856,1620,800,47.5405,-122.263
269900,5,1.75,1750,8325,1750,0,47.4007,-122.198
667400,4,2.5,2660,40312,2660,0,47.7532,-122.139
1.22E+06,3,2.25,2640,7544,2640,0,47.6224,-122.195
544000,3,2.5,1460,1613,1180,280,47.6781,-122.375
800000,2,1,1570,5000,1570,0,47.5955,-122.294
315000,3,1,1010,7500,1010,0,47.6172,-122.061
227000,4,1,1200,7200,1200,0,47.4951,-122.248
765000,4,2.5,4040,25752,4040,0,47.4579,-122.068
625000,3,3,1820,1641,1540,280,47.6482,-122.358
1.875E+06,4,5,5810,7440,3790,2020,47.6878,-122.212
822600,4,2.5,3010,9600,1510,1500,47.5519,-122.156
515000,4,2.5,1910,8947,1160,750,47.7374,-122.183
377000,4,2,1640,5014,930,710,47.5545,-122.356
600000,3,1,1480,17360,1480,0,47.5179,-122.387
525300,4,1.75,2520,7770,1680,840,47.7721,-122.372
760000,4,3,2840,13554,1990,850,47.7153,-122.257
202000,2,1,840,7200,840,0,47.3769,-122.237
470000,3,2,1730,38884,1730,0,47.4164,-121.951
810000,3,2.5,3140,10983,3140,0,47.5595,-122.04
175000,3,1,1480,8415,1080,400,47.4585,-122.283
440000,4,1.75,1920,7986,960,960,47.7209,-122.318
197000,2,1,770,8636,770,0,47.5075,-122.358
254000,3,1,1010,7384,1010,0,47.4905,-122.191
405000,3,1,1460,10000,1460,0,47.6214,-122.063
416000,2,1,940,4264,940,0,47.5314,-122.378
779950,4,2.75,2840,4864,2840,0,47.7103,-122.108
200000,4,2.75,1910,7210,1430,480,47.3693,-122.169
658100,4,2.5,2430,8509,2430,0,47.5714,-121.991
397000,2,1.75,1610,4104,950,660,47.5565,-122.275
815000,3,3.75,2780,5002,2780,0,47.5939,-122.15
345000,2,1,1160,8504,1160,0,47.7364,-122.295
305500,4,2.5,1850,7199,1850,0,47.4031,-122.172
340000,3,2.25,2120,13090,2120,0,47.296,-122.219
330000,5,2.5,2620,12763,1400,1220,47.72,-122.213
269000,4,2.5,2060,3608,2060,0,47.362,-122.309
349950,3,1,1060,9525,1060,0,47.6855,-122.111
431000,3,1,1500,6240,1500,0,47.7281,-122.311
735000,4,1.75,2380,5700,1820,560,47.6656,-122.271
414000,5,3,3045,5030,3045,0,47.4386,-122.127
619500,3,2.5,1700,4105,1700,0,47.6078,-122.292
675000,3,1.75,1240,13869,1240,0,47.6919,-122.21
380500,3,1,1410,7854,1410,0,47.7303,-122.192
253000,3,1.5,880,6600,880,0,47.5002,-122.247
157500,2,1,740,9003,740,0,47.4217,-122.197
627000,4,2,2030,9300,2030,0,47.6658,-122.149
469500,4,2.5,2090,7241,1140,950,47.726,-122.221
319950,2,1,920,8341,920,0,47.5015,-122.38
249500,3,1,1180,7200,1180,0,47.4249,-122.178
485000,3,1,1260,3230,1260,0,47.644,-122.369
1.125E+06,5,3,3690,10260,2070,1620,47.5919,-122.176
314500,3,1.75,1700,17355,1200,500,47.3637,-122.057
220000,2,1,770,8149,770,0,47.7467,-122.3
444950,3,2.5,2020,7800,1330,690,47.7368,-122.337
598000,4,2.5,2030,9825,1330,700,47.6892,-122.3
699850,4,3.5,2690,6164,2690,0,47.599,-121.973
595000,3,2.5,1750,3354,1750,0,47.6953,-122.199
735000,4,2.5,3270,45537,3270,0,47.6303,-121.984
542500,4,2.5,2330,14289,2330,0,47.5916,-122.148
450000,3,1.75,1720,6960,1140,580,47.6972,-122.129
298500,3,2,2420,8800,1420,1000,47.4322,-122.291
403950,2,1,710,1136,710,0,47.6414,-122.329
271000,2,1,710,4240,710,0,47.5226,-122.351
335000,2,1,1510,3844,1510,0,47.7038,-122.348
305000,2,2.25,1610,1968,1610,0,47.5184,-122.196
630000,3,3,1880,2200,1520,360,47.6666,-122.367
253000,2,1.75,1220,5000,860,360,47.4906,-122.204
395000,4,1.75,2060,7900,1070,990,47.6028,-122.12
265000,3,2.5,1340,10290,1140,200,47.3553,-122.149
225000,2,1,1030,9192,1030,0,47.4565,-122.181
338500,4,2.5,2717,4513,2717,0,47.3373,-122.266
300000,2,1.75,1360,8100,860,500,47.7295,-122.359
255000,2,1,1260,7810,1260,0,47.5003,-122.248
337000,4,3,2240,8504,2240,0,47.7348,-122.295
324900,3,2.25,2080,9740,2080,0,47.261,-122.219
821000,3,2.75,2760,8476,1690,1070,47.5402,-122.215
500000,4,2.75,3000,213008,3000,0,47.4032,-121.982
885000,4,3.5,3310,6000,2200,1110,47.5511,-122.391
360000,4,2,1630,10375,1630,0,47.7566,-122.073
304000,3,1,900,7500,900,0,47.7314,-122.237
376000,2,1,880,2400,760,120,47.5643,-122.275
425000,4,1.5,1620,7875,1620,0,47.6041,-122.126
1.1805E+06,3,1.75,1610,7200,1090,520,47.6279,-122.287
187000,3,2.5,1730,1803,1730,0,47.4648,-122.335
710000,2,1.5,1640,4080,1540,100,47.6624,-122.325
585000,3,1.75,1840,7350,1370,470,47.6729,-122.166
1.4E+06,5,4,4700,22326,4700,0,47.5417,-122.111
1.98E+06,4,3.5,4500,44384,3340,1160,47.6323,-122.192
250000,3,1.75,1780,35233,1420,360,47.2949,-122.269
950000,4,2.75,3800,12200,3800,0,47.5689,-122.156
725000,3,2.5,2980,16996,2980,0,47.595,-122.016
505000,4,2.5,2780,6369,1590,1190,47.7284,-122.216
90000,1,1,560,4120,560,0,47.5335,-122.348
400000,4,2,2060,3060,2060,0,47.5631,-122.285
407000,3,1,1140,7785,1140,0,47.709,-122.363
651000,3,1.5,1890,4400,1890,0,47.6662,-122.326
485000,3,2.25,2090,7450,1350,740,47.7598,-122.303
460000,4,2.75,3460,13168,3460,0,47.2046,-121.996
369000,2,1,1320,6135,880,440,47.5265,-122.379
355000,2,1,1240,27042,1000,240,47.5026,-122.465
155000,2,1,810,4755,810,0,47.5313,-122.28
1E+06,3,1,1880,5450,1880,0,47.6453,-122.302
419625,4,2.5,2680,11590,2680,0,47.4395,-122.163
435000,3,2,2040,6880,2040,0,47.7601,-122.351
379000,4,1.75,2180,7876,1290,890,47.5157,-122.191
293000,4,2.25,1870,5371,1870,0,47.3844,-122.036
592100,4,2.75,2310,7851,1790,520,47.5473,-122.187
362000,3,1.75,1120,9730,1120,0,47.7372,-122.221
227000,3,1,1340,10035,1340,0,47.4916,-122.254
335500,3,1.75,1260,8487,1260,0,47.7664,-122.201
213000,3,1.75,1200,55321,1200,0,47.3492,-121.935
338000,5,2.5,2400,4496,2400,0,47.3692,-122.126
163500,3,1,940,7200,940,0,47.2979,-122.223
199988,2,1,860,5000,860,0,47.5005,-122.267
1.185E+06,3,2.25,2390,7875,1980,410,47.6515,-122.278
320000,4,2.5,3130,5200,3130,0,47.3828,-122.098
450000,6,2.25,3550,11780,2960,590,47.7218,-122.312
249900,2,2,1470,2541,1470,0,47.3502,-122.02
223000,2,1,910,9869,910,0,47.4572,-122.184
631000,4,4,2630,59586,1470,1160,47.4496,-122.209
350000,4,2.25,1780,10416,1060,720,47.4414,-122.189
279000,3,1.75,1430,39160,900,530,47.5513,-121.801
310000,5,2,2730,7344,1510,1220,47.4602,-122.171
185000,2,1,900,8000,900,0,47.4217,-122.317
445000,3,2.5,1740,22089,1130,610,47.3948,-122.435
365000,4,2.5,2905,4874,2905,0,47.4084,-122.169
333500,3,1.5,2230,9120,1390,840,47.5008,-122.358
385000,3,2.25,1680,8450,1340,340,47.7575,-122.361
345000,3,1.5,1240,11200,1240,0,47.5716,-122.138
1.26E+06,3,3,3230,8625,2220,1010,47.562,-122.404
440000,4,2.5,2560,10400,1280,1280,47.5225,-122.04
444500,3,2.5,2600,4724,2600,0,47.5359,-121.878
340000,4,1,1200,11834,1200,0,47.4557,-122.443
680000,4,1,1660,6075,1660,0,47.6755,-122.403
420000,3,1.75,1140,8558,1140,0,47.7027,-122.198
438500,3,2.25,3050,10689,3050,0,47.3326,-122.201
109500,2,1,800,10625,800,0,47.496,-122.317
461000,4,2.75,1700,7495,1200,500,47.7589,-122.354
968000,4,1.75,2630,9645,2630,0,47.5459,-122.228
355000,3,1.75,1960,7705,980,980,47.53,-122.347
249000,3,1.5,1180,11579,1180,0,47.4502,-122.089
256500,5,2.5,1960,7350,1360,600,47.4368,-122.165
1.81E+06,5,2.5,4250,20441,2490,1760,47.6377,-122.211
269000,3,2.25,1950,8661,1950,0,47.3127,-122.362
1.35E+06,4,3.5,3600,5217,2720,880,47.6189,-122.286
885000,3,2.25,2060,9552,1610,450,47.5402,-122.231
455000,3,2,1640,9825,1090,550,47.7244,-122.2
980000,4,2.5,2730,4800,2230,500,47.642,-122.358
412500,3,1.75,1530,6300,1530,0,47.516,-122.375
740000,4,3.5,3060,4777,3060,0,47.555,-122
1.298E+06,4,2.25,2860,5658,2130,730,47.6395,-122.409
326000,2,1.5,1030,798,1030,0,47.6975,-122.34
568500,4,2.5,2460,4200,2460,0,47.6041,-122.02
620000,4,2.5,2500,8282,2500,0,47.5127,-122.169
283000,3,1.75,1830,7600,1490,340,47.5317,-122.351
875000,6,3.25,2820,4536,1930,890,47.6688,-122.309
1.31E+06,4,2.25,3750,5000,2440,1310,47.6747,-122.303
289950,3,2.5,2070,6145,2070,0,47.3357,-122.172
252500,3,2.5,1780,7192,1250,530,47.4093,-122.173
376000,4,2.25,2200,6750,1480,720,47.5215,-122.202
635700,4,2.5,3240,13978,1860,1380,47.6298,-122.057
710000,4,2.5,2880,12349,2880,0,47.5879,-121.973
440000,3,1.75,1570,5120,980,590,47.7166,-122.365
439000,3,2.5,3180,7904,1810,1370,47.489,-122.181
455000,2,1.5,1310,12196,1310,0,47.6487,-122.122
225000,2,1,910,9612,910,0,47.4297,-122.152
250000,3,1,1460,10914,1460,0,47.4511,-122.173
585000,4,3.25,3410,34939,2470,940,47.459,-122.003
685000,3,1.75,2720,4720,1580,1140,47.6691,-122.29
420000,5,2.75,2280,10319,1300,980,47.7566,-122.363
245000,2,1,670,1675,670,0,47.5918,-122.295
275000,4,2,1480,15000,1480,0,47.4312,-122.196
270000,3,2,2330,8000,1390,940,47.2958,-122.368
767250,4,3,2170,2500,1710,460,47.6742,-122.303
229000,3,2,1760,9900,1760,0,47.4783,-122.338
400000,3,1,1240,4000,1240,0,47.5467,-122.359
2.195E+06,5,3.25,5210,35765,4940,270,47.5463,-122.397
665000,5,2,2800,17788,1400,1400,47.6719,-122.163
500000,4,2.25,2060,44431,2060,0,47.744,-122.046
355500,5,2,2360,19899,2360,0,47.3299,-122.046
369000,4,2.5,2370,6557,2370,0,47.423,-122.155
338500,2,1,720,6050,720,0,47.7259,-122.29
256000,3,1,950,4000,780,170,47.5232,-122.284
470000,3,2.5,1980,9725,1980,0,47.4856,-121.802
675000,3,2.5,2540,7680,2540,0,47.7175,-122.364
369950,4,2.75,2760,7533,1400,1360,47.371,-122.108
615000,5,3.5,2950,7980,2350,600,47.5339,-121.858
1.20069E+06,5,3,3640,28531,3640,0,47.5502,-122.13
950000,3,1.75,2150,3503,1870,280,47.6285,-122.303
799500,4,2.5,2760,5750,2760,0,47.627,-122.303
187000,2,1,840,11600,840,0,47.492,-122.302
598000,5,2.25,2890,12478,2890,0,47.6295,-122.052
429950,3,2.25,2060,10160,1340,720,47.7712,-122.285
347950,5,2.25,1700,13500,1700,0,47.4611,-122.067
851000,3,2.5,3560,107290,3560,0,47.6652,-122.049
205000,3,1,1210,10185,1210,0,47.4873,-122.345
225000,3,2.25,1590,9200,1110,480,47.2917,-122.184
705000,4,2.25,2620,10536,1520,1100,47.5847,-122.075
535000,5,2.5,3190,6178,3190,0,47.5104,-122.154
222500,3,2,1450,9044,1450,0,47.1955,-121.987
313500,2,1.5,1270,1282,1000,270,47.5581,-122.363
632000,3,2.25,2730,7521,2730,0,47.7704,-122.196
467000,3,2,1840,3432,1840,0,47.7368,-122.295
339000,3,2.25,1970,7210,1380,590,47.3821,-122.171
712000,3,2.75,3200,6699,3200,0,47.5884,-121.991
335000,3,1,1060,10050,1060,0,47.7355,-122.231
470000,3,3.25,1740,1693,1360,380,47.558,-122.382
367000,3,1,810,7000,810,0,47.6591,-122.134
440500,3,2.5,2460,4399,2460,0,47.5415,-121.884
305000,4,1,2100,9288,1050,1050,47.4558,-122.171
635000,3,1.75,1530,5000,1020,510,47.6806,-122.36
1.02E+06,3,2.25,1670,4800,1670,0,47.6356,-122.367
342000,2,2.5,1175,1366,740,435,47.6962,-122.342
283000,3,2.25,2130,8800,1270,860,47.383,-122.168
430000,4,2.75,2470,50123,1280,1190,47.2504,-122
245000,4,2.5,1700,4268,1700,0,47.3303,-122.268
355500,3,2.5,2600,5540,2600,0,47.3446,-122.041
395000,3,1,1460,5000,1460,0,47.6837,-122.32
324900,4,2.25,2010,7280,2010,0,47.3585,-122.286
660000,3,1.75,1320,5750,1320,0,47.5848,-122.391
570000,3,2.5,3150,20189,3150,0,47.447,-122.088
552321,3,2.5,1960,8469,1960,0,47.7236,-122.105
1.1E+06,2,1.75,2050,11900,2050,0,47.6209,-122.219
237000,3,1.5,1800,9216,1800,0,47.2739,-122.249
402000,2,1,1210,5600,1210,0,47.5322,-122.392
470000,3,2.25,1830,39165,1830,0,47.4612,-121.992
395900,3,1.75,1880,8706,940,940,47.7362,-122.292
442000,2,1.75,860,5535,860,0,47.6901,-122.331
795000,4,2.75,2890,16397,2890,0,47.7102,-122.072
190500,3,2,1390,10155,1130,260,47.2575,-122.305
808000,4,2.75,3340,7230,3340,0,47.549,-122.096
500000,4,2.5,2040,6685,2040,0,47.7413,-122.354
775000,4,2.75,3010,15992,3010,0,47.5895,-121.994
300000,5,1.75,2110,8500,1100,1010,47.7737,-122.35
496000,5,1.75,2110,8500,1100,1010,47.7737,-122.35
448000,4,2.5,2510,6853,2510,0,47.3547,-122.003
645000,2,2.25,2770,11884,1570,1200,47.5098,-122.474
464600,3,1.75,1120,5500,1120,0,47.5445,-122.391
590000,3,1,1530,2370,1530,0,47.6108,-122.303
399000,3,2.5,1800,3300,1690,110,47.5491,-122.276
305000,2,1,1030,6000,1030,0,47.5669,-122.283
478000,3,1.75,1210,6175,1210,0,47.7291,-122.202
598800,1,1,1090,32010,1090,0,47.6928,-121.87
430000,4,2.25,1790,7203,1110,680,47.7709,-122.294
433000,4,1.5,1550,5053,1180,370,47.5499,-122.274
420000,4,2.75,2400,20000,1170,1230,47.4556,-122.087
585000,4,1.75,2470,131790,2470,0,47.4421,-122.444
255000,3,1,1170,7395,1170,0,47.4627,-122.19
305000,3,1,1120,10125,1120,0,47.4794,-122.078
396000,4,1,1040,4420,1040,0,47.6945,-122.368
347500,4,2.5,2460,7350,2460,0,47.3061,-122.349
900000,4,2.5,3690,11468,3690,0,47.5699,-122.092
425000,3,1.75,1960,43332,1400,560,47.739,-122.048
429000,3,2.5,1920,15124,1920,0,47.5015,-121.773
540000,3,2.25,1670,3135,1220,450,47.6478,-122.396
324950,3,2,1340,9750,890,450,47.5644,-121.898
1.049E+06,3,2.25,2610,3357,1980,630,47.638,-122.306
221000,4,1.75,1540,7200,1260,280,47.3424,-122.308
405000,3,2,1640,7201,1640,0,47.7216,-122.289
1.15E+06,3,2.5,2100,15120,2100,0,47.6201,-122.222
588000,4,1.75,1930,7245,1510,420,47.6396,-122.112
234950,3,2,1430,10850,1430,0,47.2671,-122.233
580000,4,1.5,2430,4995,1730,700,47.5782,-122.292
637000,5,3,2460,7240,1840,620,47.5486,-122.189
704000,4,2.25,2490,6973,1490,1000,47.6516,-122.409
210000,2,1,880,9750,880,0,47.4885,-122.298
772000,4,2.5,2110,3750,2110,0,47.6789,-122.363
763000,4,1.75,1850,4388,1850,0,47.6885,-122.381
213500,2,1.5,2060,7713,2060,0,47.3722,-122.185
255000,2,1,1360,9367,680,680,47.7689,-122.315
423500,3,2,2000,10490,1430,570,47.6976,-122.166
520000,3,1.5,1810,18483,1810,0,47.7617,-122.378
550000,3,2.75,2230,14400,1460,770,47.5791,-122.048
795000,3,2.75,1820,7517,1820,0,47.5705,-122.406
495000,4,3,2740,2811,2240,500,47.7738,-122.158
455000,4,2.5,2710,6558,2710,0,47.434,-122.109
85000,2,1,910,9753,910,0,47.3897,-122.236
239000,4,2,1980,10585,1980,0,47.4836,-122.214
184900,3,1,1040,10080,1040,0,47.329,-122.343
386000,4,2.25,2810,8560,1610,1200,47.4437,-122.124
415000,4,2.5,2000,5962,2000,0,47.7695,-122.35
387000,3,1,1530,6372,1210,320,47.535,-122.289
2.14E+06,6,4,5110,7128,5110,0,47.6285,-122.304
685000,4,2.25,3133,16197,2533,600,47.4255,-122.338
340000,4,2.5,2020,32710,1070,950,47.4969,-122.33
422000,2,1,750,4000,750,0,47.5547,-122.272
442000,3,2.5,1980,39932,1980,0,47.7433,-122.196
280000,3,1,1200,6250,920,280,47.5095,-122.331
1.15E+06,5,2.5,3580,8921,3580,0,47.693,-122.202
279000,3,2.5,2010,11618,2010,0,47.1956,-121.985
569000,4,2,1730,3884,1060,670,47.6624,-122.349
1.355E+06,5,3.5,5960,13703,4770,1190,47.6151,-122.107
209950,2,1,860,5080,860,0,47.39,-122.236
468000,3,1.5,1370,7697,1370,0,47.7153,-122.361
237100,3,1.75,1360,9603,1360,0,47.3959,-122.309
336000,4,2.5,2530,8169,2530,0,47.2634,-122.312
500000,4,2,1680,3813,1680,0,47.593,-122.293
290000,3,2.5,1580,6860,1580,0,47.4447,-122.188
1.185E+06,7,3.5,3890,8342,2840,1050,47.7011,-122.392
365000,5,2,1600,4168,1600,0,47.5297,-122.381
146300,3,1,1200,9668,1200,0,47.3156,-122.128
554000,3,1.75,1760,10780,1760,0,47.5938,-122.154
424000,3,2,1670,7700,1170,500,47.725,-122.2
1.348E+06,4,3.5,4640,9827,3210,1430,47.5524,-122.078
508500,4,1.5,1800,6750,1800,0,47.6868,-122.285
244500,3,1.75,1210,8864,1210,0,47.3639,-122.08
206000,2,2.5,1280,1566,1280,0,47.4336,-122.195
643500,3,2,1650,7104,1650,0,47.7053,-122.374
372500,4,1.75,1590,10523,1590,0,47.7358,-122.342
630000,5,2,1900,5000,1720,180,47.6735,-122.362
418000,2,2.5,1500,3608,1500,0,47.5472,-121.994
425000,4,2.5,2689,6688,2689,0,47.3803,-122.184
800000,4,2.75,3250,5500,3250,0,47.5398,-121.997
208000,2,1,960,13438,960,0,47.4745,-122.295
476000,3,1.75,1650,9600,1650,0,47.5779,-122.044
277500,3,2.5,1690,5171,1690,0,47.2779,-122.347
478000,3,1.75,2790,36585,1410,1380,47.4734,-121.999
890000,4,2.75,2310,4020,2310,0,47.6154,-122.291
450000,3,3.5,1790,1288,1390,400,47.651,-122.384
205000,3,1,1230,8750,1230,0,47.3266,-122.334
665000,3,2,1620,2640,1620,0,47.6884,-122.322
518000,4,2.75,2440,12051,1440,1000,47.7456,-122.351
465000,4,2.25,2100,7350,2100,0,47.7019,-122.171
330000,3,2.5,3040,7232,3040,0,47.3355,-122.168
449400,4,3,2490,5064,2490,0,47.5139,-122.189
829000,3,2.75,2690,10443,2690,0,47.7185,-122.024
450000,4,1.75,2190,9752,2190,0,47.7108,-122.239
310000,3,1.75,1490,9120,1490,0,47.4806,-122.163
615000,3,2.25,2530,45234,2530,0,47.7221,-122.12
605000,3,2,2060,4040,1120,940,47.6798,-122.352
437500,3,2.25,1970,35100,1970,0,47.4635,-121.991
545000,3,1.75,1400,4000,1400,0,47.6902,-122.388
770000,3,2.5,3680,35617,2390,1290,47.7213,-122.12
600000,5,2.25,3000,13899,3000,0,47.6373,-122.105
560000,3,1,1440,5000,1440,0,47.6741,-122.354
1.92E+06,5,5.75,7730,230868,6660,1070,47.7615,-122.084
457000,3,1,1170,3348,1170,0,47.687,-122.378
585000,2,1,1770,8640,1520,250,47.6926,-122.363
560000,3,2,1860,13374,1860,0,47.5397,-122.054
345000,2,1,770,3008,770,0,47.5686,-122.389
550000,4,3.5,3820,17745,2440,1380,47.557,-122.295
589950,4,2.5,3190,8195,3190,0,47.3555,-122.003
327000,3,1.5,1320,13200,1320,0,47.5009,-122.143
800000,2,2.25,1730,31491,1730,0,47.373,-122.464
150000,3,1,1010,25000,1010,0,47.6927,-121.901
425000,2,2.5,1140,1182,1140,0,47.6713,-122.383
350000,3,1,860,7030,860,0,47.7151,-122.211
273000,3,1.75,1540,10545,1540,0,47.4451,-121.763
750000,4,2.25,2160,9525,1080,1080,47.5651,-122.221
240000,3,1.5,1450,9477,1450,0,47.4215,-122.203
400000,3,1.75,1830,9620,1830,0,47.3123,-122.389
230000,3,1.5,1630,6625,980,650,47.29,-122.368
372000,4,2.5,2500,8215,2500,0,47.4124,-122.204
459500,3,1.75,1470,4950,1030,440,47.7325,-122.337
582000,3,2.5,2380,19860,2380,0,47.5255,-122.173
465000,4,2.5,2170,7700,1420,750,47.7216,-122.219
386000,3,2,2120,7560,2120,0,47.435,-122.16
546000,3,2.5,1530,3464,1530,0,47.6179,-122.141
278000,3,1.75,2710,9088,2060,650,47.3073,-122.272
540000,3,2.5,2860,8935,2860,0,47.5336,-121.855
529000,4,1.75,2800,90169,2800,0,47.5204,-121.829
554000,4,1,1120,7104,1120,0,47.7055,-122.372
210000,3,1,1730,7210,1430,300,47.3404,-122.28
225000,2,1,1010,5408,1010,0,47.3759,-122.238
561600,4,2.5,2350,6624,2350,0,47.6262,-122.045
300000,6,5.25,2860,5682,2860,0,47.303,-122.221
1.65E+06,4,3.5,4285,9567,3485,800,47.6434,-122.409
1.0171E+06,4,3.75,4060,19290,4060,0,47.6051,-122.053
150000,3,1,1310,9612,960,350,47.2958,-122.285
400950,2,1.75,2320,6250,1400,920,47.5468,-122.386
620000,4,2.25,2210,8101,2210,0,47.6475,-122.07
449000,4,2.75,2090,14141,1680,410,47.4333,-122.347
630000,4,2.5,2240,4025,1250,990,47.6818,-122.311
336000,2,1,1180,7200,1180,0,47.7475,-122.342
299950,4,1.75,1560,31299,1560,0,47.3384,-122.164
352500,4,2,1970,7451,1350,620,47.765,-122.335
150000,2,1,840,12750,840,0,47.484,-122.211
175000,2,1,840,12750,840,0,47.484,-122.211
305000,3,2,1830,10873,1830,0,47.3066,-122.394
2.574E+06,4,3.75,4475,20424,2659,1816,47.6646,-122.208
607500,3,1.5,1800,4700,1200,600,47.6858,-122.385
505000,2,1,1250,5040,950,300,47.6959,-122.365
280500,3,1.75,2440,10179,1220,1220,47.4118,-122.314
610000,3,2.5,2910,12283,2910,0,47.4602,-122.152
381000,5,2.75,3060,6895,3060,0,47.3809,-122.098
482000,5,2.25,2230,9600,1320,910,47.7466,-122.076
379950,3,1,1270,6900,1270,0,47.7279,-122.192
2.5E+06,4,4.5,4300,19844,4300,0,47.6218,-122.237
425000,3,2.25,1580,39189,1180,400,47.6365,-121.972
580000,4,2.25,2570,36465,2570,0,47.6555,-122.042
605000,2,1,860,6510,860,0,47.6021,-122.202
194000,1,1,820,1060,760,60,47.5472,-122.372
546200,4,2.25,2090,8579,2090,0,47.6364,-122.03
1.395E+06,4,3.5,3560,16782,2560,1000,47.5569,-122.225
315000,3,1.75,1860,9629,1240,620,47.4913,-122.143
465000,3,1.5,900,8690,900,0,47.5751,-122.393
330000,2,1,1160,32251,580,580,47.3537,-121.939
795000,4,2.75,3100,7501,3100,0,47.6859,-122.109
265000,4,2.25,2300,9100,1280,1020,47.4576,-122.16
1.3E+06,4,2.5,3110,11857,2040,1070,47.6952,-122.402
126500,3,1,1130,12212,1130,0,47.4952,-122.34
760000,4,2.5,2920,7901,2920,0,47.7036,-122.125
540000,2,1.25,1230,1569,1050,180,47.6193,-122.304
446000,5,2.75,2190,12687,1370,820,47.7762,-122.257
170000,1,0.75,850,5600,850,0,47.7654,-121.48
379000,3,2.5,1500,7420,1000,500,47.7236,-122.174
1.4E+06,9,4,4620,5508,3870,750,47.6684,-122.309
800000,4,2.75,3150,7035,3150,0,47.5979,-121.974
260000,3,1,1300,10139,1300,0,47.3427,-122.087
820000,5,2.5,3160,8000,1580,1580,47.5735,-122.208
449950,3,1.75,2070,96703,2070,0,47.2853,-122.008
392000,3,2.25,1790,7125,1220,570,47.7184,-122.226
465000,3,2.5,1650,4636,1650,0,47.5997,-122.016
449950,4,2.5,2070,7312,1230,840,47.6958,-122.12
520000,3,1.5,1580,8841,1180,400,47.6931,-122.352
546800,4,2.25,2170,10000,1420,750,47.6219,-122.109
825000,4,2.75,2220,11925,1560,660,47.6381,-122.205
337000,3,1.75,1440,11364,1440,0,47.743,-122.328
333000,2,1,720,6686,720,0,47.7003,-122.362
380000,2,2,1120,780,760,360,47.5788,-122.41
280000,3,2.5,1970,8426,1970,0,47.2674,-122.306
202000,3,1.5,1420,9081,1420,0,47.1948,-121.999
585000,4,2.5,2250,4119,2250,0,47.5973,-122.034
435000,4,2,2630,9663,1330,1300,47.4841,-122.19
1.2E+06,4,3.5,4740,172497,4740,0,47.6779,-122.075
364000,2,2.25,1280,2574,1280,0,47.5939,-122.302
300000,3,1,1260,8280,1260,0,47.7,-122.299
558000,2,1.75,1930,4601,1930,0,47.7196,-122.022
199950,1,1.5,1048,4800,1048,0,47.4759,-122.212
515000,3,2.25,1640,8400,1640,0,47.5484,-122.172
590000,4,2.5,2380,4950,2380,0,47.5382,-122.391
813500,4,2,2530,15520,2220,310,47.613,-122.167
725000,4,2.5,2700,25870,2700,0,47.6934,-122.161
490000,3,2.25,2330,3600,2330,0,47.631,-122.061
277000,3,2.25,2160,9612,2160,0,47.1927,-122.011
325000,4,1.5,1470,70800,1470,0,47.3458,-121.948
649800,4,2.5,2280,9827,2280,0,47.6883,-122.168
425000,3,1,1280,3200,1280,0,47.6029,-122.307
460000,2,1,850,4650,850,0,47.6926,-122.365
750000,3,3.25,4610,81935,4610,0,47.6217,-122.021
469000,5,2.5,2690,11745,1790,900,47.7708,-122.362
566000,4,1.75,2440,5000,1340,1100,47.6823,-122.371
407500,3,2.5,1930,10460,1930,0,47.4938,-122.161
353500,2,1,800,8775,800,0,47.7171,-122.307
524000,3,2.25,2430,73151,2430,0,47.4749,-122.092
264950,4,2.5,1990,9656,1990,0,47.3125,-121.998
547500,3,2.5,2550,10355,2550,0,47.739,-122.203
264500,3,2.25,1370,7087,1370,0,47.3504,-122.035
507500,3,2,2020,8118,1020,1000,47.5866,-122.118
560000,3,3.5,1560,2198,1180,380,47.5812,-122.403
995000,5,4,5610,22529,4090,1520,47.7239,-122.092
835000,6,2,3560,5120,3560,0,47.6056,-122.311
440000,3,1.5,2120,6290,1220,900,47.5658,-122.318
1.015E+06,3,2.5,2920,5629,1460,1460,47.642,-122.405
300000,2,1,1340,7788,1340,0,47.5094,-122.244
125000,3,1,1230,4800,1230,0,47.6941,-122.365
986000,4,3.5,2840,5900,1920,920,47.5543,-122.268
315000,4,2.5,2080,5650,1680,400,47.5107,-122.257
320000,4,2.5,2070,7007,2070,0,47.3968,-122.171
972000,4,3.25,4010,13797,4010,0,47.5229,-122.152
760000,3,2.5,2190,10000,1540,650,47.5419,-122.214
265000,4,3,1730,7264,1730,0,47.4738,-122.264
355000,2,1,1250,4558,1250,0,47.5318,-122.379
300000,3,1,1300,20812,1300,0,47.5435,-122.359
474950,5,2.5,2080,8347,1460,620,47.7334,-122.168
470000,4,2,2180,17180,2180,0,47.698,-121.92
437500,3,1,1630,16393,1630,0,47.6576,-122.186
520000,2,1.5,1840,3825,1040,800,47.6808,-122.38
237600,2,1,1370,11584,1370,0,47.4224,-122.293
162950,2,1,950,2784,950,0,47.3793,-122.321
457000,3,1.75,1690,6375,1690,0,47.5247,-121.926
635000,3,2.5,1780,11000,1210,570,47.5574,-122.149
735000,4,3,2840,4120,2060,780,47.5683,-122.283
910000,2,2.5,2000,5150,2000,0,47.7056,-122.223
346500,3,3.25,1570,2048,1290,280,47.548,-122.375
655000,4,2.5,2370,9517,1630,740,47.6222,-122.034
425000,3,1.75,1610,144619,1610,0,47.5659,-121.863
137000,3,1,1300,10125,1300,0,47.2921,-122.215
557500,3,2.5,2620,11056,2620,0,47.7378,-122.218
415000,4,2.25,3060,48787,3060,0,47.3397,-121.918
830000,5,2.25,2780,10192,2780,0,47.6134,-122.152
949000,4,3,4270,85643,4270,0,47.7711,-122.048
420000,3,1,1310,3963,1310,0,47.6826,-122.096
353000,2,1,1100,7500,1100,0,47.7235,-122.326
560000,3,1.75,1480,383328,1480,0,47.7192,-121.932
445700,3,2.5,1270,1180,1270,0,47.6697,-122.392
226000,4,1,1270,6459,1270,0,47.5441,-122.273
358000,3,1,890,9870,890,0,47.5398,-122.178
501000,3,1.75,1480,8667,740,740,47.5718,-122.136
609000,4,2.5,3240,23870,1840,1400,47.7731,-122.282
734950,4,3.25,4280,47179,3050,1230,47.3017,-122.127
725000,5,2.5,3210,12000,1830,1380,47.6205,-122.148
350500,3,2.25,1870,7200,1390,480,47.734,-122.174
610000,5,2.5,3990,3839,1990,2000,47.6236,-122.299
605125,2,1,1160,5029,910,250,47.6723,-122.266
1.388E+06,4,2.25,2940,20384,2940,0,47.6214,-122.227
550000,3,2.25,1850,37264,1850,0,47.6486,-122.035
335000,2,1.75,1060,1202,760,300,47.5426,-122.388
397000,3,2,1100,9165,1100,0,47.7304,-122.231
240000,3,2,1190,10299,1190,0,47.314,-122
240000,3,2,1030,11118,1030,0,47.3463,-122.308
262500,2,1.5,1140,14373,1140,0,47.7354,-122.219
440000,3,1.5,2260,5300,1200,1060,47.6756,-122.348
160000,3,1,1140,3240,1140,0,47.7093,-121.364
427000,4,1,1860,4736,1860,0,47.6251,-122.3
920000,4,3.5,4080,10666,4080,0,47.6818,-122.023
2.3E+06,4,2.5,3280,7100,2180,1100,47.6285,-122.362
480000,4,2.5,2870,35757,2870,0,47.7568,-122.05
615000,4,1.75,2300,11700,1960,340,47.6331,-122.094
736500,3,2,2230,4800,1290,940,47.645,-122.386
542500,3,2.5,1920,1649,1600,320,47.5901,-122.388
191000,2,1,700,5000,700,0,47.4927,-122.172
730000,4,2.5,2740,11975,2740,0,47.6315,-122.028
1.225E+06,5,2.25,3440,5000,3440,0,47.6127,-122.286
129000,1,1,650,15364,650,0,47.3721,-122.159
284000,3,1.5,1500,10018,1500,0,47.468,-122.163
645000,3,2.5,2490,5978,2490,0,47.6298,-122.022
218000,3,1.5,1330,7600,1330,0,47.3103,-122.366
675000,4,3.5,3190,6875,2120,1070,47.7082,-122.221
575000,3,2.5,1590,2910,1110,480,47.6855,-122.321
225000,2,1,830,5720,830,0,47.7339,-122.339
626000,3,2.25,1810,5107,1810,0,47.6882,-122.171
499950,4,2.5,2910,20067,2910,0,47.4714,-122.273
405000,4,1.75,2180,13529,1090,1090,47.7516,-122.294
152500,3,1,1090,3523,1090,0,47.3161,-122.182
325000,4,2.5,2160,6825,2160,0,47.4111,-122.2
475300,3,1,2110,10005,1110,1000,47.688,-122.168
485000,3,1.75,2180,7318,1210,970,47.5251,-122.37
720000,3,2.5,2100,2200,1500,600,47.614,-122.294
465000,3,1.75,1410,6886,1410,0,47.7183,-122.353
489000,3,1.5,1020,9072,920,100,47.695,-122.301
3.1E+06,5,5.25,5090,23669,5090,0,47.6297,-122.216
288000,3,2.25,2090,7500,1280,810,47.3951,-122.172
225000,3,1.75,1350,9793,1350,0,47.1981,-122.003
499000,3,1.75,2650,11774,2240,410,47.4909,-122.363
632000,5,3,3520,36558,2100,1420,47.4658,-122.007
580000,3,2.5,2040,4627,2040,0,47.6365,-122.108
730000,4,1.5,2340,5000,2100,240,47.6065,-122.291
325000,4,2.25,1770,7799,1770,0,47.4192,-122.202
421000,3,1.75,1100,8662,1100,0,47.5368,-122.173
316000,3,2.5,1490,4078,1490,0,47.4915,-122.155
415000,2,1,1460,4200,880,580,47.6774,-122.361
401000,3,2.25,1350,2839,1350,0,47.6824,-122.036
229950,3,0.75,1030,12700,1030,0,47.3877,-122.236
539950,3,1.75,1820,9875,1820,0,47.6243,-122.094
335000,3,2,1170,5360,1170,0,47.5181,-122.364
339000,3,2.5,1450,3748,1450,0,47.532,-121.85
414950,4,1.75,2200,8545,1100,1100,47.7481,-122.353
650000,4,2,1610,8976,1610,0,47.6011,-122.192
445000,3,2.5,2690,21883,2690,0,47.6462,-121.904
295000,3,2.25,1850,7800,1850,0,47.3146,-122.379
975000,4,2.25,2250,3600,2010,240,47.643,-122.37
296500,3,1.5,1580,10100,1580,0,47.4423,-122.193
440000,4,2.75,2030,56192,1550,480,47.752,-122.073
420000,5,1.5,1890,10880,1890,0,47.7196,-122.197
302000,3,2.5,2140,9492,2140,0,47.3289,-122.204
350000,4,1.75,1770,7336,1770,0,47.4265,-122.163
667000,3,1.75,3320,478288,2260,1060,47.2407,-121.953
645000,3,2,1640,4218,910,730,47.6546,-122.344
430000,4,2.75,1820,5400,1220,600,47.5204,-122.205
413000,4,1,1410,6000,810,600,47.566,-122.373
420000,3,1,1240,7300,1240,0,47.6775,-122.168
495000,3,2.25,1780,8050,1230,550,47.6977,-122.126
2.18773E+06,4,4.5,4240,13162,4240,0,47.6193,-122.229
965000,4,2.5,3570,17411,3570,0,47.5617,-122.03
500000,4,2.5,1900,5001,1200,700,47.7289,-122.335
636100,3,1,1010,6000,1010,0,47.6438,-122.357
720000,4,2.5,2870,12648,2870,0,47.5632,-122.017
298000,3,1.75,1620,12825,1340,280,47.3321,-122.323
409000,2,1.75,1480,4000,740,740,47.6916,-122.38
370000,4,2.5,2650,5706,2650,0,47.3515,-122.164
230000,5,1,1410,9000,1410,0,47.3054,-122.369
290000,3,2,1360,6685,1360,0,47.7365,-122.324
420000,4,2.25,2930,9840,1560,1370,47.3103,-122.382
917000,4,2.5,3500,10891,3500,0,47.5533,-122.093
957000,5,3.25,3160,5000,2180,980,47.6464,-122.405
482000,3,2.25,1710,21485,1710,0,47.6198,-122.053
488000,3,1.75,2180,14734,2180,0,47.4831,-121.767
760369,5,2.5,2870,4712,2870,0,47.5463,-122.182
170000,2,1,1500,18540,1500,0,47.4727,-122.281
625000,3,2.5,2120,10021,1230,890,47.5621,-122.135
357000,3,1.5,1590,6750,1080,510,47.73,-122.191
583000,3,2.25,1830,8276,1350,480,47.6336,-122.025
173250,3,2,1210,9097,1210,0,47.4849,-122.303
414050,4,2,1590,10331,1590,0,47.7273,-122.332
400000,3,1.75,1050,6150,950,100,47.5715,-122.394
537000,3,2,1550,27003,1550,0,47.606,-122.056
465000,4,2.25,2070,7500,2070,0,47.727,-122.217
425000,3,2.25,1740,9682,1740,0,47.5138,-122.173
445000,4,2,1700,21780,1080,620,47.6289,-122.108
179950,2,1,1200,9000,1200,0,47.3277,-122.349
275000,3,2.5,1710,7230,1710,0,47.2778,-122.298
190000,4,2.5,1840,13493,1840,0,47.2649,-122.242
385000,3,1.75,1900,5520,1280,620,47.5549,-122.292
303000,4,1,2300,9583,1220,1080,47.5671,-121.89
165000,3,1,970,7503,970,0,47.4688,-122.163
600000,2,2,1270,5000,1270,0,47.6729,-122.363
710000,3,2.25,3130,65775,3130,0,47.5462,-122.085
875000,5,3.25,4230,21455,2720,1510,47.6375,-122.015
269950,3,2.5,1480,9743,1480,0,47.3293,-122.001
838000,4,2.5,3310,42998,3310,0,47.7232,-122.131
670500,4,2,1590,6750,1590,0,47.6406,-122.317
420000,4,1.5,1690,9391,1290,400,47.7438,-122.329
370000,3,1.5,1690,161913,1430,260,47.356,-122.189
360000,3,1.75,1500,7200,1500,0,47.7748,-122.337
562500,4,2.5,2320,8721,2320,0,47.7326,-122.226
360500,3,2.5,3300,11525,1650,1650,47.4113,-122.315
389999,3,2.25,1445,1471,1300,145,47.5342,-122.072
450000,4,3,1890,13140,1270,620,47.5221,-122.044
247500,4,2,1760,8400,1060,700,47.3258,-122.323
208000,3,1,1050,6240,1050,0,47.4933,-122.338
455000,3,2.5,1980,7309,1980,0,47.7257,-122.172
379400,4,1.75,2120,7680,1060,1060,47.7172,-122.361
190000,3,1.5,760,40039,760,0,47.5295,-121.829
326188,3,1,1300,8800,1300,0,47.64,-121.966
168000,2,2.5,1160,2174,1160,0,47.5264,-122.366
314000,4,2.5,2340,8990,2340,0,47.3781,-122.03
630000,4,2.75,2710,37277,2710,0,47.4634,-121.987
550000,3,1.75,1440,8957,1440,0,47.6008,-122.118
530000,4,2.25,1980,15086,1980,0,47.647,-122.064
637500,3,1.75,1680,10685,1680,0,47.6556,-122.193
400000,3,2.5,1390,2815,1390,0,47.566,-122.366
700000,5,2.75,3100,9825,3100,0,47.7188,-122.281
272000,3,2.5,1680,8512,1680,0,47.1952,-121.986
600000,4,2.5,2710,6474,2710,0,47.5383,-121.878
450600,2,1,840,7020,840,0,47.5513,-122.394
550000,3,2.25,2090,8095,2090,0,47.5287,-122.385
225000,3,1,1120,8407,1120,0,47.2051,-122.006
132825,3,1.5,1210,5200,1210,0,47.3615,-122.087
219950,3,1.5,1210,5200,1210,0,47.3615,-122.087
580000,5,2,1940,6000,970,970,47.6875,-122.287
568000,3,1.75,1930,213008,1300,630,47.6751,-121.993
406000,3,1.75,1270,6017,1030,240,47.737,-122.225
469000,3,1.75,1680,2400,1170,510,47.6849,-122.367
415000,3,2.5,2090,6045,2090,0,47.4947,-122.174
390000,3,1.5,1000,13991,1000,0,47.5643,-122.138
251000,3,1.75,1350,10125,1350,0,47.3334,-122.298
750000,3,2.5,3280,6750,2440,840,47.5219,-122.38
845000,4,2.5,2390,5071,1760,630,47.6144,-122.283
350000,3,1.5,1860,17640,1860,0,47.484,-122.111
322000,3,1,1380,5864,790,590,47.7049,-122.339
664500,4,2.25,3070,9210,2740,330,47.7638,-122.196
988000,3,1.75,2190,3800,2190,0,47.643,-122.355
625000,2,1.75,1990,4000,1090,900,47.6889,-122.342
675000,2,1,930,36478,930,0,47.5699,-122.164
503000,3,1.75,2070,9827,1420,650,47.522,-122.05
431000,4,2.25,2170,10500,1270,900,47.4394,-122.338
250000,3,1.75,1910,10230,1290,620,47.4185,-122.207
268500,4,2.5,2100,4237,2100,0,47.3901,-122.174
1.07E+06,6,3.25,3560,21400,3560,0,47.7602,-122.372
295000,4,2.5,2290,4539,2290,0,47.4753,-122.172
780000,3,2.25,2130,11782,1590,540,47.5423,-122.215
354000,3,2.5,2160,15817,2160,0,47.4166,-122.183
305000,2,1,860,7250,860,0,47.7206,-122.35
733000,5,2.75,2880,4425,2880,0,47.7048,-122.109
640000,4,2.75,2100,11894,1720,380,47.6006,-122.194
840000,4,2.5,2360,9600,1630,730,47.5889,-122.249
1.475E+06,5,3.25,3680,10300,3680,0,47.6548,-122.28
525000,3,1,1560,8100,1140,420,47.7261,-122.364
625000,4,2.75,1680,11180,1680,0,47.6557,-122.127
350000,3,2,1380,3600,1380,0,47.6074,-122.305
650000,4,2.75,2610,4160,1910,700,47.6901,-122.357
435000,2,1,870,4000,870,0,47.5682,-122.374
660000,3,1,1210,9622,1210,0,47.5728,-122.179
350000,3,1,1150,12877,1150,0,47.6614,-122.056
435000,3,2.5,3110,6000,1560,1550,47.5331,-122.353
375900,6,1.5,2550,33740,1750,800,47.3222,-122.362
272000,3,3,2430,10500,2150,280,47.2579,-122.312
233000,3,1.75,1460,7800,1040,420,47.3035,-122.382
500000,4,1.5,1330,5750,1330,0,47.5681,-122.384
540000,4,1.75,2040,9322,1440,600,47.7611,-122.298
712000,3,2.5,2375,4094,2375,0,47.6627,-122.086
425000,4,2.5,2480,4504,2480,0,47.4998,-122.15
242000,3,1.75,1580,6099,790,790,47.4807,-122.29
515000,5,3.25,2740,9629,1390,1350,47.7645,-122.197
415000,4,1.75,1920,7700,1920,0,47.5381,-122.177
375000,3,2.75,2200,9600,1570,630,47.3438,-122.323
182500,3,1,910,7194,910,0,47.3337,-122.275
310000,3,1.5,1860,10379,1240,620,47.3962,-122.309
360000,3,1.75,1510,6000,1060,450,47.5535,-122.39
889000,4,3.5,3920,9555,3920,0,47.6797,-122.025
450500,2,1,1330,3698,1330,0,47.6866,-122.372
342000,4,2.25,1964,3541,1964,0,47.3594,-122.201
413000,3,2,1520,3451,1520,0,47.7753,-122.375
960000,5,4,3720,15200,3720,0,47.5956,-122.026
180000,2,1,770,9370,770,0,47.762,-122.321
770000,4,2.5,3210,14910,3210,0,47.6073,-122.062
224400,3,1.75,1070,7200,1070,0,47.3129,-122.023
280000,3,1.5,1430,8861,1430,0,47.4454,-122.289
500000,3,2.5,1670,2575,1670,0,47.531,-122.047
153000,2,1,710,9000,710,0,47.4811,-122.339
385000,3,2.25,1920,4833,1060,860,47.7067,-122.352
325000,2,1,750,5534,750,0,47.7017,-122.36
315000,4,3,2210,4191,2210,0,47.2959,-122.225
294999,4,2.5,1660,9760,1660,0,47.3635,-122.188
175000,3,1.75,1910,17003,1910,0,47.3095,-122.283
299000,3,1.75,1910,17003,1910,0,47.3095,-122.283
146000,2,1,780,9750,780,0,47.4816,-122.322
290000,3,2.25,1650,10336,1500,150,47.7757,-122.35
1.776E+06,3,3.25,3230,7800,3230,0,47.6348,-122.403
367500,2,1,810,4800,810,0,47.5614,-122.27
535000,4,2.5,2750,15099,2750,0,47.7298,-121.972
334999,3,2.5,1650,13816,1650,0,47.6553,-121.913
655000,3,1.75,1960,5520,1080,880,47.6535,-122.397
1.298E+06,4,3.5,2790,10125,2790,0,47.5651,-122.22
480000,4,2.25,2230,11200,1300,930,47.7691,-122.167
465000,3,1.5,1280,4720,850,430,47.5509,-122.377
297950,3,2,1240,10800,1240,0,47.449,-122.155
590000,3,2,1860,3600,1110,750,47.6102,-122.296
805000,4,2.75,2410,6000,1410,1000,47.6707,-122.399
204250,3,2.25,1960,7708,1490,470,47.2981,-122.374
500000,3,2.25,1710,4561,1710,0,47.5691,-122.004
490000,4,2.5,3480,12696,1980,1500,47.3816,-122.153
2.5E+06,4,3.75,3480,14850,1870,1610,47.6227,-122.216
750000,3,2.5,2960,69351,2960,0,47.4,-122.42
405000,4,2.5,2670,20894,2330,340,47.7735,-122.281
209995,2,1,700,7303,700,0,47.4934,-122.166
680000,4,2.5,2830,8399,2830,0,47.5851,-122.034
355000,3,1.75,1120,7740,860,260,47.7107,-122.291
280000,2,1,1310,6600,1310,0,47.4834,-122.332
385000,3,2.25,1710,11500,1210,500,47.7675,-122.267
505000,4,2.75,2200,9778,1100,1100,47.5472,-122.176
429900,4,3.25,3310,8897,2380,930,47.2655,-122.31
560000,4,2.5,2280,9874,2280,0,47.7099,-122.229
231000,3,2,1640,4875,1040,600,47.3661,-122.094
135000,2,1,750,5217,750,0,47.5188,-122.353
800000,4,3,3520,4895,1980,1540,47.6678,-122.361
420000,3,2.5,2720,8622,2720,0,47.4954,-122.163
360000,3,1,1660,9600,1660,0,47.708,-122.216
642000,4,2.5,2560,8780,2560,0,47.5717,-121.991
379950,3,2,1080,5077,1080,0,47.6836,-122.095
745000,3,1.75,2050,11041,2050,0,47.5968,-122.174
630000,4,2,2670,3240,1780,890,47.5841,-122.294
250000,3,2.5,1730,7200,1730,0,47.4029,-122.196
275000,3,1,990,9798,990,0,47.767,-122.164
435000,6,3,3560,4290,1780,1780,47.5282,-122.269
175000,2,1,700,8174,700,0,47.5136,-122.349
560000,4,1.75,1880,3880,1090,790,47.6635,-122.362
325000,4,2.25,1870,9680,1170,700,47.7157,-122.234
1.185E+06,3,2.75,2500,5568,2500,0,47.6258,-122.312
399950,3,2.5,2570,10431,2570,0,47.4188,-122.213
752000,4,2.5,2940,10382,2940,0,47.5333,-122.151
1.2E+06,4,3.5,3930,43560,3930,0,47.7497,-122.121
400000,4,1.5,2150,11026,2150,0,47.7635,-122.263
240000,3,2,1330,6000,630,700,47.5255,-122.327
640000,5,2.5,3220,4759,3220,0,47.5957,-122.032
564450,3,2.5,2710,6174,2710,0,47.512,-122.174
300000,3,1.5,1630,82764,1630,0,47.4743,-122.026
286000,3,2.5,1680,4226,1680,0,47.3684,-122.123
531800,3,2.5,1930,5344,1930,0,47.6783,-122.032
502000,4,2.25,2140,10943,1550,590,47.7271,-122.215
993500,4,2.25,4070,23321,4070,0,47.5563,-122.219
450000,3,1,1350,10000,1350,0,47.5741,-122.133
997950,4,3.5,4270,117176,4270,0,47.5352,-121.883
526000,3,1,1320,5250,1320,0,47.5566,-122.378
335000,3,1.75,2100,8298,1230,870,47.4601,-122.36
187250,2,1,710,14700,710,0,47.4939,-122.318
735000,3,2.25,2350,6000,1020,1330,47.6809,-122.305
425000,3,1,1180,8400,1180,0,47.7028,-122.295
110000,3,1,1250,53143,1250,0,47.4235,-122.051
305000,3,2,1490,7697,1490,0,47.4852,-122.164
212000,3,1,1000,9450,1000,0,47.4562,-122.193
1.38E+06,5,4.25,4050,18827,2150,1900,47.5323,-122.237
298950,5,2.25,2300,11505,1300,1000,47.3812,-122.223
525000,3,1.75,1330,8136,1330,0,47.7001,-122.173
707000,4,3.25,3200,7081,3200,0,47.5886,-121.989
695000,3,2.75,2590,12063,2590,0,47.5527,-122.12
796500,3,2.75,2590,12063,2590,0,47.5527,-122.12
420000,4,2.5,2030,8100,1150,880,47.7404,-122.186
625000,5,2.5,2700,21208,1950,750,47.6078,-122.154
620000,3,1.75,1670,9900,1670,0,47.595,-122.172
1.45E+06,5,2.75,3090,19865,3090,0,47.6232,-122.235
549950,5,2.5,2650,54380,2650,0,47.7726,-122.081
275000,4,2,1440,10920,1440,0,47.5049,-122.18
705000,3,2.5,2820,7200,1780,1040,47.7691,-122.388
197000,3,1.75,1690,7735,1060,630,47.3324,-122.28
265000,3,1.75,1420,8126,1420,0,47.3871,-122.189
297000,4,1.75,1790,5341,1050,740,47.4663,-122.363
207500,3,1.75,1320,12528,1320,0,47.3234,-122.142
410000,3,2.5,1509,1418,1509,0,47.7047,-122.34
268000,3,2,1610,8416,1610,0,47.397,-122.187
330000,4,1.75,1550,50094,1550,0,47.2194,-122.059
417500,3,1,1160,7491,1160,0,47.7024,-122.359
760000,4,2.25,2500,8500,2500,0,47.5569,-122.151
499000,3,2.5,1540,1326,1390,150,47.6457,-122.374
620000,4,2.5,1910,7683,1910,0,47.5644,-122.092
315000,3,2.5,2340,6837,2340,0,47.3608,-122.194
624950,3,2.5,2060,4730,2060,0,47.6874,-122.178
525000,3,2.25,1960,12350,1960,0,47.5247,-122.052
300000,2,1.5,1150,3927,1150,0,47.7248,-122.162
299900,4,2.75,2330,7200,1560,770,47.3203,-122.385
299000,3,2.5,2210,10119,1450,760,47.3783,-122.22
1.88E+06,4,2.75,3260,19542,2170,1090,47.6245,-122.236
265000,4,1.75,1900,10588,1900,0,47.289,-122.212
280000,2,1.75,1610,158558,1610,0,47.5319,-121.84
124740,3,1,1340,15600,1340,0,47.3224,-122.143
1.085E+06,3,2.75,3170,34850,3170,0,47.6611,-122.169
1.97E+06,8,3.5,4440,6480,3140,1300,47.631,-122.303
219000,4,1,1370,5339,1370,0,47.5046,-122.3
569950,5,1,1420,6250,1420,0,47.5807,-122.389
212500,2,2,1030,21712,1030,0,47.4905,-122.331
680000,3,2.25,1820,8316,1320,500,47.5849,-122.169
1.457E+06,4,1.5,2650,6900,2400,250,47.6275,-122.305
300000,3,1,910,7700,910,0,47.7303,-122.238
629950,3,2.5,1680,1683,1120,560,47.6424,-122.374
349900,2,1.75,1550,9230,970,580,47.4701,-121.744
690000,4,2.5,2780,6235,2780,0,47.5976,-122.039
1.454E+06,5,4,4070,11334,4070,0,47.6771,-122.187
1.288E+06,3,2.5,3240,12625,3240,0,47.5327,-122.232
696000,4,3.5,3650,38546,2550,1100,47.4776,-121.73
650000,3,2.25,2180,60112,2180,0,47.6723,-122.082
640000,3,3.5,2480,10800,2480,0,47.6083,-122.06
499950,5,2.5,3180,23809,3180,0,47.3727,-122.054
490000,4,2.5,3630,8387,3630,0,47.3623,-122.127
685000,5,2.5,3160,5635,3160,0,47.5362,-122.067
387500,4,1,1370,7140,1370,0,47.512,-122.376
401750,2,1.5,1070,1236,1000,70,47.5619,-122.382
254950,4,2,2180,8800,1170,1010,47.3676,-122.046
500000,4,2.25,2420,36680,2420,0,47.4663,-122.006
856500,4,2.5,3290,8147,3290,0,47.7048,-122.107
552000,3,1,1430,5000,1080,350,47.6724,-122.296
506500,4,2.5,1890,7200,1500,390,47.7278,-122.218
500000,3,2.25,1760,4539,1760,0,47.5754,-122.013
280000,4,2.75,2230,10160,1400,830,47.5123,-122.32
308000,3,1.75,1630,11475,1330,300,47.4635,-121.746
613500,3,2.5,2350,7035,2350,0,47.5713,-122.02
255000,3,1.75,1550,9720,1050,500,47.3433,-122.037
545000,3,2.5,3550,136343,3550,0,47.6223,-121.869
620000,4,2.5,2720,34498,1360,1360,47.5832,-122.02
450000,3,1.75,1740,6800,1740,0,47.5314,-122.373
279000,4,1.75,1840,7275,1090,750,47.4002,-122.189
625000,3,2.5,2010,3200,2010,0,47.5463,-122.015
274950,3,1.75,1670,7415,1320,350,47.3776,-122.116
423000,3,1.75,1820,6038,1040,780,47.5233,-122.378
350000,2,1,720,5820,720,0,47.7598,-122.255
305000,4,1.75,2370,10140,1460,910,47.3352,-122.278
368000,3,1.75,2120,11340,1060,1060,47.4109,-122.329
232000,3,1.75,1290,6604,1290,0,47.323,-122.349
250000,4,3,1800,2500,1800,0,47.5333,-122.294
220000,3,1.75,1230,8917,1230,0,47.4528,-122.172
435000,3,2,1380,2500,750,630,47.6753,-122.363
350000,2,1,740,7680,740,0,47.5245,-122.371
206325,5,2.5,1720,10202,1720,0,47.4572,-122.167
339000,5,2.5,1720,10202,1720,0,47.4572,-122.167
399000,4,2.5,2100,7355,2100,0,47.5078,-122.161
529000,2,1,1210,7667,900,310,47.6571,-122.396
640000,4,2.5,2210,7722,2210,0,47.5992,-122.019
735000,4,2.5,2470,2550,2470,0,47.6765,-122.389
378000,5,2.5,2760,8015,1600,1160,47.7255,-122.297
775000,3,2,2540,7200,1600,940,47.5972,-122.292
2.25E+06,3,4.25,5150,7800,4170,980,47.6288,-122.282
1.35E+06,4,4.5,3420,7440,3420,0,47.6875,-122.33
380000,4,2.5,2270,11500,1540,730,47.7089,-122.241
624900,4,2.5,2270,11500,1540,730,47.7089,-122.241
379770,3,2.5,1470,1779,1160,310,47.5472,-121.998
340000,3,1.75,1280,16200,1030,250,47.7427,-122.071
515500,4,2.75,2830,8126,2830,0,47.4863,-122.14
600000,4,2.25,1970,7125,1500,470,47.6725,-122.293
400000,1,1,1390,60984,1390,0,47.7652,-121.903
364000,4,1,1020,11383,1020,0,47.7429,-122.321
440000,4,2.5,2250,7526,2250,0,47.5123,-122.15
285000,2,1,800,6240,800,0,47.7257,-122.296
669000,3,1,1560,4500,1560,0,47.6204,-122.292
475000,4,2,2100,13468,1050,1050,47.7139,-122.292
747000,2,1,990,4000,990,0,47.6589,-122.341
317000,3,1.5,1060,5750,1060,0,47.5532,-122.372
390000,2,1,1270,8164,1270,0,47.7116,-122.311
1.07E+06,4,2.5,2740,5000,2740,0,47.674,-122.371
1.205E+06,4,2.75,2470,5500,1570,900,47.6586,-122.358
580000,3,1.75,1970,5100,1130,840,47.6831,-122.379
518000,4,2.5,2070,10244,1370,700,47.5592,-122.178
147500,3,1.75,1010,6552,1010,0,47.375,-122.117
555000,4,2.25,2220,8125,1450,770,47.5429,-122.177
427500,2,2,1090,934,1090,0,47.6341,-122.342
1.735E+06,3,2.5,4310,32093,2510,1800,47.7624,-122.38
265950,3,2.5,1490,3840,1490,0,47.374,-122.133
247500,2,1,700,6046,700,0,47.7172,-122.34
244000,4,1,1450,8960,1450,0,47.4972,-122.348
578550,3,2.5,2120,6602,2120,0,47.5669,-122.012
451000,4,2.5,1670,3315,1670,0,47.5532,-121.998
489000,2,1.75,1810,4220,1810,0,47.7177,-122.034
190000,2,1,710,1164794,710,0,47.6888,-121.909
475000,3,3,2540,18900,1580,960,47.754,-122.144
485000,3,2,1420,4080,1420,0,47.6872,-122.349
530000,3,2.75,2440,45738,1840,600,47.5453,-121.957
379000,4,2.5,2570,10155,2570,0,47.3842,-122.17
1.629E+06,5,2.5,3090,16583,3090,0,47.6458,-122.218
739000,3,1.75,2050,5160,1300,750,47.6374,-122.304
189950,3,1,920,6460,920,0,47.3665,-122.082
637500,4,3,2320,4468,2160,160,47.546,-122.009
2.225E+06,3,3,3450,16740,1960,1490,47.7067,-122.38
209950,3,1,1660,8800,960,700,47.3212,-122.352
460000,3,1,1130,7000,830,300,47.7132,-122.283
543500,4,2.5,2550,5835,2550,0,47.5373,-121.87
376000,4,2.75,2420,5773,2420,0,47.3772,-122.029
430000,3,2.25,1470,1703,1470,0,47.5478,-121.999
515000,4,2.5,2030,39049,1530,500,47.4413,-122.345
580000,7,2.75,2310,2400,2310,0,47.6775,-122.39
600000,5,3.5,3370,16846,2650,720,47.5584,-122.089
476800,3,1.75,1900,43700,1900,0,47.7265,-122.136
815000,3,1.5,1940,3570,1740,200,47.6618,-122.325
455600,3,2.5,2420,8252,2420,0,47.5382,-121.871
270000,3,1,1010,9514,1010,0,47.4936,-122.105
1.2E+06,5,4,2710,2800,2380,330,47.6346,-122.364
525000,2,1.5,1340,3600,1340,0,47.6358,-122.364
242000,3,1.75,1310,9645,1310,0,47.4051,-122.29
715000,4,2.5,2650,30500,1680,970,47.5535,-122.028
475000,3,2.75,1890,3938,1890,0,47.5336,-121.867
370000,4,3,2580,5511,2580,0,47.4286,-122.185
788600,4,2.75,3500,7200,3500,0,47.6818,-122.025
160000,2,1,1040,13100,1040,0,47.3877,-122.234
800000,5,1.75,1930,501376,1930,0,47.6294,-121.911
520000,4,3,2190,5085,2190,0,47.5693,-122.002
725000,3,1.75,1530,4000,1530,0,47.5239,-122.388
335000,4,1,1480,6500,1480,0,47.5282,-122.267
919000,4,2.5,3620,17133,2220,1400,47.5604,-122.027
425000,3,2.75,3370,13929,2650,720,47.3411,-122.197
420000,5,2.5,2100,14395,1140,960,47.7723,-122.317
905000,4,3,3370,47959,3370,0,47.733,-122.129
435000,2,1,2240,7200,1120,1120,47.5631,-122.271
438000,3,2.5,1650,3031,1650,0,47.682,-122.034
725000,4,2.75,2630,7505,2630,0,47.6846,-122.163
840000,4,1.75,2330,4000,1300,1030,47.666,-122.289
425500,3,2.5,1970,2752,1970,0,47.6345,-122.108
853505,3,2.5,2820,14890,1770,1050,47.7019,-122.228
398000,2,1,590,10945,590,0,47.3364,-122.033
418500,3,2.5,2060,4399,2060,0,47.5415,-121.884
826000,3,1.5,1890,5000,1890,0,47.6312,-122.353
742000,4,2.5,2810,10986,2810,0,47.5943,-121.981
180000,4,1,1470,18581,1470,0,47.4336,-122.197
286000,4,1.75,2190,8400,2190,0,47.3003,-122.373
421200,3,2.5,1440,3060,1440,0,47.6821,-122.035
390000,3,3,2480,14141,1500,980,47.3778,-122.033
739000,4,2.5,2780,6737,2780,0,47.5656,-122.122
499900,4,3,2180,12196,2180,0,47.5338,-122.033
670000,3,2.25,3340,13805,3340,0,47.744,-122.292
842500,3,2.25,2560,3996,2150,410,47.6321,-122.306
492500,2,2.25,1600,80400,1600,0,47.4422,-122.505
836500,3,2.5,2230,7200,2230,0,47.558,-122.265
334000,2,1,900,1818,900,0,47.6485,-122.397
179900,3,1,1010,9920,1010,0,47.3238,-122.14
563000,3,2,1580,5289,870,710,47.6881,-122.342
310000,3,2.5,1890,6300,1890,0,47.3673,-122.031
335000,4,2.25,2160,8817,1460,700,47.7595,-122.356
499950,4,2.25,2160,8817,1460,700,47.7595,-122.356
658500,2,1,1410,5101,1410,0,47.6872,-122.333
297000,2,1.5,1430,1650,1430,0,47.7222,-122.29
725000,6,1.75,2380,4080,2380,0,47.6629,-122.325
780000,3,2.25,2206,82031,866,1340,47.6302,-122.069
252500,3,1,1030,6127,880,150,47.7192,-122.32
330000,3,2.5,1070,1155,720,350,47.5617,-122.385
525000,3,2.5,2320,9610,1730,590,47.7394,-122.204
365000,2,1.75,1270,7500,1270,0,47.6186,-122.063
500000,4,3,2570,9104,2570,0,47.5821,-122.401
179950,3,1,920,4875,920,0,47.3648,-122.081
440000,3,2,1790,32379,1790,0,47.4826,-121.698
145000,1,0.75,480,9750,480,0,47.4982,-122.362
331000,4,3,2483,5701,2483,0,47.3623,-122.199
780000,3,2.25,2140,3000,2140,0,47.6767,-122.351
855000,3,1.75,1900,4000,1300,600,47.6854,-122.331
225000,3,2.25,1650,7739,1290,360,47.3532,-122.304
199000,3,1,1510,9100,1510,0,47.3331,-122.319
550000,3,1.75,2910,35200,2910,0,47.5747,-122.035
1.425E+06,4,4.25,4960,6000,3680,1280,47.6437,-122.356
805000,3,2,2710,4500,1880,830,47.6747,-122.295
261000,3,1.5,1810,29308,950,860,47.3585,-122.067
347000,3,1,940,9198,940,0,47.6889,-122.117
390000,3,2.25,1600,10240,1090,510,47.7281,-122.232
436000,4,2.5,2640,3899,2640,0,47.754,-122.217
1.80275E+06,5,3.25,3890,20005,2260,1630,47.6312,-122.224
557000,3,2.5,1630,1587,1630,0,47.6693,-122.393
135000,3,1,830,9600,830,0,47.3698,-122.297
425000,3,2.5,1800,14036,1800,0,47.7334,-121.97
648752,3,2.25,2060,9953,1070,990,47.5767,-122.233
1.388E+06,4,3,4040,20001,2020,2020,47.6408,-122.212
630100,4,2.75,1910,11356,1160,750,47.6999,-122.2
739000,4,2.5,2800,246114,2800,0,47.6586,-121.962
269000,3,1.5,1320,2625,1320,0,47.7316,-122.338
250000,3,1,1220,5038,1220,0,47.496,-122.189
475000,5,2.75,3100,5298,3100,0,47.5369,-121.887
290000,1,1,550,5700,550,0,47.6846,-122.366
219000,3,1,1080,10639,1080,0,47.3171,-122.219
416000,2,1,880,6650,880,0,47.6914,-122.372
179000,2,1,720,8914,720,0,47.4488,-122.274
302000,4,2.75,2030,9120,2030,0,47.282,-122.303
565000,4,2,2040,8281,2040,0,47.6689,-122.195
281700,3,1,1570,8316,1070,500,47.3943,-122.198
480000,2,1,1500,3420,1500,0,47.661,-122.338
775000,4,2.5,3180,15358,3180,0,47.5172,-122.053
375000,3,1.75,1260,11224,1260,0,47.7444,-122.321
345000,3,1.5,1390,13860,1390,0,47.4704,-121.747
300000,3,3,2850,9375,2240,610,47.4655,-122.209
364950,4,2.5,2070,2992,2070,0,47.4496,-122.12
410000,3,3.25,2650,7819,1760,890,47.4821,-122.192
231000,3,1.75,1220,8817,1220,0,47.3111,-122.396
445000,3,2,1630,8702,1630,0,47.5168,-122.193
530000,2,2.5,1785,779,1595,190,47.5959,-122.198
353500,3,2.5,1260,972,840,420,47.5872,-122.316
209950,3,1.5,1380,11130,1380,0,47.3146,-122.323
650000,3,1.75,2330,7200,1320,1010,47.565,-122.274
325000,2,1,840,4239,840,0,47.5319,-122.382
257000,3,2.25,1730,9516,1180,550,47.3823,-122.166
337000,4,2.5,2230,5970,2230,0,47.3745,-122.131
541000,3,2.5,1790,4038,1790,0,47.5499,-121.998
577500,3,2.5,2280,10879,2280,0,47.6217,-122.034
560000,3,2.5,2430,5128,1270,1160,47.5198,-122.389
979700,5,3,3730,5500,2160,1570,47.6507,-122.32
750000,5,3,2230,8560,1150,1080,47.6154,-122.115
407500,2,1,770,2971,770,0,47.6358,-122.322
530000,4,1.75,1814,5000,944,870,47.684,-122.281
235000,4,1.75,1920,9350,1000,920,47.292,-122.195
715000,4,2.5,1860,3840,1170,690,47.6886,-122.359
795000,5,3,2750,10000,1730,1020,47.5878,-122.13
465000,4,2.5,1930,9653,1930,0,47.3367,-122.335
287600,3,2.5,1950,8251,1950,0,47.343,-122.28
630000,6,3,2470,9328,2470,0,47.6025,-122.153
445000,3,2.25,1630,6449,1310,320,47.7275,-122.232
490000,4,2.25,2110,16200,1630,480,47.752,-122.144
565000,3,1.75,1490,5000,1250,240,47.5257,-122.392
330000,3,2.5,1740,1844,1320,420,47.5248,-122.365
463000,4,2.75,1900,6000,1300,600,47.495,-122.229
1.87E+06,5,4,4510,15175,4510,0,47.5309,-122.228
219500,3,1,1090,6710,1090,0,47.3066,-122.217
622200,3,1.75,1720,7200,1420,300,47.7062,-122.304
474800,2,3.25,1400,1243,1400,0,47.6534,-122.353
465000,4,2.5,2090,9702,1320,770,47.7467,-122.339
389950,3,1.75,1580,9049,1580,0,47.7776,-122.375
650000,4,2.5,2620,19864,2620,0,47.7014,-122.122
395000,3,2,1500,2506,870,630,47.5962,-122.301
304500,4,2.5,2030,5202,2030,0,47.388,-122.176
307000,3,1,1020,8484,1020,0,47.7719,-122.31
485000,3,2.5,1540,7120,770,770,47.3729,-122.037
1.562E+06,5,3,3910,16200,2890,1020,47.6326,-122.217
650500,5,4.25,3920,11412,3920,0,47.5766,-122.151
960000,4,2.5,3180,10105,3180,0,47.5328,-122.226
710000,3,2.5,2330,9160,2330,0,47.5467,-122.181
540000,3,2.5,2600,23361,2150,450,47.4997,-122.379
601000,4,1.75,1950,4200,1040,910,47.6755,-122.285
463828,5,1.75,3250,13702,1650,1600,47.4883,-122.225
293000,4,1,1130,8308,1130,0,47.4669,-122.355
597500,3,2.5,2620,4800,2620,0,47.6849,-122.037
240000,2,1,1120,45302,1120,0,47.5105,-121.77
284000,3,1.75,1800,23103,1800,0,47.6517,-121.906
440000,4,1.75,2180,10200,2000,180,47.7638,-122.27
340000,3,1.75,1960,8136,980,980,47.5208,-122.364
363000,3,1.75,1960,8136,980,980,47.5208,-122.364
270000,2,1,1150,3600,1150,0,47.5729,-122.31
365000,4,2.5,2800,6820,2800,0,47.3695,-122.108
428000,3,2,1310,2550,780,530,47.6911,-122.35
600000,3,1.75,2340,57499,2340,0,47.6989,-122.044
405000,3,2.5,1430,10200,1430,0,47.7012,-122.166
339900,4,2.5,2340,9748,1610,730,47.3363,-122.331
275000,3,1,1290,11250,1290,0,47.4743,-122.341
361600,2,1,760,6380,760,0,47.6914,-122.31
325000,6,2,2780,13950,2780,0,47.3738,-122.226
1.05E+06,3,2,2090,4077,1530,560,47.6433,-122.3
959750,4,3,3060,50002,2460,600,47.6205,-122.096
210000,3,1,1110,7962,1110,0,47.5035,-122.36
258000,3,2,1790,7879,1790,0,47.2634,-122.289
468000,3,1.5,1830,9848,1830,0,47.539,-122.18
710000,4,3.5,2850,2910,1970,880,47.6855,-122.321
268000,3,1,1420,6000,1420,0,47.4913,-122.336
115000,2,1,790,7252,790,0,47.5048,-122.365
500000,3,2.5,2300,4307,2300,0,47.7326,-122.197
431000,3,2.5,2440,71002,2440,0,47.2689,-122.01
241500,3,2,1310,7349,870,440,47.3639,-122.186
300000,3,1,1380,12000,1380,0,47.3997,-122.215
982000,4,2.5,2790,10289,2790,0,47.5483,-122.158
248500,3,2.5,1360,7293,1360,0,47.3304,-122.302
665000,4,2.5,2510,5936,2510,0,47.5847,-122.032
1.215E+06,3,3,4560,16339,4040,520,47.7024,-122.243
380000,2,1,780,3910,780,0,47.566,-122.38
220000,3,2,1410,7998,1410,0,47.4968,-122.277
631500,4,2,2530,5650,1910,620,47.5778,-122.382
386100,3,2,1270,6760,1270,0,47.7381,-122.179
1.05E+06,4,4.5,3180,4606,1990,1190,47.6402,-122.405
650000,2,1.75,1450,4000,1350,100,47.6571,-122.326
545000,4,1.75,2040,53578,1160,880,47.3844,-122
870000,4,2.5,2650,12001,2650,0,47.5496,-122.14
380000,3,1.75,1240,8611,1240,0,47.7175,-122.331
265000,2,1,820,8423,820,0,47.4741,-122.2
645500,2,1,1890,5202,1890,0,47.6786,-122.379
570000,3,2,1270,3090,1270,0,47.685,-122.359
1.2E+06,4,2.5,3350,11688,1760,1590,47.5507,-122.133
605000,2,1,1550,3200,1550,0,47.6368,-122.306
199500,3,1,920,9812,920,0,47.2958,-122.284
445000,2,1,950,4800,950,0,47.5864,-122.301
495000,4,1.75,2040,3570,1020,1020,47.5754,-122.288
594000,4,1.75,1870,5200,1200,670,47.6843,-122.283
465000,3,1.75,1720,5280,900,820,47.6493,-122.401
160000,2,1,1020,13647,1020,0,47.2848,-121.927
340000,4,2.5,2690,6099,2690,0,47.3314,-122.171
870000,4,2,3090,41147,3090,0,47.6748,-122.049
249000,3,1.5,1070,5150,1070,0,47.5335,-122.349
500000,4,2.25,2050,7201,2050,0,47.7003,-122.165
220000,3,1.5,1660,15600,1660,0,47.2589,-122.279
368500,5,1.75,2810,9360,1520,1290,47.4361,-122.193
439950,4,2.25,2460,14600,1720,740,47.3762,-122.16
179900,3,1.75,1230,12000,1230,0,47.2878,-122.251
490000,4,2.5,2360,4367,2360,0,47.7731,-122.167
425000,4,1.75,1730,11890,980,750,47.5979,-122.194
533300,4,2.5,2770,21806,2770,0,47.4815,-121.768
447500,4,2,1770,3332,1630,140,47.5563,-122.281
768000,5,2.75,3030,13640,3030,0,47.6186,-122.146
285000,3,1.75,2380,6000,1320,1060,47.498,-122.222
336900,3,1.75,1780,120661,1780,0,47.7731,-121.897
415000,4,1.5,1540,7886,1540,0,47.734,-122.193
500000,3,2.25,1580,4379,1580,0,47.5694,-122.005
337000,4,2.5,3200,5772,3200,0,47.3486,-122.153
419950,4,2.5,2220,6800,2220,0,47.49,-122.15
290000,4,2.75,2240,8162,1380,860,47.7427,-122.34
349950,2,1.75,1640,4176,1040,600,47.5162,-122.26
330000,3,1.5,1170,4950,1170,0,47.6057,-122.135
965000,4,2.25,3160,34560,3160,0,47.7337,-122.132
515000,3,2.5,2100,7851,2100,0,47.7242,-122.105
665000,4,2.5,2600,17388,2600,0,47.5283,-122.146
265000,3,1.75,1630,5999,1630,0,47.3816,-122.313
545400,3,2,2850,19200,2340,510,47.3378,-122.348
350000,4,3,2560,5606,2560,0,47.3274,-122.178
260000,2,1.5,980,1296,840,140,47.7075,-122.336
2.51E+06,3,3.25,5480,57990,5480,0,47.4558,-122.371
355000,3,2,2160,8091,2160,0,47.3474,-122.303
879000,3,3,3030,5156,2080,950,47.647,-122.369
833000,4,3.5,3560,7178,2590,970,47.7054,-122.107
261590,2,1,760,6407,760,0,47.4977,-122.259
512500,3,3,2260,2400,2260,0,47.6094,-122.31
600000,2,1.75,1560,3200,880,680,47.6419,-122.394
417500,5,3,2270,6664,1340,930,47.7191,-122.315
970000,5,3,3480,15185,3480,0,47.5757,-122.216
316000,3,2.25,1900,7479,1900,0,47.3495,-122.037
397500,4,3,2350,9952,1650,700,47.4194,-122.211
1.35E+06,3,2.5,2390,5500,1700,690,47.6389,-122.409
840000,4,2.5,3730,9847,3730,0,47.587,-121.976
270000,2,1,1780,81021,1780,0,47.2712,-122.265
312900,4,2.5,1630,4473,1630,0,47.3546,-122.015
325000,2,1,1130,6908,1130,0,47.745,-122.313
680000,3,1.75,2140,3584,1070,1070,47.636,-122.391
763000,4,2.5,3220,7873,3220,0,47.5849,-122.03
375000,1,1,800,533610,800,0,47.4134,-121.986
475000,3,2.5,1800,3300,1690,110,47.5491,-122.276
219000,2,2.5,809,940,809,0,47.5499,-122.384
415000,3,2.25,1820,9694,1240,580,47.6157,-122.05
90000,2,1,580,7500,580,0,47.4852,-122.251
220000,2,1,580,7500,580,0,47.4852,-122.251
616000,3,2,2900,5650,1520,1380,47.5789,-122.396
269500,2,1,1140,74052,1140,0,47.2093,-121.962
395350,2,1,1060,5754,1060,0,47.6931,-122.372
770000,4,3,2320,7200,1260,1060,47.5893,-122.232
840000,4,2.5,3450,43216,3450,0,47.7625,-122.025
428950,2,1,1760,4441,1310,450,47.5311,-122.381
800000,4,3.75,3370,6766,3370,0,47.7063,-122.106
401000,4,1,1940,5753,1940,0,47.7188,-122.358
303697,4,2,2520,7334,1600,920,47.7263,-122.291
355000,3,1,1360,8968,1360,0,47.7105,-122.289
350000,2,1,800,5040,800,0,47.6953,-122.362
754999,4,2.5,3010,9323,3010,0,47.578,-122.053
982218,3,1.75,2340,5500,2340,0,47.6451,-122.319
406500,3,2,1780,8621,1780,0,47.5062,-122.149
1.65E+06,4,3.25,4200,210394,4200,0,47.5607,-121.961
565000,2,1.75,1720,3000,860,860,47.686,-122.351
160000,2,1,830,4500,830,0,47.5248,-122.265
220000,3,1,1090,6320,890,200,47.4976,-122.35
1.284E+06,5,4.25,5040,9466,5040,0,47.5282,-122.133
970000,5,2.75,3500,5040,2950,550,47.5527,-122.379
115000,3,1,1080,6250,1080,0,47.5045,-122.33
124000,3,1,1080,6250,1080,0,47.5045,-122.33
157000,3,1,1080,6250,1080,0,47.5045,-122.33
183000,3,1,870,5200,870,0,47.3702,-122.078
527000,4,2.5,2830,6163,2830,0,47.5227,-122.19
407193,4,2,1880,14653,1880,0,47.6959,-121.921
970000,4,2.75,3600,5040,2610,990,47.6487,-122.388
535000,4,2.5,2340,5600,2340,0,47.5117,-122.379
245000,3,2,2040,13125,810,1230,47.478,-122.278
337000,3,1.75,1310,12750,1310,0,47.4695,-122.07
630000,3,2,1470,6000,1090,380,47.6829,-122.202
320000,3,1.75,1370,9900,1370,0,47.2575,-122.312
228500,3,1,1080,7486,990,90,47.4838,-122.335
293000,3,2.5,1990,7577,1990,0,47.2908,-122.351
447000,3,1,1310,7000,1310,0,47.6019,-122.123
226500,3,1.75,1640,10762,1130,510,47.3586,-122.074
436000,3,2.25,1770,8000,1350,420,47.7358,-122.17
451000,3,2.5,2050,4876,2050,0,47.7746,-122.158
315000,3,1,1170,62290,1170,0,47.5104,-121.787
450000,2,1,1340,7250,1340,0,47.7015,-122.32
635000,3,1.5,2240,5300,1120,1120,47.6927,-122.395
292500,2,1,880,17743,880,0,47.4115,-122.197
329900,3,2.5,2170,4905,2170,0,47.3503,-122.039
531000,2,1.5,1260,6660,1260,0,47.6792,-122.287
725000,3,1.75,1880,13300,1380,500,47.634,-122.204
355300,3,2.5,1620,7410,1620,0,47.7708,-122.335
280000,3,2.5,1610,10022,1610,0,47.2583,-122.3
1.095E+06,4,2.75,3330,9143,3330,0,47.6821,-122.19
605004,4,2,1370,4000,1370,0,47.6593,-122.394
260000,2,1,690,6000,690,0,47.5621,-122.283
748000,4,2.5,3170,4979,2570,600,47.6655,-122.34
776000,2,2,1990,6180,1010,980,47.6792,-122.303
425000,4,1,1080,6095,1080,0,47.6962,-122.346
230000,4,1,1870,14703,1090,780,47.5274,-122.281
418000,3,1.75,1670,12075,1370,300,47.7681,-122.307
440000,4,2.5,2800,28254,2800,0,47.3552,-122.063
858450,5,2.75,3460,7977,3460,0,47.5908,-122.062
390000,3,2,1930,12443,1930,0,47.4906,-121.775
957000,4,3,2370,3836,1750,620,47.6718,-122.394
507000,3,1,1180,6000,1180,0,47.6853,-122.286
575000,2,1,1320,4750,1320,0,47.6729,-122.38
700000,3,1.75,1350,4000,1350,0,47.6581,-122.354
239950,2,1.5,1068,1452,1068,0,47.753,-122.244
253000,3,1,1580,8240,1040,540,47.3542,-122.181
540000,4,1,1690,3417,1690,0,47.663,-122.402
1.55E+06,3,4,5120,4600,4490,630,47.7052,-122.223
805000,4,2.5,3960,38615,3960,0,47.7249,-122.024
920000,4,3.25,2420,4000,1870,550,47.6567,-122.325
496600,3,2.5,1910,5562,1910,0,47.5738,-122.017
246000,3,2.25,1440,10500,1130,310,47.318,-122.391
350000,5,3,2320,8400,1510,810,47.557,-122.365
585000,3,2,1670,4572,1670,0,47.6854,-122.373
450000,3,1.75,1390,11700,1390,0,47.7002,-122.192
746000,3,2.5,2620,8950,2620,0,47.5523,-122.119
598555,3,2.5,3040,7880,3040,0,47.5277,-122.184
820000,3,2.5,2990,10711,1560,1430,47.3573,-122.324
266500,3,2.25,1740,5460,1210,530,47.3648,-122.046
370000,2,1,2360,105850,1180,1180,47.2495,-121.97
625000,3,2.75,2240,3600,1650,590,47.6244,-122.326
243500,4,2,1610,6200,1610,0,47.3833,-122.306
340000,2,1,700,5829,700,0,47.6958,-122.357
559950,5,3,2730,9519,1670,1060,47.7504,-122.307
315000,3,2.75,1780,15114,1080,700,47.258,-122.305
753000,3,2.5,3070,223463,3070,0,47.664,-121.993
800000,3,3,2060,3200,2060,0,47.637,-122.324
550000,3,2.25,1360,5111,1360,0,47.6988,-122.313
465000,3,2,1430,14250,1430,0,47.701,-122.199
465000,3,2.25,1840,5752,1840,0,47.7042,-122.187
710000,4,2.25,2000,8068,2000,0,47.5584,-122.137
505000,3,2.5,1820,11012,1820,0,47.6358,-122.026
690000,3,1.75,2330,16300,2330,0,47.7037,-122.24
217500,2,2,1070,8400,1070,0,47.4014,-122.186
500000,2,1,930,3750,930,0,47.6733,-122.296
325000,2,2,1040,5796,1040,0,47.7362,-122.29
500000,4,2.25,1960,12436,1960,0,47.6276,-122.037
721500,3,3.25,2970,234788,2040,930,47.5353,-121.897
924000,3,1.5,2200,5000,2200,0,47.6404,-122.408
2.005E+06,6,4.5,3810,28176,3810,0,47.7612,-122.381
345000,2,1.5,830,1034,830,0,47.5926,-122.3
825000,4,3.5,3920,11086,3920,0,47.5416,-121.869
560000,3,2,2870,95396,1350,1520,47.4834,-122.001
599000,3,2,2560,14680,1330,1230,47.648,-122.118
211000,3,1.5,1350,7620,1350,0,47.4565,-122.35
425000,4,2.25,1240,21190,910,330,47.5123,-122.197
750000,4,2.75,3210,8520,1810,1400,47.7743,-122.388
479000,3,2.5,1690,3322,1690,0,47.6824,-122.036
612500,4,2.5,2550,10623,2550,0,47.5695,-121.992
605000,5,1.75,3240,34510,2690,550,47.5529,-122.027
1.364E+06,4,2.5,3560,8960,3560,0,47.6903,-122.213
389900,3,2.5,2160,59241,2160,0,47.3304,-122.13
710000,4,2.5,3060,5000,3060,0,47.5395,-122.188
295000,3,2.5,1690,8564,1690,0,47.3518,-122.057
275250,3,2.25,1520,7199,1520,0,47.3492,-122.034
250000,4,2.5,2040,5770,2040,0,47.3522,-122.059
709000,3,2,2360,18000,2180,180,47.7133,-122.367
399500,4,1.75,1360,4840,1360,0,47.556,-122.376
225000,3,2.5,2000,9202,2000,0,47.3516,-122.057
500000,3,2.5,1650,4648,1650,0,47.5968,-122.015
364900,3,3,2500,8304,2500,0,47.4022,-122.166
356000,3,1.5,1140,7500,1140,0,47.619,-122.064
616750,3,1.5,2140,47743,2140,0,47.5402,-122.365
755000,3,2.75,2870,6600,2870,0,47.5745,-122.113
327500,2,1,830,8183,830,0,47.7366,-122.302
605000,3,2.25,1960,10139,1960,0,47.6481,-122.061
179950,4,1.5,1130,5200,1130,0,47.3616,-122.089
633000,5,2.75,3630,30570,3630,0,47.4243,-122.097
349950,4,2,1764,15600,1764,0,47.4318,-122.181
1.08E+06,3,2.75,2770,5800,1650,1120,47.6496,-122.413
425000,3,2.5,2650,12247,2650,0,47.3185,-122.259
990000,3,2.75,2500,6350,2370,130,47.6035,-122.285
410000,3,1,2710,19000,2710,0,47.4462,-122.359
590000,3,2.25,2490,8800,2490,0,47.5666,-122.132
242000,3,1.75,1500,7560,1500,0,47.3467,-122.296
775000,3,2,1160,13747,580,580,47.585,-122.051
680000,4,1.5,1880,6200,1440,440,47.5035,-122.384
217000,3,2.5,1340,4200,1340,0,47.2942,-122.226
395000,3,2.5,1960,3953,1960,0,47.4904,-122.158
572500,3,2.25,2030,9791,1500,530,47.534,-122.161
559900,5,3,2200,6380,1440,760,47.7033,-122.322
845000,3,2,2540,4750,1840,700,47.6838,-122.4
241000,3,2,1520,7131,1520,0,47.3061,-122.361
1.325E+06,3,2.25,2360,5504,2080,280,47.617,-122.288
475000,3,1.75,1340,2805,1340,0,47.5922,-122.297
575000,2,1.5,1400,5810,1400,0,47.6843,-122.341
455000,4,2.75,3030,117378,1680,1350,47.401,-122.135
839000,3,2.5,3200,203425,3200,0,47.7614,-122.015
475000,4,1.5,1580,10260,1030,550,47.5984,-122.147
600000,2,1,2120,6897,1060,1060,47.5566,-122.278
515000,2,1,1640,5200,1040,600,47.6426,-122.403
425000,3,2.25,1890,8400,1520,370,47.7103,-122.232
565000,4,2,1710,3875,1710,0,47.6086,-122.294
498000,2,2,1140,8282,1140,0,47.6949,-122.21
739000,4,3,2720,3800,1800,920,47.6756,-122.306
355000,2,1.75,1650,4000,950,700,47.5622,-122.319
263000,3,1.75,1790,7485,1330,460,47.3118,-122.34
375000,4,1.75,1680,6834,1680,0,47.716,-122.307
322000,3,1.75,2200,12231,1250,950,47.5076,-122.173
325000,2,1,830,5100,830,0,47.6932,-122.346
290000,2,1,770,4800,770,0,47.527,-122.383
809950,4,2.5,3280,6181,3280,0,47.6484,-122.081
969500,3,3.25,2080,3025,1220,860,47.6051,-122.289
665000,4,2.5,2790,43091,2790,0,47.7759,-122.08
635000,5,3.5,4150,13232,4150,0,47.3417,-122.182
272450,3,2.25,1780,7332,1780,0,47.3593,-122.051
427000,4,1.75,1460,9750,1460,0,47.6205,-122.102
261500,3,1,1410,8174,1410,0,47.4969,-122.178
488800,4,2.25,2170,9665,1300,870,47.5444,-122.165
340000,2,1,690,5200,690,0,47.556,-122.395
398950,4,3,3000,10297,3000,0,47.3684,-122.073
217000,3,1,870,5200,870,0,47.3701,-122.078
799000,4,2.5,3170,94855,1910,1260,47.7648,-122.112
160000,4,1,1540,7350,770,770,47.3318,-122.34
447000,3,1,1270,8800,1270,0,47.6703,-122.15
765000,3,1.75,2190,6450,1480,710,47.5284,-122.391
1.32E+06,4,3.5,4410,36200,4410,0,47.5487,-122.126
445000,4,2.5,2790,8111,2480,310,47.4492,-122.116
310000,3,1,1510,6000,1170,340,47.5168,-122.285
380000,2,1.75,1800,7191,990,810,47.4828,-122.191
325000,4,1,2410,6975,1510,900,47.5692,-122.295
345000,4,2.75,2250,7412,1480,770,47.4449,-122.129
300000,3,1,950,4760,950,0,47.5236,-122.348
530000,4,1.75,2860,48351,1710,1150,47.7605,-122.085
583500,4,1.75,2860,48351,1710,1150,47.7605,-122.085
410000,2,1,1560,10125,1130,430,47.7488,-122.304
535000,2,1.5,1940,5700,970,970,47.6881,-122.367
2.05E+06,4,3.25,3580,19989,3480,100,47.7087,-122.276
345000,4,2.5,2040,5523,2040,0,47.432,-122.328
539000,5,1,1700,11727,1700,0,47.686,-122.172
590000,4,2.5,3700,12500,1920,1780,47.5403,-122.168
187000,2,1.75,1050,2926,1050,0,47.3811,-122.317
270000,3,2,1690,9583,1690,0,47.4825,-122.164
546000,2,1,1120,6180,1120,0,47.6824,-122.301
520000,3,1.75,1490,1036,1090,400,47.6588,-122.403
515000,5,2,2220,6000,1390,830,47.5822,-122.295
990000,3,2.5,2160,6000,1880,280,47.6582,-122.28
382000,2,1,870,10492,870,0,47.5467,-122.365
1.21E+06,3,1.75,1900,13600,1900,0,47.6163,-122.219
900000,4,3.5,3370,5000,2470,900,47.5714,-122.38
675000,3,2.75,3370,5350,2310,1060,47.5373,-122.39
460000,2,1,880,3300,880,0,47.6566,-122.36
234000,2,1,940,5375,940,0,47.4206,-122.324
399000,3,1,1340,7191,1340,0,47.7148,-122.212
253500,3,1.5,1440,12040,1440,0,47.3715,-122.16
475000,3,1.5,1750,12632,1750,0,47.6736,-122.176
740000,5,3.5,3990,5000,2910,1080,47.54,-122.27
799000,3,2.5,2860,4442,2860,0,47.661,-122.396
390000,4,2.5,1940,3864,1940,0,47.4507,-122.12
421000,2,1.5,1400,11245,1400,0,47.7469,-122.321
296500,3,2.5,1770,6033,1770,0,47.3764,-122.119
895000,4,2,1710,4178,1710,0,47.6373,-122.3
386000,4,2.5,2810,11897,2810,0,47.3251,-122.186
424000,3,1,1580,13912,1580,0,47.7552,-122.276
749000,3,1,1580,5000,1580,0,47.684,-122.386
523000,3,1,1440,8681,1440,0,47.6976,-122.283
389000,4,2.5,2420,9147,2420,0,47.3221,-122.322
270000,4,1.5,1930,15000,1930,0,47.3864,-122.312
275000,3,1,1190,27215,1190,0,47.4978,-122.115
287500,4,2.5,2240,6944,1310,930,47.338,-122.258
345000,2,2.5,2550,216344,2550,0,47.2584,-122.124
427000,2,1,920,3780,920,0,47.6576,-122.348
508450,4,1.75,1520,9600,1000,520,47.5763,-122.154
705000,3,2,1460,6250,1460,0,47.6693,-122.333
550000,1,1.5,1900,40600,1450,450,47.4718,-122.009
380000,3,1.5,1430,11173,1430,0,47.5734,-122.153
539900,3,2.5,2500,4203,2500,0,47.5346,-121.875
330000,2,1,720,7250,720,0,47.5267,-122.032
455000,2,1,1140,5720,850,290,47.6827,-122.298
510000,4,4,3530,10935,3530,0,47.3016,-122.342
315000,3,2,1220,14645,1220,0,47.4842,-122.117
206000,3,1,1320,7000,1320,0,47.2787,-122.205
592500,4,3,2170,8240,1370,800,47.6291,-122.093
744000,3,2.5,2020,7512,2020,0,47.6927,-122.206
334500,3,2.5,1990,3694,1990,0,47.3872,-122.154
886000,4,2,2660,3900,1480,1180,47.6398,-122.306
600000,4,2.5,2360,13500,1780,580,47.6315,-122.103
850000,3,2,2740,101930,2740,0,47.5056,-121.77
550000,3,1.75,1360,5850,1000,360,47.5711,-122.391
184900,2,1,1230,5000,1230,0,47.2064,-121.988
245000,3,1.5,1260,7964,1260,0,47.4307,-122.334
370000,2,1,1040,4172,1040,0,47.6308,-122.302
480000,4,2.5,2700,9700,1670,1030,47.7752,-122.198
579000,3,1.75,1800,4429,1800,0,47.6842,-122.357
339275,3,1.5,1590,7260,1080,510,47.7753,-122.353
425000,3,2.75,1360,542322,1140,220,47.2069,-122.024
170000,3,1.75,1370,10780,1370,0,47.4727,-122.298
950000,4,2.5,3320,7644,3320,0,47.5541,-122.106
623000,4,2.5,2980,9235,1690,1290,47.5513,-122.162
477000,3,2.5,1350,2053,1350,0,47.6758,-122.386
330000,3,1,1160,9600,1160,0,47.7419,-122.073
600000,3,2.25,1480,5400,1480,0,47.6095,-122.296
570000,3,2,1640,2808,820,820,47.5945,-122.291
515000,4,2.5,2680,7178,2680,0,47.5325,-121.856
805000,4,2.25,2440,9889,1540,900,47.6932,-122.3
555000,4,2.5,2920,24074,2920,0,47.381,-122.056
245000,3,2.25,1780,9598,1780,0,47.3718,-122.182
638150,4,2.5,2170,7275,1820,350,47.5672,-122.09
1.65E+06,4,4.5,5550,16065,3880,1670,47.5455,-122.214
269950,4,2.5,2060,13500,1260,800,47.4229,-122.153
195000,3,1.5,1050,5525,1050,0,47.3608,-122.083
159100,2,1,790,7095,790,0,47.4928,-122.239
550000,3,1,1010,6120,1010,0,47.6648,-122.204
299000,2,1,1040,4600,1040,0,47.5387,-122.277
1.375E+06,4,3.5,3130,4500,2060,1070,47.677,-122.33
249500,2,1,900,4500,900,0,47.4881,-122.204
700000,4,1,1470,5450,1470,0,47.6458,-122.306
275000,4,1,1080,26114,1080,0,47.3834,-122.215
565000,3,2.25,2440,8378,1480,960,47.7705,-122.26
425000,4,1.75,2520,11017,1320,1200,47.7604,-122.356
620047,4,1.75,1760,6000,880,880,47.6508,-122.373
480000,3,2.25,1820,13362,1220,600,47.5898,-122.052
515000,3,2.25,1820,13362,1220,600,47.5898,-122.052
420000,4,2.5,3040,24123,3040,0,47.2667,-122.216
610000,5,3.25,3490,23400,1890,1600,47.5701,-122.124
849000,4,1.5,2440,8040,1440,1000,47.7081,-122.374
718000,3,1.75,2280,3446,2280,0,47.715,-122.282
295000,3,2.25,1980,8000,1560,420,47.3149,-122.378
871000,5,1.75,2360,6150,1180,1180,47.6732,-122.4
430000,3,3.75,3890,7140,2390,1500,47.5073,-122.239
440000,4,2.5,2300,10880,1190,1110,47.7341,-122.242
405000,2,1,910,6490,910,0,47.6892,-122.306
340000,3,2,1140,11620,1140,0,47.4991,-121.783
675000,4,2.5,2390,5249,2390,0,47.6194,-122.026
480000,3,1,1150,4945,1150,0,47.5663,-122.379
362500,5,2,2330,8586,1270,1060,47.7671,-122.334
752888,3,2.5,2420,9000,2420,0,47.6599,-122.146
255000,4,1.75,960,8863,580,380,47.5372,-122.289
283700,1,1.75,1010,10900,1010,0,47.7391,-121.982
335000,4,2.5,2370,6000,2370,0,47.3732,-122.179
285000,3,1.75,2880,18296,1580,1300,47.4881,-122.281
278000,4,2.25,2400,7738,2400,0,47.4562,-122.33
731000,5,2.5,3670,8960,3670,0,47.6654,-122.142
335000,3,1.5,1140,15890,840,300,47.4752,-121.757
334200,3,1.75,1410,45302,1410,0,47.7077,-121.914
642000,6,1,1530,4305,1530,0,47.6862,-122.31
540000,4,1.75,1720,4240,1460,260,47.579,-122.294
299000,3,2.5,1620,79993,1620,0,47.2138,-121.982
560000,3,1.75,1570,4375,970,600,47.5889,-122.389
852000,5,2.75,1990,3750,1990,0,47.6733,-122.358
306000,2,1,930,5650,930,0,47.5478,-122.377
440000,3,1.75,1550,7820,1210,340,47.717,-122.163
517000,4,1,1650,8250,1650,0,47.6366,-122.118
379000,2,1,800,6380,800,0,47.691,-122.309
360000,2,1,930,6098,930,0,47.5289,-122.03
645000,4,1.5,2550,4000,1760,790,47.6811,-122.318
217000,2,1,720,4760,720,0,47.496,-122.186
255000,2,1,620,4760,620,0,47.5292,-122.376
625000,3,2.5,2360,12164,2360,0,47.5596,-122.022
680000,3,1.75,1760,8400,1460,300,47.5355,-122.39
440000,3,1.75,2100,29735,1080,1020,47.7622,-122.302
615000,5,2.25,2480,12070,2480,0,47.631,-122.052
239000,3,1,1040,6860,1040,0,47.5121,-122.375
462500,3,2.5,1656,108900,1656,0,47.3758,-122.425
619400,4,2,2090,3610,1790,300,47.6881,-122.313
975000,6,2.75,2520,54160,2520,0,47.4969,-122.376
330000,2,1,700,4000,700,0,47.5487,-122.391
985000,4,3.25,4030,36762,4030,0,47.7235,-122.039
430000,2,1,760,7114,760,0,47.7005,-122.352
2.458E+06,4,5.25,6500,14986,5180,1320,47.6304,-122.236
778000,3,2,1840,6000,1720,120,47.6828,-122.207
219000,3,2,1090,7350,1090,0,47.3687,-122.085
1.595E+06,4,2.5,2980,13341,1800,1180,47.704,-122.245
715000,4,2.25,1900,8272,1460,440,47.5803,-122.227
950000,4,2.5,2790,15653,2790,0,47.5477,-122.215
425000,2,1,1280,5026,1020,260,47.6938,-122.312
239000,3,1,1510,15022,1510,0,47.3304,-122.304
310000,1,1,920,8282,920,0,47.761,-122.214
400000,2,1,700,8120,700,0,47.6962,-122.321
428000,2,1.75,1980,44550,1280,700,47.4193,-122.444
600000,3,1,1440,4300,1440,0,47.6847,-122.372
415000,4,4,2740,8250,2740,0,47.3735,-122.156
401000,2,1,1400,8220,1400,0,47.7228,-122.357
292000,3,1.75,2270,7156,1370,900,47.4864,-122.316
291750,3,2.25,1310,12825,1310,0,47.4515,-122.368
227000,3,1.75,1680,7455,1680,0,47.3112,-122.378
675000,3,2.25,2260,13209,2260,0,47.6385,-122.167
397500,3,2.25,1350,980,1050,300,47.5998,-122.312
206000,2,1.5,1820,8867,1820,0,47.4764,-122.269
1.19E+06,3,3.5,3380,3333,2800,580,47.6162,-122.288
360000,4,1.75,2140,49658,2140,0,47.3583,-121.922
427500,4,2.5,2430,3249,2430,0,47.5048,-122.155
115000,2,1,940,6000,940,0,47.4907,-122.336
559000,3,1.5,2070,5386,1140,930,47.6896,-122.374
420000,4,1,1510,1501,1510,0,47.6526,-122.342
550000,4,1.75,2550,39460,1890,660,47.7707,-122.123
282150,2,1,700,5940,700,0,47.7289,-122.337
260000,3,1,1150,3090,1150,0,47.5506,-122.276
428000,3,2.5,2340,3466,2340,0,47.5322,-121.851
319950,3,3.25,1510,1245,1510,0,47.7293,-122.343
1.35E+06,3,2,2070,9600,1590,480,47.616,-122.239
552000,2,1,1150,5000,1050,100,47.6846,-122.317
637000,4,2.75,2190,2867,1470,720,47.6868,-122.308
213000,4,1.75,1980,9000,1480,500,47.3071,-122.381
215000,3,1,960,7200,960,0,47.4583,-122.353
590000,3,1.75,2180,6120,1380,800,47.6501,-122.405
390000,4,2.5,2560,43560,2560,0,47.3692,-122.047
287000,4,2.25,2270,11997,1540,730,47.4095,-122.296
580000,5,2.75,3550,9600,3550,0,47.6766,-122.186
424000,3,2,1330,5632,1330,0,47.5745,-122.017
610000,4,2.5,2110,6360,2110,0,47.5641,-122.012
1.32E+06,4,3.25,3470,11843,2270,1200,47.5513,-122.135
623500,4,3,1550,3350,860,690,47.6583,-122.362
260000,2,1,570,81893,570,0,47.4433,-122.444
906000,3,2.5,2030,1800,2030,0,47.6199,-122.3
330000,3,2,1500,11233,1500,0,47.7279,-121.967
275000,2,1,920,7688,920,0,47.5281,-122.362
290000,3,1,1470,8200,1040,430,47.7347,-122.302
599950,2,1,1150,3775,1150,0,47.6539,-122.329
550000,4,3,4180,35169,4180,0,47.4,-122.027
289000,3,1.75,1690,3449,1690,0,47.4719,-122.191
411000,4,2.75,2150,9915,1240,910,47.5378,-122.17
826000,3,3.25,2330,4000,1730,600,47.5882,-122.295
400000,4,2,2680,13680,2350,330,47.4887,-122.192
342000,3,2.5,1740,2226,1320,420,47.525,-122.366
475000,2,1.75,1320,3420,1080,240,47.6639,-122.399
1.205E+06,4,3.5,3150,5500,3150,0,47.6644,-122.293
455000,4,3,2480,9238,2050,430,47.4701,-122.364
850000,4,3,3330,4000,1790,1540,47.6559,-122.344
185000,3,1,1010,6400,1010,0,47.3027,-122.376
850000,6,3.25,4920,20590,2730,2190,47.5468,-122.267
239900,4,1.75,1570,18730,1200,370,47.3999,-122.301
765000,5,3.75,3580,14275,3190,390,47.5322,-122.056
437000,3,1.75,2220,17568,2220,0,47.749,-122.083
240000,3,1.5,1010,10350,1010,0,47.379,-122.29
395000,2,1,1440,7808,860,580,47.7431,-122.336
320000,3,1,1230,7492,1230,0,47.7633,-122.315
525000,3,1.75,1710,7350,1280,430,47.699,-122.167
260000,3,3,2390,8993,1680,710,47.3532,-122.306
450000,3,2.75,2840,39324,2200,640,47.3076,-122.101
560000,4,2.5,2300,7989,2300,0,47.6273,-122.034
310000,5,3,2270,5001,1360,910,47.5539,-122.3
440000,3,2.5,2290,6302,2290,0,47.435,-122.107
458450,4,1,1330,9715,970,360,47.6038,-122.122
200000,3,1,1200,10703,1200,0,47.5209,-122.28
430000,3,2.25,2160,6527,1580,580,47.7292,-122.212
360000,3,1,1120,10500,1120,0,47.7267,-122.226
311000,4,2.5,2090,11645,1200,890,47.4759,-122.299
615000,3,3.25,1470,1152,1470,0,47.6516,-122.337
575000,3,1.75,2270,10136,2270,0,47.535,-122.056
2.027E+06,4,3.75,4100,22798,2540,1560,47.5648,-122.21
430000,3,1.75,1440,4025,720,720,47.567,-122.38
400000,3,1.5,1200,4800,1200,0,47.6084,-122.136
340000,3,1.75,1720,10710,860,860,47.5092,-122.362
351000,1,0.75,930,6600,930,0,47.7127,-122.296
440000,4,2.5,2400,8038,2400,0,47.4881,-122.143
298000,4,2.5,1960,11798,1960,0,47.3293,-122.205
300000,4,1.75,1890,9205,1260,630,47.774,-122.348
310000,3,2.25,1590,3056,1590,0,47.5432,-122.293
500000,4,2.5,2590,9354,2590,0,47.7703,-122.193
399900,3,1,860,1664,860,0,47.6761,-122.384
343000,3,2.5,1270,2509,1270,0,47.5357,-122.365
415000,2,2.25,1130,2191,1130,0,47.6861,-122.103
410000,3,2.5,1860,15457,1860,0,47.7383,-121.955
320000,2,1,1802,11225,1802,0,47.7205,-122.323
1.99E+06,5,3,4480,5000,3420,1060,47.6275,-122.315
253000,2,1,1310,7128,940,370,47.3958,-122.189
630000,3,2.5,2320,32772,2320,0,47.6304,-121.988
216000,2,1,1130,12500,1130,0,47.4514,-122.187
540000,3,2.5,2180,11100,1230,950,47.717,-122.101
212000,3,1.5,1830,12233,1830,0,47.2057,-122.003
300000,3,2.75,2340,12282,1470,870,47.7379,-122.289
969950,3,2.5,2830,3750,2830,0,47.6798,-122.385
715000,3,1,1610,7680,900,710,47.6038,-122.303
1.32162E+06,5,2.75,2410,19447,2290,120,47.5549,-122.211
1.444E+06,4,2.75,2660,9547,1930,730,47.616,-122.218
305000,3,1,1030,5350,1030,0,47.4905,-122.206
458000,3,4,1390,1569,1150,240,47.671,-122.269
275000,3,1.75,1580,8775,1220,360,47.4845,-122.335
550000,3,2.75,2330,4780,1730,600,47.3459,-122.326
742000,3,3.25,1540,704,1540,0,47.6177,-122.308
700000,3,1,1570,4000,1570,0,47.6575,-122.346
640000,4,3,2940,5763,1640,1300,47.5589,-122.295
352000,3,0.75,1240,7200,1240,0,47.7298,-122.342
301500,3,1,1410,7419,1050,360,47.534,-122.173
630000,4,2.5,2190,9880,1410,780,47.6926,-122.186
340000,3,2.5,3040,6255,3040,0,47.3817,-122.206
477500,4,1.75,1860,9364,1080,780,47.731,-122.301
285000,3,2.5,1690,7460,870,820,47.4964,-122.353
255000,3,2.75,1900,16117,1900,0,47.3144,-122.278
315000,3,2.5,1600,7982,1600,0,47.3397,-122.266
830000,6,3,2530,9000,2530,0,47.6716,-122.199
539950,3,2.25,1860,1558,1860,0,47.7006,-122.339
980000,3,2.25,2390,4590,2090,300,47.6615,-122.276
735000,4,2.5,3100,8529,3100,0,47.6252,-122.029
536000,5,2.25,2650,9140,1350,1300,47.7772,-122.387
575000,3,2,1520,5000,1140,380,47.6733,-122.389
500000,2,1,1510,4000,930,580,47.6917,-122.38
285500,4,1.75,1960,7950,1960,0,47.3109,-122.377
498000,4,2.75,2270,7375,1290,980,47.7222,-122.168
412000,2,1,910,6282,910,0,47.6967,-122.354
607000,4,2.5,2100,8220,1300,800,47.6733,-122.145
199000,3,1,1000,8512,1000,0,47.2151,-121.993
492500,4,2.75,2760,18306,1630,1130,47.7302,-122.215
585000,4,2.5,2840,11044,2840,0,47.7134,-122.237
326995,3,2.5,1860,5321,1860,0,47.3848,-122.033
372500,4,2.25,1920,9660,1920,0,47.4544,-122.143
528000,2,0.75,840,40642,840,0,47.404,-122.447
400000,3,1.5,2390,32109,2390,0,47.3028,-122.102
344000,4,2.5,2100,8501,2100,0,47.1951,-122.01
409950,4,3,2430,7163,2430,0,47.3558,-122.013
625000,3,2,1880,4000,1280,600,47.6375,-122.391
304950,3,1.75,1350,9000,1350,0,47.4487,-121.773
381500,2,2,2160,35183,2160,0,47.312,-122.115
215000,3,1.75,1430,13399,900,530,47.4787,-122.275
345000,5,1.75,2840,12870,2840,0,47.4961,-122.235
363000,3,0.75,2510,20000,2510,0,47.2871,-122.287
240000,3,1,1690,20063,1690,0,47.3556,-122.294
548050,2,2,1930,5479,1930,0,47.7054,-122.011
314000,2,1,720,4920,720,0,47.5352,-122.371
800000,4,2.5,2990,16809,2990,0,47.7123,-122.073
400000,5,1.75,2300,6720,2300,0,47.528,-122.32
247000,1,1,460,4120,460,0,47.4868,-122.199
540000,2,1.75,1240,4120,890,350,47.6689,-122.314
410000,4,2.5,1900,15123,1900,0,47.5015,-121.772
525000,3,1.75,2120,9146,1260,860,47.6475,-122.064
820000,4,2.5,2440,5737,1700,740,47.6472,-122.367
1.25E+06,4,2.25,3300,15375,2820,480,47.526,-122.225
244000,2,1,1180,10200,1180,0,47.4358,-122.336
275000,1,1,520,4800,520,0,47.5533,-122.363
577000,2,1.75,2070,23160,1260,810,47.6551,-122.394
446950,5,2.5,2250,7945,1360,890,47.7316,-122.221
457000,3,2.5,2050,5694,2050,0,47.5331,-121.855
320000,4,1.5,1310,137214,1310,0,47.362,-122.316
210000,3,1.5,1250,9484,1250,0,47.3675,-122.147
220000,4,2.5,2130,9100,1290,840,47.3815,-122.169
589000,3,2,2250,8800,1250,1000,47.5737,-122.409
435000,4,2,1880,3840,970,910,47.5929,-122.303
375000,3,1,1520,10798,1520,0,47.7635,-122.262
1.735E+06,4,3.5,4010,9654,4010,0,47.5891,-122.2
545000,2,1.75,1660,5581,1660,0,47.713,-122.033
970000,3,2.25,3400,10000,3400,0,47.6846,-122.284
705000,2,1.75,2320,6755,1380,940,47.6398,-122.403
915557,5,3.25,3740,11536,2540,1200,47.5599,-122.108
259000,4,1.5,1810,9000,1810,0,47.4911,-122.322
1.695E+06,2,2.25,3170,3000,1990,1180,47.6291,-122.351
427000,3,1.75,1680,8610,1290,390,47.7246,-122.173
390000,2,1,930,3100,930,0,47.5943,-122.302
363000,3,2.5,2390,8000,2390,0,47.3895,-122.154
612000,4,2.5,2680,3626,1680,1000,47.6727,-122.361
380000,4,1.75,1790,10186,1790,0,47.7769,-122.376
230000,4,3,1680,6003,1150,530,47.2885,-122.218
580000,3,1.75,1570,2600,1570,0,47.6867,-122.37
770000,3,1,2230,3200,1630,600,47.6334,-122.356
207200,4,2,1260,8400,1260,0,47.1946,-122
525000,3,2,1790,11430,1190,600,47.6319,-122.035
925000,3,2.5,2440,7419,1520,920,47.6857,-122.334
883000,4,2.25,2410,4000,1650,760,47.6727,-122.316
455000,4,2.5,1780,2992,1780,0,47.7633,-122.149
343500,3,2.5,1900,5194,1900,0,47.4391,-122.117
244000,2,1,960,8450,960,0,47.755,-122.316
397000,3,1.75,1640,11730,1640,0,47.7351,-122.189
180500,2,1,850,5000,850,0,47.3817,-122.314
310000,3,2.75,2150,6576,1900,250,47.7539,-122.308
315000,4,2.5,2780,3969,2780,0,47.3992,-122.164
718000,3,1,1030,4958,1030,0,47.6647,-122.277
279950,3,1.75,1930,7267,1330,600,47.3217,-122.205
689000,3,2.5,2080,9612,1700,380,47.7293,-122.283
828000,4,2.5,3520,9901,3520,0,47.6084,-122.011
150000,2,1,890,8100,890,0,47.4839,-122.34
505400,3,1.75,1640,3400,930,710,47.6694,-122.3
1.68E+06,5,3.25,4860,23723,3820,1040,47.5767,-122.215
217450,3,1,1040,5000,1040,0,47.5122,-122.358
677000,4,2.5,2820,4174,2820,0,47.7112,-122.226
361000,2,2.5,1320,48787,1320,0,47.5157,-121.924
620000,3,2.5,2590,7237,2590,0,47.7113,-122.309
176000,3,2.25,1540,5449,1180,360,47.29,-122.358
330000,3,1,960,7218,960,0,47.7278,-122.226
290000,3,2.5,1190,8175,1190,0,47.4556,-122.203
711000,4,2.5,2770,9532,2770,0,47.5688,-122.012
295000,3,1.75,1060,8100,1060,0,47.3617,-122.047
1.0965E+06,5,3.25,4010,12110,4010,0,47.5228,-122.151
257500,3,2,1140,7078,1140,0,47.4057,-122.185
240000,4,1,1910,16320,1910,0,47.5151,-122.366
645000,4,2.5,2340,8955,2340,0,47.6283,-122.026
499000,2,1.75,1170,2400,740,430,47.6653,-122.333
321000,3,1,1290,9526,1290,0,47.7111,-122.213
449000,3,2.5,1810,1658,1810,0,47.6955,-122.376
515000,3,2.5,1820,5280,910,910,47.6892,-122.375
456000,4,1.5,2220,12385,1270,950,47.6734,-122.185
865000,3,3.75,3830,219106,3830,0,47.5432,-121.952
515500,4,2.5,2920,7700,2920,0,47.7351,-121.975
576925,4,2.5,2630,6100,2630,0,47.7735,-122.167
243000,3,1.75,1320,10416,1320,0,47.3902,-122.208
253400,3,2,1400,8640,1400,0,47.3182,-122.319
292000,3,2.5,1600,3580,1600,0,47.4939,-122.261
271500,3,2.5,1490,8005,1090,400,47.4359,-122.165
765000,2,2.5,2170,6750,2170,0,47.7115,-122.014
375000,3,3.25,1280,1730,1090,190,47.7032,-122.36
382880,3,2,1620,9566,1620,0,47.474,-122.146
852500,3,2.5,2630,10100,1580,1050,47.5638,-122.153
475000,3,1.5,1240,8738,1240,0,47.5849,-122.17
462000,3,1.75,1300,2580,820,480,47.674,-122.319
762400,3,1.75,2430,14607,1230,1200,47.5588,-122.211
330000,4,1.5,1890,7540,1890,0,47.7534,-122.318
473000,3,2.25,1890,12236,1890,0,47.6232,-122.047
550000,3,1.5,2440,7200,2440,0,47.5604,-122.274
449500,3,2.25,1780,7280,1340,440,47.723,-122.215
744000,4,2.75,2830,13059,2830,0,47.595,-121.986
700000,4,2,2490,4700,1690,800,47.5254,-122.392
511100,4,2.5,1560,12220,1560,0,47.5287,-122.053
317950,3,2.5,1980,4500,1980,0,47.3671,-122.113
542950,3,2.5,2070,39768,2070,0,47.7696,-122.036
490000,3,1.75,1490,11360,1490,0,47.5896,-122.12
760000,4,3.5,3090,4060,2420,670,47.5733,-122.287
475000,3,2.25,1580,8659,1220,360,47.7599,-122.215
1.7025E+06,5,4.5,5190,23716,3390,1800,47.5846,-122.223
435000,3,2.75,2692,6197,2692,0,47.3569,-122.202
399000,3,2.5,1740,3690,1740,0,47.5345,-121.867
627000,3,2,1940,3800,1050,890,47.6842,-122.309
346500,4,2.5,2150,5100,1290,860,47.5338,-122.36
412000,3,1.5,1320,8000,1320,0,47.6027,-122.122
845000,4,2.5,3360,40471,3360,0,47.742,-122.035
373000,3,1.75,1850,9655,1100,750,47.7358,-122.319
725000,4,2.25,2880,8882,2480,400,47.6999,-122.284
376000,6,2.5,2420,11662,1420,1000,47.4459,-122.278
552500,3,1,2020,4120,1520,500,47.5514,-122.271
365000,5,2,2280,19000,2280,0,47.4683,-122.359
700000,4,2.5,3010,46173,3010,0,47.6471,-121.964
315000,4,2.25,2550,9736,2550,0,47.3193,-122.212
262500,4,2,1540,5110,1540,0,47.5164,-122.268
660000,3,2.25,2280,6150,2280,0,47.5423,-122.385
340000,4,2.5,2450,6941,2450,0,47.4006,-122.162
660500,5,2.5,2950,5500,1720,1230,47.5785,-122.293
280000,1,1,690,1950,690,0,47.6849,-122.374
267000,1,1,800,2480,800,0,47.5581,-122.316
230000,2,1,1470,25661,1470,0,47.4878,-122.13
417000,3,2.25,1840,11403,1840,0,47.4862,-121.797
252000,3,1,1170,9730,1170,0,47.4562,-122.196
791000,5,1.75,2344,4800,1544,800,47.6537,-122.335
415000,1,1,1230,3774,830,400,47.6886,-122.354
339000,3,1.75,1150,13278,1150,0,47.6384,-121.969
158000,3,1,1140,10477,1140,0,47.4874,-122.306
535000,3,1,1660,5100,1260,400,47.5323,-122.383
818900,3,1,1080,4120,980,100,47.6771,-122.319
550000,4,2,1720,4000,1420,300,47.6651,-122.285
240000,2,1,590,8717,590,0,47.7343,-122.335
590000,3,3.25,1290,1230,1090,200,47.6367,-122.37
369300,3,1.5,1480,21320,1480,0,47.5234,-122.043
510000,4,2.5,2600,118666,1400,1200,47.54,-121.97
542500,3,2.5,2040,10086,2040,0,47.679,-122.113
262500,3,1,970,7854,970,0,47.4899,-122.185
900000,6,3,2620,4350,1760,860,47.678,-122.373
1.1E+06,4,3.5,4560,41636,4170,390,47.5589,-122.116
368000,3,1.75,1750,14400,1750,0,47.4535,-122.361
825000,4,3.5,3620,6499,3620,0,47.7326,-122.36
343500,3,2,1660,7509,1660,0,47.4872,-122.144
273500,4,1,1360,6000,1020,340,47.4783,-122.285
1E+06,3,2.5,2044,5610,2044,0,47.6791,-122.209
770000,5,3,2370,6000,1340,1030,47.6645,-122.358
400000,3,2,1170,3868,1170,0,47.5543,-122.29
225000,3,1,1660,7210,1100,560,47.3394,-122.281
345000,4,1,2020,18150,2020,0,47.739,-122.249
450000,3,2.5,2530,8116,2530,0,47.7597,-122.167
334850,2,1,870,5635,870,0,47.5676,-122.398
605000,5,3,3670,9600,1980,1690,47.5648,-122.316
760000,5,3.5,3180,14000,3180,0,47.5501,-122.128
390000,2,1.5,1870,12960,1350,520,47.5234,-122.288
488000,3,2.5,1940,5660,1940,0,47.7511,-122.17
3.3E+06,3,3.25,4220,41300,2460,1760,47.6083,-122.11
1.063E+06,5,4.5,4820,13165,3950,870,47.7295,-122.057
608000,3,2,2400,217800,1590,810,47.4166,-121.94
1.385E+06,3,2.25,2930,6000,1920,1010,47.6301,-122.301
299950,2,1,800,3000,800,0,47.5602,-122.292
818000,3,3.25,2200,4800,1910,290,47.6551,-122.353
355000,3,2.5,2400,9701,2400,0,47.3081,-122.392
1.855E+06,5,3.25,5570,9600,3860,1710,47.6708,-122.262
660000,3,3.25,1980,2850,1980,0,47.6597,-122.331
2.367E+06,3,2.25,3530,17450,1840,1690,47.5358,-122.213
1.211E+06,4,2.5,3430,35120,3430,0,47.6484,-122.182
255950,3,2.5,1720,3676,1720,0,47.4039,-122.188
475000,3,1.5,1930,11092,1500,430,47.634,-122.033
362950,4,1.75,2140,159865,1140,1000,47.4235,-122.218
452000,3,1.75,1110,9012,1110,0,47.6563,-122.131
315000,3,1.75,1970,8200,1270,700,47.4731,-122.327
330950,3,2.5,1630,2844,1630,0,47.5413,-122.288
535000,5,2.25,2520,49222,2520,0,47.4918,-122.064
479000,4,2.25,2270,9464,1520,750,47.5007,-122.359
340000,3,2.5,1212,1174,1212,0,47.7145,-122.311
312000,4,2,1890,8362,1890,0,47.4377,-122.279
305000,3,2.25,1370,6600,1370,0,47.3504,-122.035
270000,3,2.5,1770,7336,1770,0,47.3639,-122.185
529999,3,2.5,1710,1664,1300,410,47.6456,-122.383
587100,2,1,1190,6967,1190,0,47.5896,-122.243
459800,3,2,1690,16061,1690,0,47.6359,-122.035
451000,4,1.75,1680,7800,1330,350,47.6286,-122.118
2.475E+06,3,3.25,4340,4947,3060,1280,47.6709,-122.406
525000,3,2.25,2040,435600,2040,0,47.2328,-121.945
250000,2,1,1110,26051,1110,0,47.4711,-122.291
475000,5,2,2040,6180,2040,0,47.5503,-122.28
235000,4,1.5,1920,11595,1920,0,47.2858,-122.212
230000,3,1.5,1330,9548,1330,0,47.3675,-122.11
581000,4,1,1630,2566,1630,0,47.6183,-122.3
415000,3,1,1520,9030,1520,0,47.587,-122.134
522500,3,1,1520,9030,1520,0,47.587,-122.134
383000,3,1.5,1340,7725,1340,0,47.5389,-122.173
315000,3,1.75,2500,8289,1250,1250,47.4973,-122.177
591000,3,2,1460,3600,1460,0,47.6123,-122.314
750000,4,2.25,3140,12150,3140,0,47.6361,-122.047
430000,3,1.75,2150,4333,1200,950,47.5537,-122.388
712000,4,2.5,3140,32336,3140,0,47.7412,-122.087
510000,3,2.5,2310,53578,1340,970,47.7677,-122.135
480000,2,1,710,4800,710,0,47.6212,-122.298
538000,3,1,1460,7200,1260,200,47.6875,-122.336
464000,2,2.75,730,5000,730,0,47.5381,-122.374
476000,3,2.5,1440,3840,1440,0,47.6873,-122.043
349500,3,2,1130,16875,1130,0,47.7489,-122.3
270000,3,2.25,1810,8262,1810,0,47.2994,-122.37
740000,3,2.5,2710,18480,2000,710,47.7256,-122.259
395000,4,2.5,2740,8336,2740,0,47.3904,-122.176
498000,3,2.5,1690,4088,1690,0,47.6779,-122.034
339900,3,2.5,1470,4675,1470,0,47.5261,-121.827
539000,3,2.5,2830,9972,2830,0,47.7382,-121.975
400000,3,1,1410,9704,1140,270,47.6203,-122.036
225000,3,2.5,2170,11745,1410,760,47.4342,-122.17
330000,3,2.25,1340,4080,1170,170,47.5722,-122.291
1.3878E+06,3,3,2480,5500,1730,750,47.6466,-122.404
490000,3,2.75,1990,31200,1990,0,47.5544,-122.035
260000,4,2.75,2240,7200,1140,1100,47.3357,-122.275
469900,4,2.5,2990,8913,2990,0,47.4353,-122.159
493000,6,1.75,2120,3801,1220,900,47.6832,-122.311
740000,4,2.25,2920,46355,2920,0,47.569,-121.962
148900,4,1.75,1700,6000,1700,0,47.3252,-122.208
475000,2,2.5,1620,14467,1620,0,47.6306,-122.035
415000,2,1,760,4000,760,0,47.6896,-122.396
229500,3,1,1230,6000,1230,0,47.3256,-122.209
1.355E+06,5,3.75,4960,13990,3760,1200,47.5491,-122.137
385000,4,2.5,2030,11375,1330,700,47.7765,-122.261
230000,3,2.25,1830,11331,1250,580,47.2899,-122.287
425000,2,1,970,2700,770,200,47.6852,-122.312
189900,2,1,1000,4179,1000,0,47.297,-122.227
238000,2,1,750,6480,750,0,47.5195,-122.35
968060,4,2.5,2620,16200,1570,1050,47.6623,-122.196
921000,4,1.5,2220,9496,1490,730,47.6233,-122.206
380000,5,1.75,3000,6000,1500,1500,47.492,-122.225
285000,1,1,1060,54846,1060,0,47.4716,-122.445
449000,4,2.5,1980,5400,1980,0,47.5182,-122.207
625000,4,1,1600,5500,1600,0,47.6983,-122.393
318989,4,2.25,2000,9000,2000,0,47.3125,-122.387
445000,3,1.5,1310,1266,1120,190,47.5663,-122.408
750000,3,1,1120,8549,1120,0,47.6294,-122.205
959000,3,2.5,3320,11875,3320,0,47.7212,-122.26
330000,3,2.5,2370,9102,2370,0,47.3067,-122.394
425000,2,1.5,830,1241,830,0,47.6363,-122.368
280000,3,1,940,7913,940,0,47.7657,-122.321
476500,4,2.5,2250,50155,2250,0,47.449,-121.756
556000,3,2.25,2020,3600,2020,0,47.6678,-122.165
1.862E+06,4,5.25,5240,320917,5240,0,47.5605,-121.905
637000,4,3.5,4083,68377,4083,0,47.3114,-122.262
405000,3,2,1450,6081,1450,0,47.7522,-122.278
397000,5,1,1170,6757,800,370,47.7332,-122.304
895990,4,2.75,3555,6565,3555,0,47.6847,-122.017
259000,3,2,1610,14046,1610,0,47.7704,-122.264
420000,2,1,960,112384,960,0,47.7642,-122.234
518000,3,2.5,1680,2096,1380,300,47.6904,-122.37
425000,3,1.75,1380,8182,1380,0,47.7513,-122.349
182500,2,1,1040,13920,1040,0,47.3756,-122.306
549900,3,1.5,1380,3031,1380,0,47.6889,-122.38
445000,3,1.75,1850,16863,1280,570,47.7166,-122.225
452000,2,1.75,1740,5400,990,750,47.6971,-122.282
715000,5,1.75,1920,6500,1260,660,47.6394,-122.308
559000,3,2.5,2010,5200,2010,0,47.7142,-122.203
3.3E+06,5,6.25,8020,21738,8020,0,47.5675,-122.189
250000,4,1.75,1860,7350,1090,770,47.3979,-122.174
1.23E+06,5,4,4390,6656,2930,1460,47.648,-122.397
276500,4,2.25,2380,128937,2380,0,47.4253,-122.043
440000,4,2.5,2880,7386,2880,0,47.4397,-122.15
543200,6,2.25,2820,15600,1970,850,47.4635,-122.362
250000,1,1,750,4000,750,0,47.5243,-122.39
625000,4,2.5,1750,9000,1410,340,47.6403,-122.105
530100,3,1,1540,3399,1200,340,47.6853,-122.359
549900,2,1.75,1140,936,940,200,47.6647,-122.284
430000,4,1.5,1560,6534,1560,0,47.6012,-122.152
835000,3,2.5,2960,6856,2960,0,47.5906,-122.057
409500,4,2.75,2140,13000,1320,820,47.7683,-122.252
329000,4,2.5,1600,6765,830,770,47.5469,-122.365
940000,4,2.75,2080,4000,2080,0,47.6737,-122.358
539950,3,2,1560,3200,1560,0,47.6398,-122.356
579950,4,2.5,2880,213444,2140,740,47.2887,-122.109
881000,5,3,2510,4125,1590,920,47.5968,-122.29
362500,3,1,960,5424,960,0,47.6997,-122.32
243950,2,1,1120,35500,1120,0,47.2411,-122.043
658000,4,2.75,3310,6166,3310,0,47.521,-121.877
218250,3,1.5,1080,9774,1080,0,47.3155,-122.401
655000,4,2.5,2860,12394,2860,0,47.5832,-122.026
255000,3,2,1490,7599,1490,0,47.3687,-122.088
215000,3,1,1210,7175,1210,0,47.5339,-122.356
1.265E+06,3,1.75,2240,5657,1910,330,47.6621,-122.27
2.92E+06,4,4.75,4575,24085,3905,670,47.6263,-122.284
424305,3,2.5,1600,5960,1600,0,47.4758,-122.265
494000,4,1.75,2090,4300,1250,840,47.5555,-122.397
560000,4,2.5,2260,3713,2260,0,47.7247,-122.165
130000,3,1,1200,7000,1200,0,47.5883,-122.384
468000,4,2.5,2480,176418,2480,0,47.1941,-122.038
480000,5,3,2240,15435,1390,850,47.7426,-122.288
475000,3,1.75,1550,4054,1550,0,47.6743,-122.301
285000,4,1.75,2130,8151,1330,800,47.3932,-122.201
765000,5,3,2870,5700,1950,920,47.6621,-122.33
208000,2,1,1160,5750,1160,0,47.5322,-121.829
372000,3,2.5,2430,5000,2430,0,47.3786,-122.127
470000,2,1,900,5512,900,0,47.6877,-122.289
451000,5,2.75,2830,8925,2830,0,47.731,-122.179
442200,4,1.75,1620,8132,1620,0,47.6788,-122.11
330000,4,2.5,2510,8580,2510,0,47.295,-122.37
335000,3,1.75,1790,5120,940,850,47.5277,-122.355
280000,3,2,1640,13249,1640,0,47.3589,-122.281
625000,3,1.75,2240,6050,1250,990,47.5658,-122.4
345000,3,2.5,1870,3584,1870,0,47.4521,-122.121
255950,4,1,1500,11050,1500,0,47.4509,-122.088
570000,4,1,1490,6000,1490,0,47.5518,-122.385
685000,3,1.5,2230,8558,2230,0,47.5833,-122.219
273148,3,1.75,1710,7210,1240,470,47.4094,-122.175
246500,3,2.5,1620,7686,1620,0,47.3613,-122.053
349950,5,2.5,2250,7176,1310,940,47.4486,-122.194
545000,4,2,1700,2350,850,850,47.6865,-122.366
403000,3,2.5,1502,1400,1502,0,47.6951,-122.305
299950,4,2.5,1900,4054,1900,0,47.3767,-122.124
792000,3,2.5,3320,12840,2600,720,47.5783,-121.994
418000,5,2.5,1980,10205,1080,900,47.699,-122.307
332500,4,1,1670,8102,1670,0,47.4692,-122.355
337000,3,2.5,2235,43560,990,1245,47.3326,-122.046
212000,2,1,1070,7386,1070,0,47.5434,-122.298
542000,2,2.25,1800,2819,1800,0,47.6104,-122.113
622500,4,2.5,2980,8107,2980,0,47.5389,-121.876
260000,3,1.75,1670,8511,1340,330,47.3257,-122.276
525000,3,1.75,2620,38350,1320,1300,47.4619,-121.991
975000,5,3.5,5470,35071,4590,880,47.6368,-122.159
1.14E+06,4,1.75,3080,6500,1700,1380,47.6353,-122.402
500000,3,1,940,10360,940,0,47.688,-122.19
554000,5,2.25,1870,11411,1170,700,47.7445,-122.289
343000,4,2.5,2070,4500,2070,0,47.3497,-122.026
515000,2,1.75,950,15219,950,0,47.7723,-122.262
492000,2,1,1290,6272,890,400,47.6777,-122.305
655000,4,3,2570,8022,1370,1200,47.6956,-122.099
290000,3,2.5,1600,6848,1600,0,47.3303,-122.271
952500,4,1.5,2550,5055,2550,0,47.636,-122.301
235000,2,1,1010,7500,1010,0,47.5283,-122.32
323000,3,1.5,1720,7110,1720,0,47.5417,-122.355
1.05E+06,3,2.5,2200,1970,1610,590,47.6426,-122.327
265000,0,0.75,384,213444,384,0,47.4177,-122.491
200000,2,1,1400,9600,1400,0,47.2113,-121.993
419995,3,2.25,1830,7500,1330,500,47.7574,-122.31
1.5E+06,3,3,3110,9015,1590,1520,47.6624,-122.202
455000,3,2.5,1600,7829,1600,0,47.7288,-122.227
660000,3,3.5,3600,37982,3600,0,47.6982,-121.917
319000,3,1,1390,12823,1390,0,47.7438,-122.075
390000,3,1.75,2092,250905,2092,0,47.2664,-122.027
718500,3,1.5,1200,6240,1030,170,47.6222,-122.287
474000,2,1,1090,3160,840,250,47.6385,-122.344
615750,4,2,2140,6360,1840,300,47.687,-122.286
551000,3,2.5,2010,17362,2010,0,47.6904,-122.176
230000,3,2.25,1500,7210,1150,350,47.3124,-122.352
790000,4,2.5,3500,9198,3500,0,47.6785,-122.025
1.23E+06,3,2.5,2660,1967,1870,790,47.6264,-122.363
325000,3,2.25,1440,6443,1440,0,47.7471,-121.979
705000,4,2.75,2780,6207,2780,0,47.6867,-122.038
259000,4,1.75,1580,8856,1580,0,47.4694,-121.745
306000,3,1.5,1250,8700,1250,0,47.4744,-122.328
315000,3,1,970,6828,970,0,47.5476,-122.36
392500,3,1,1100,7650,1100,0,47.7219,-122.354
1.065E+06,4,2.25,3240,12930,2730,510,47.5373,-122.22
350500,2,2.5,1290,1445,1290,0,47.6955,-122.376
825000,4,3.5,3810,9792,3810,0,47.5018,-122.38
235000,4,1,1500,6360,1500,0,47.4979,-122.24
650000,3,2,2660,257875,1530,1130,47.553,-121.887
675000,4,3,2400,3340,1200,1200,47.6646,-122.365
265000,4,1,1860,8505,1860,0,47.4406,-122.194
822500,2,1,1450,7098,1450,0,47.63,-122.349
705000,3,2.75,2260,4000,1540,720,47.6435,-122.353
2.63E+06,6,4.75,5540,7200,3950,1590,47.6361,-122.366
685000,2,1.5,1300,1676,1300,0,47.6133,-122.308
630000,4,2,1610,5000,1610,0,47.6775,-122.398
1.25E+06,4,3.25,3820,24166,3310,510,47.5263,-122.227
359000,4,2.5,1820,11325,1390,430,47.4574,-122.361
784500,4,5,5820,13906,3750,2070,47.3814,-122.164
850000,3,2,2470,8800,2470,0,47.5753,-122.222
410000,3,2.5,3040,6054,3040,0,47.3508,-122.163
252000,4,1.75,1120,8250,1120,0,47.4555,-122.177
618000,5,1.75,1880,18295,1880,0,47.6059,-122.154
265000,3,1,1070,4800,970,100,47.5187,-122.377
465000,3,2,1560,8509,790,770,47.7261,-122.22
240000,2,1,870,6552,870,0,47.7188,-122.353
217000,3,1,1000,12000,1000,0,47.3321,-122.346
415000,4,2.25,2520,4200,1510,1010,47.5814,-122.312
274000,2,2,1700,7992,950,750,47.3031,-122.385
420000,5,3,2150,6117,1370,780,47.538,-122.356
1.0625E+06,4,2.75,1590,6000,1590,0,47.6401,-122.299
1.415E+06,4,5.25,4670,43950,4670,0,47.5456,-122.126
618500,3,2,1800,5000,1080,720,47.6738,-122.297
295000,3,1.5,1670,10800,1670,0,47.2004,-122.003
400000,3,2,1010,12252,1010,0,47.6224,-122.045
595000,3,2.5,2550,6677,2550,0,47.7336,-122.232
1.728E+06,4,3,3700,20570,1850,1850,47.6212,-122.224
261000,3,1.75,1350,7686,1350,0,47.3617,-122.052
780000,5,2.5,1660,4000,1660,0,47.6452,-122.352
589000,3,1.5,1390,5040,1090,300,47.6611,-122.282
230000,3,1.75,1720,9125,1140,580,47.3173,-122.181
690000,4,3.5,2980,2147,2490,490,47.5463,-121.995
524000,4,2.25,2190,15491,2190,0,47.6299,-122.039
380000,2,2.5,1230,987,1060,170,47.6007,-122.305
357500,3,1,1000,4080,740,260,47.5351,-122.381
330000,3,2,2500,10697,2500,0,47.1927,-122.01
635000,5,1.75,2240,4750,1120,1120,47.6727,-122.293
934000,9,3,2820,4480,1880,940,47.6654,-122.307
358500,2,1.75,1400,865,1110,290,47.5478,-121.999
401000,3,1.5,1470,6867,1470,0,47.7495,-122.327
270000,3,2,1820,7750,1820,0,47.3169,-122.352
705000,4,2,2060,6000,1370,690,47.5237,-122.383
325000,3,2,1670,17071,1100,570,47.69,-121.913
384950,3,1,1540,7740,1540,0,47.522,-122.375
310000,3,1,1210,9730,1210,0,47.762,-122.355
829950,4,2.5,3430,42775,3430,0,47.765,-122.045
353000,3,2.5,2550,6021,2550,0,47.3828,-122.211
170500,2,1,1060,7700,820,240,47.4599,-122.205
885250,4,2.5,3670,49658,3670,0,47.6219,-122.015
2.7E+06,4,3.25,4420,7850,3150,1270,47.572,-122.102
245000,3,1.5,1550,9126,1550,0,47.2012,-122
469000,3,2.5,1190,1290,1190,0,47.6762,-122.378
455000,3,1,1300,3550,1300,0,47.6696,-122.32
305000,4,2.5,2430,5959,2430,0,47.3348,-122.19
840000,7,4.5,4290,37607,4290,0,47.4812,-122.033
905000,5,3.5,3500,10155,2570,930,47.5415,-122.133
219200,3,2,1680,7000,1680,0,47.2775,-122.203
455000,3,1.5,1250,8004,1250,0,47.6285,-122.117
195000,2,1,1020,8100,1020,0,47.4971,-122.334
799000,3,1,1510,4178,1510,0,47.6849,-122.335
285000,2,1,910,8155,910,0,47.7399,-122.3
300000,3,1.5,1320,15053,1320,0,47.7405,-122.095
83000,2,1,900,8580,900,0,47.4727,-122.27
220000,2,1,890,4804,890,0,47.7027,-122.346
174500,2,2.5,1240,2689,1240,0,47.3236,-122.323
695000,4,2.5,2960,10760,2960,0,47.5677,-122.013
255000,3,1.5,1020,11410,1020,0,47.4811,-122.162
539000,5,2.25,2590,7245,1510,1080,47.6398,-122.111
552700,2,1,1100,2800,1100,0,47.6361,-122.371
571500,3,1,1300,6710,1300,0,47.5851,-122.242
263700,3,1,1200,6561,1200,0,47.7763,-122.36
3.3E+06,8,4,7710,11750,6090,1620,47.6263,-122.314
186950,2,2,1390,1302,1390,0,47.3089,-122.33
520000,3,1.75,1430,53628,1430,0,47.5577,-121.891
358000,3,1.5,1250,7194,1250,0,47.7298,-122.231
210000,2,0.75,840,49658,840,0,47.4727,-122.292
3.65E+06,5,3.75,5020,8694,3970,1050,47.6146,-122.213
543000,4,2.25,2060,8767,2060,0,47.7228,-122.103
330000,4,2.25,2000,10679,1350,650,47.4238,-122.329
529000,3,2,1530,3400,990,540,47.6204,-122.296
295000,1,1,700,2500,700,0,47.5662,-122.364
365000,3,1,950,8450,950,0,47.6884,-122.186
473000,3,3,1380,1081,1380,0,47.6692,-122.39
403500,3,1,1830,8004,1200,630,47.7259,-122.297
544000,3,1.5,1790,8203,1790,0,47.5768,-122.403
621000,3,1,1340,4000,1340,0,47.6652,-122.288
672600,3,2.25,1520,5750,1400,120,47.5787,-122.388
689800,2,1.75,1370,3125,1090,280,47.6492,-122.391
613000,3,1.5,1470,4480,1130,340,47.6693,-122.291
808000,4,2.25,2500,8866,2500,0,47.6604,-122.146
301000,3,1,1060,9241,1060,0,47.7465,-122.339
340000,3,1.75,1210,9635,1210,0,47.7382,-121.98
206000,3,1,920,8400,920,0,47.3771,-122.287
550000,3,1.5,1340,6000,1340,0,47.5866,-122.25
325000,2,1,960,4800,960,0,47.5752,-122.411
475000,3,2.5,1630,7586,1630,0,47.5689,-122.023
432100,3,1.75,1840,7350,1310,530,47.7089,-122.23
359000,3,2,3085,7280,1560,1525,47.4956,-122.181
490000,3,1,920,4800,780,140,47.6937,-122.362
648360,4,1.75,2260,7005,1130,1130,47.6895,-122.207
340000,3,1.75,1730,11986,1730,0,47.3595,-122.323
545000,3,2,1610,8069,1090,520,47.5754,-122.15
115000,2,0.75,550,7980,550,0,47.511,-122.348
705640,3,2.25,2400,12350,1420,980,47.6533,-122.192
300000,3,2.25,1960,1585,1750,210,47.5414,-122.288
1.65E+06,4,2.75,3190,14904,1940,1250,47.6178,-122.214
1.1375E+06,4,3.5,3160,4200,2180,980,47.5963,-122.292
280000,3,1.75,1550,7410,1550,0,47.4951,-122.237
245000,4,1.75,1930,7650,1280,650,47.3078,-122.386
564000,4,1,1170,4590,1170,0,47.6804,-122.311
849000,3,1.75,2520,4534,1460,1060,47.6381,-122.401
698000,3,1.75,1220,7447,1220,0,47.6886,-122.211
319000,3,1,960,8556,960,0,47.7245,-122.22
1.45E+06,3,3.5,4110,15720,2230,1880,47.6996,-122.229
695000,4,3.5,3310,21050,2400,910,47.5197,-122.041
680000,4,2.75,2220,5310,1170,1050,47.5801,-122.294
287500,4,2.25,2250,12000,2250,0,47.3715,-122.274
465000,3,3.25,1510,1850,1230,280,47.6683,-122.362
335000,3,1,1350,14212,1350,0,47.6606,-122.06
602000,4,1.75,2420,37800,1880,540,47.6688,-122.024
482000,3,2.5,2950,6545,2950,0,47.4828,-122.139
220000,5,1,1260,8382,1260,0,47.5058,-122.355
206000,4,2,1700,6025,1700,0,47.3029,-122.221
1.1E+06,4,3,3320,5760,2120,1200,47.6474,-122.389
491150,3,2.5,1470,3971,1470,0,47.6816,-122.035
390000,4,2.75,2500,12848,2120,380,47.3364,-122.321
393000,4,2.5,2641,8091,2641,0,47.4043,-122.213
635000,4,2,2260,8457,2260,0,47.6251,-122.03
490000,2,1,1160,5000,1160,0,47.6865,-122.399
770000,4,3.5,3680,2242,2670,1010,47.6192,-122.307
665000,2,2,1615,4590,1615,0,47.6886,-122.348
287000,3,1,1250,26862,1250,0,47.426,-122.154
410000,3,1,1230,7020,1090,140,47.5719,-122.39
562000,3,2,2510,5200,1470,1040,47.5631,-122.366
475000,2,2,1540,54450,1540,0,47.638,-121.953
387500,3,3.25,1860,2218,1860,0,47.7185,-122.313
580000,5,2,2700,10875,1540,1160,47.6163,-122.138
930000,3,2.5,3290,6830,3290,0,47.6702,-122.142
625000,3,1.75,2700,18893,2110,590,47.3397,-122.048
325000,3,2,1570,5600,1570,0,47.4286,-122.185
235000,3,1.75,1950,8712,1950,0,47.4391,-122.189
450000,2,1,1380,4390,880,500,47.6947,-122.323
745000,4,2.75,2410,5650,2070,340,47.5651,-122.391
223000,4,2,1200,8470,1200,0,47.3262,-122.338
630000,4,1.75,1770,12278,1350,420,47.7004,-122.295
413450,3,2.5,1540,1614,1470,70,47.6961,-122.341
720000,5,2.75,2860,5379,2860,0,47.7082,-122.104
339000,3,1.5,1740,21980,1740,0,47.3644,-122.132
1.1155E+06,4,3.5,2830,4000,1840,990,47.5842,-122.292
839000,5,4,4280,11307,2710,1570,47.5503,-122.081
2.95E+06,4,3.25,3890,25470,3030,860,47.6608,-122.269
568000,4,2,2340,50233,1170,1170,47.5905,-122.022
269000,3,2,1410,10577,1410,0,47.3642,-122.187
382000,2,2,1350,2560,1350,0,47.6338,-122.106
574000,2,2.25,1100,1114,900,200,47.6199,-122.304
405000,3,2.5,2070,4697,2070,0,47.5307,-121.875
572000,3,2.5,2360,9938,1690,670,47.5374,-122.053
675000,4,2.25,2760,12100,2760,0,47.6285,-122.058
165000,4,1,1220,7980,1220,0,47.4924,-122.237
260000,4,1,1220,7980,1220,0,47.4924,-122.237
196000,3,1,1220,6719,1220,0,47.4187,-122.329
515000,3,2.5,3020,12184,3020,0,47.744,-121.976
810000,4,3.5,3470,7396,2520,950,47.7146,-122.279
365650,4,2.25,2380,7700,2380,0,47.4391,-122.194
651000,3,3,2260,1834,1660,600,47.6111,-122.308
240000,2,1,720,6345,720,0,47.5201,-122.35
299000,3,2,1730,6007,1730,0,47.3573,-122.2
768000,3,2.5,2660,10928,1830,830,47.5442,-122.141
397380,2,1,1030,5072,1030,0,47.6962,-122.294
476000,4,3,2890,6885,1590,1300,47.6763,-122.282
315000,3,1,890,5200,890,0,47.559,-122.277
240000,3,2.25,1410,7290,940,470,47.5396,-122.274
325000,2,1,810,4080,810,0,47.5337,-122.379
160000,3,1.75,1370,8006,1370,0,47.258,-122.252
435000,3,2.5,2260,5100,2260,0,47.7341,-121.968
427500,3,1.75,1430,16200,1430,0,47.5223,-122.043
450000,5,2.5,2510,10240,1410,1100,47.4732,-122.141
688000,3,1.5,1760,4880,1290,470,47.5334,-122.388
285000,4,1,1430,3600,980,450,47.5343,-122.355
530000,3,3.25,1510,1125,1510,0,47.6711,-122.39
195000,4,1.75,1320,7694,1320,0,47.4297,-122.325
250200,3,1.5,1180,7384,1180,0,47.3838,-122.287
1.1E+06,3,2.25,1560,8570,1080,480,47.6155,-122.21
732500,3,2.5,2470,10321,2470,0,47.6694,-122.141
194250,3,2.25,2190,8834,1390,800,47.2633,-122.244
526000,4,2,1610,8000,1190,420,47.6301,-122.118
520000,4,2.75,2700,9882,2700,0,47.7671,-122.291
526000,3,1.75,1530,6125,1120,410,47.5687,-122.397
1.13525E+06,5,4,7320,217800,7320,0,47.4473,-122.086
202000,2,1,920,7569,920,0,47.4951,-122.302
645500,4,2.5,2990,8622,2990,0,47.5394,-121.875
570000,1,1,720,7540,720,0,47.3509,-122.323
325000,3,2,1750,9000,1750,0,47.7489,-122.35
725000,2,1,2410,5930,1930,480,47.5657,-122.395
192000,3,1.75,1240,10361,1240,0,47.37,-122.151
560000,2,1,1010,9219,1010,0,47.6886,-122.202
283450,5,2.75,2770,6116,1490,1280,47.4847,-122.291
863000,4,1.75,2800,5400,1400,1400,47.6803,-122.313
815000,4,2,1400,4800,1400,0,47.6168,-122.298
245000,2,1,1020,7679,1020,0,47.4915,-122.188
1.315E+06,4,3,2860,10292,2860,0,47.6286,-122.206
1.156E+06,4,3.5,4270,12305,4270,0,47.5489,-122.118
480000,3,2.5,2270,4488,2270,0,47.5329,-121.879
600000,4,2.5,2560,5593,2560,0,47.6886,-122.037
329950,2,1,900,5220,900,0,47.5105,-122.387
299500,4,2.5,2010,12085,2010,0,47.3406,-122.057
460000,3,2.5,1690,5131,1690,0,47.5234,-122.38
515000,5,3.5,2310,5249,1560,750,47.5463,-122.272
405000,3,2.25,1520,1245,1520,0,47.6907,-122.34
483000,4,1.5,1220,3780,1220,0,47.6667,-122.36
377000,4,2.5,2170,11511,2170,0,47.3886,-122.188
568000,4,1.75,2790,17476,1450,1340,47.4556,-122.369
355000,2,1.75,1760,4600,850,910,47.5654,-122.372
640000,4,1.75,2100,3000,1500,600,47.6721,-122.329
270000,4,1,1430,5909,1070,360,47.7623,-122.313
559950,5,3.5,2450,8193,2450,0,47.7721,-122.241
515000,4,3,1820,8261,1420,400,47.7197,-122.219
352000,4,1.75,1850,5712,1850,0,47.6966,-122.324
595888,3,1.75,1870,9000,1870,0,47.7203,-122.361
588000,4,2.25,2580,7344,2580,0,47.5647,-122.09
1.05E+06,4,3.25,3680,8580,1840,1840,47.5266,-122.387
260000,3,1.5,1750,7000,1750,0,47.3108,-122.346
1.6E+06,4,3.5,3890,3600,2860,1030,47.6342,-122.282
380000,2,1,1000,4800,1000,0,47.6926,-122.362
802000,2,2.5,2210,6327,2210,0,47.7114,-122.03
1.325E+06,4,3.25,2850,4800,2700,150,47.6292,-122.312
710000,4,2.75,2460,3600,1640,820,47.6093,-122.297
600000,3,2.5,2630,77972,2630,0,47.745,-121.916
707900,3,1,1750,5355,1750,0,47.6792,-122.31
179950,2,1,1100,7323,780,320,47.2874,-122.37
683000,4,2.5,2620,10489,2620,0,47.6732,-122.143
222400,3,2,1200,9566,1200,0,47.2649,-122.252
517000,2,1.5,1920,3408,960,960,47.6118,-122.299
410000,3,2.75,1690,5763,1180,510,47.7336,-122.202
480000,3,1.75,1680,2552,840,840,47.6848,-122.391
430000,3,1.75,3440,10428,3440,0,47.449,-122.128
439950,5,1.75,2190,7500,1290,900,47.7766,-122.355
797500,4,2.5,3270,8223,3270,0,47.6018,-122.073
379000,4,1.5,1280,5460,1080,200,47.5348,-122.268
575000,1,1,1310,8667,1310,0,47.6059,-122.313
247500,3,1,1660,11060,1110,550,47.3311,-122.326
385000,4,2.75,2700,37011,2700,0,47.3496,-122.088
423000,4,1.75,1940,6909,970,970,47.7108,-122.352
550000,3,1.75,1520,5618,1170,350,47.68,-122.284
415000,4,1,1620,4329,1620,0,47.5728,-122.388
693000,3,2.25,2090,45535,1280,810,47.5538,-122.191
543000,2,1,1070,4700,1070,0,47.6887,-122.368
465000,5,1.75,2000,10246,1200,800,47.5084,-122.246
280000,3,2.5,1020,2217,720,300,47.5343,-122.348
1.388E+06,3,1.25,2400,6653,2400,0,47.6019,-122.29
665000,6,3,2480,9720,2480,0,47.6127,-122.145
237950,3,1.75,1310,7314,1310,0,47.2888,-122.221
440000,4,2.75,2420,10200,1220,1200,47.72,-122.236
618000,2,1,1890,4700,1030,860,47.6747,-122.391
572000,3,2.25,1860,4000,1020,840,47.5539,-122.267
725000,3,1.5,2500,4774,1450,1050,47.6567,-122.358
454000,3,1,1970,22144,1970,0,47.5234,-121.841
535000,4,1,1660,10656,1180,480,47.5391,-122.385
249000,3,2.5,1850,7200,1500,350,47.3063,-122.384
395000,4,2.75,1970,37026,1970,0,47.4375,-122.446
690000,3,2,1890,6620,1890,0,47.7016,-122.274
526500,3,1.5,1310,7236,1170,140,47.6944,-122.333
325000,4,1.5,1870,7220,1870,0,47.77,-122.319
495000,3,3,1520,4080,1520,0,47.572,-122.29
825000,5,3,3070,8474,3070,0,47.6852,-122.184
383000,3,1.5,1400,14850,1400,0,47.4471,-122.464
320000,3,1.75,1960,11931,980,980,47.5432,-122.272
475000,3,2.5,2680,87117,1340,1340,47.5646,-121.935
275000,3,2.5,2030,6326,2030,0,47.3491,-122.029
1.15E+06,2,2.25,2320,9300,1920,400,47.681,-122.273
455000,3,1.75,1760,11371,1760,0,47.7616,-122.273
262000,5,1,1870,7800,1580,290,47.5127,-122.321
390000,4,1,1280,4840,940,340,47.5477,-122.395
300000,3,2.25,1730,10030,1730,0,47.3108,-122.345
746300,3,1.75,2060,5721,1140,920,47.5268,-122.388
267000,3,1.5,1030,8223,1030,0,47.4282,-122.331
525000,3,2.5,1720,7950,1720,0,47.7178,-122.168
570000,3,1.75,1210,7350,1210,0,47.7,-122.172
360000,4,2.25,2620,8100,1550,1070,47.4564,-122.351
1.052E+06,3,1,1860,44431,1860,0,47.6057,-122.038
699950,3,2.5,2510,4106,2510,0,47.5494,-121.994
375000,4,2.5,2040,109336,2040,0,47.4193,-121.958
625000,4,1.75,2410,6770,1220,1190,47.6946,-122.336
464050,2,1,780,2750,780,0,47.5842,-122.388
470000,5,2.5,2210,9655,1460,750,47.7698,-122.222
330000,4,2,1590,9100,1040,550,47.4465,-122.156
537000,4,1.75,2230,7957,2230,0,47.5859,-122.122
250000,3,2,1560,32137,910,650,47.3197,-122.117
835000,4,2.5,2950,48351,2950,0,47.5938,-122.048
770000,4,1,1480,3750,1480,0,47.6737,-122.354
650000,4,2,2850,4497,1730,1120,47.5876,-122.292
335000,3,1.75,2390,30409,1560,830,47.4789,-122.296
350000,3,1.75,1740,29597,1740,0,47.481,-122.115
415000,5,2.75,2060,8906,1220,840,47.5358,-122.289
788000,4,2.5,2680,8778,2680,0,47.5516,-122.161
640000,4,2.75,3150,7379,2430,720,47.6968,-122.3
388000,4,2.5,2440,7155,2440,0,47.4501,-122.126
360000,6,1.75,2230,10080,1390,840,47.7089,-122.201
692500,6,1.75,2230,10080,1390,840,47.7089,-122.201
425000,4,1.5,1600,6180,1600,0,47.5681,-122.285
645000,4,1.5,1600,6180,1600,0,47.5681,-122.285
340000,3,1,1580,8308,1580,0,47.5075,-122.379
713000,4,3.25,2840,54400,2840,0,47.6707,-122.045
430000,3,2.75,2550,11160,2550,0,47.7351,-122.323
280000,3,2.25,1700,7210,1250,450,47.3546,-122.318
215000,3,2,1470,2052,1470,0,47.3084,-122.331
306000,3,2.5,1680,11193,1680,0,47.4482,-122.125
299900,3,1,1110,8593,1110,0,47.7595,-122.309
534000,5,1.75,2120,8625,1200,920,47.6118,-122.131
1.16E+06,3,2.75,2380,5572,1930,450,47.6626,-122.271
1.165E+06,3,2.5,2670,5000,2000,670,47.5855,-122.292
199990,2,1,890,6430,890,0,47.2003,-121.996
946000,4,3,3140,9058,2140,1000,47.5462,-122.154
295000,4,1,1260,7800,1260,0,47.7334,-122.307
475000,2,1,920,5157,920,0,47.5499,-122.269
750000,5,3.5,2990,212137,2450,540,47.5298,-121.887
1.225E+06,4,2.5,3120,49456,2590,530,47.3535,-122.323
183500,3,1,1010,7520,1010,0,47.2699,-122.255
450000,2,1,1010,3627,1010,0,47.5873,-122.294
180000,3,1,1020,5500,1020,0,47.5502,-122.286
707000,5,4.5,3540,21217,2940,600,47.4274,-122.28
230000,2,0.75,900,3527,900,0,47.5083,-122.336
192500,3,1,1100,9750,1100,0,47.3248,-122.345
309000,3,2.5,1990,3614,1990,0,47.36,-122.039
759000,3,1.5,1980,5800,1520,460,47.6499,-122.413
1.115E+06,4,3.75,4040,14212,4040,0,47.5189,-122.147
462000,5,1.75,1250,10530,1250,0,47.6101,-122.138
229000,4,1.5,1820,22814,1820,0,47.7321,-122.296
399950,2,2.25,1140,1184,1010,130,47.659,-122.346
325000,5,2,1730,10532,1730,0,47.5076,-122.178
512000,2,2.25,1170,1313,1170,0,47.6712,-122.378
410000,5,2.75,2910,5802,2910,0,47.3591,-122.036
210000,2,1,970,5500,970,0,47.556,-122.291
325000,4,2.25,2130,8499,1600,530,47.3657,-122.21
685000,3,2.5,2520,10175,1630,890,47.5652,-122.089
488000,2,2,1360,4688,780,580,47.6874,-122.315
247500,3,2.25,1620,6000,1280,340,47.2835,-122.2
489000,4,2,2120,11479,1060,1060,47.7084,-122.303
725000,4,1.75,2700,6000,1450,1250,47.6539,-122.395
199950,3,1.5,1370,10317,1370,0,47.4731,-122.298
670000,5,3,2520,13001,2010,510,47.6385,-122.114
275000,3,2,1540,10410,1540,0,47.3662,-122.315
1E+06,3,1.75,2610,6360,2130,480,47.6287,-122.351
255000,3,2,1490,8371,1490,0,47.3962,-122.189
465000,3,1.75,2760,9137,1380,1380,47.6079,-122.132
259000,3,1.75,1260,3604,1260,0,47.3612,-122.103
695000,3,3.5,2630,4713,2030,600,47.5473,-122.016
505000,3,1.75,1800,7210,1370,430,47.7346,-122.17
631500,2,1,1130,2640,1130,0,47.6438,-122.357
630500,3,1,1180,3600,1180,0,47.6337,-122.28
999000,4,2.75,2800,19168,2800,0,47.5911,-122.037
740000,3,1.5,1830,4000,1350,480,47.6453,-122.371
650000,3,2.5,2220,6380,1660,560,47.6974,-122.313
554000,2,2,1870,5580,1870,0,47.7101,-122.031
400000,3,2.5,2580,214315,2580,0,47.6465,-122.024
529941,3,2,1660,10000,1010,650,47.5852,-122.174
310000,3,1,1330,3740,1330,0,47.5502,-122.274
389000,3,1,1330,3740,1330,0,47.5502,-122.274
731781,3,3,2630,4972,2630,0,47.693,-122.133
502501,2,1,1100,4750,1100,0,47.5772,-122.381
443000,3,1.75,1810,7950,1810,0,47.6236,-122.117
607000,3,2,2060,4080,1060,1000,47.574,-122.289
2.1475E+06,3,3.5,4660,5500,3040,1620,47.6465,-122.319
585000,4,2.5,2370,15200,1660,710,47.6295,-122.089
1.027E+06,3,2.5,2430,10500,2430,0,47.5818,-122.198
315000,3,2.5,1880,7000,1880,0,47.4206,-122.184
180000,2,1,1150,5695,1150,0,47.4989,-122.171
322500,3,2,1350,14200,1350,0,47.7315,-121.972
568500,3,2.75,2180,7519,1310,870,47.6959,-122.125
813000,4,2.75,3370,6675,1920,1450,47.5887,-122.291
1.085E+06,5,2.25,3650,13068,1850,1800,47.5458,-122.231
424000,4,2,2100,4857,2100,0,47.7521,-122.279
235000,2,1,670,5600,670,0,47.5498,-122.304
740000,3,3.5,2420,4000,1820,600,47.6054,-122.295
415000,1,1,760,3000,760,0,47.6059,-122.303
432000,3,2.75,2200,14925,1100,1100,47.6606,-122.059
1.26889E+06,5,3.25,4410,35192,3880,530,47.7522,-122.13
676500,3,1.75,1300,2446,880,420,47.6071,-122.285
419000,2,1,720,4592,720,0,47.6534,-122.404
650000,3,2.5,2180,37042,2180,0,47.722,-122.026
239000,2,1,1130,15190,1130,0,47.3902,-122.283
900000,4,2.5,2230,4372,1540,690,47.6698,-122.334
330000,5,1.75,2100,7347,1070,1030,47.7751,-122.268
510000,3,1.75,2060,58341,1100,960,47.4193,-122.439
465000,4,2.5,3060,6000,3060,0,47.3689,-122.058
1.7E+06,3,2.75,2810,18731,2810,0,47.6361,-122.093
490000,3,2.25,2550,8588,2550,0,47.7711,-122.195
2.68E+06,5,3,4290,20445,4290,0,47.6217,-122.239
1E+06,3,2.25,3040,52302,3040,0,47.7635,-122.112
469950,4,2.75,2530,14178,2530,0,47.737,-121.955
536000,3,1.75,1300,5413,1300,0,47.6988,-122.32
244950,4,2.5,1790,19177,1790,0,47.3617,-122.172
575000,3,1,1530,2400,890,640,47.6543,-122.354
361000,5,2.75,2380,7500,1300,1080,47.5009,-122.235
650000,5,2.25,2400,13450,1200,1200,47.6007,-122.117
230005,2,1,1030,6000,830,200,47.5291,-122.268
293000,4,2.5,3250,235063,3250,0,47.2582,-122.113
445000,3,3,1970,24318,1970,0,47.7651,-122.246
280000,4,1.5,1940,6386,1140,800,47.5533,-122.285
520000,3,2.25,1850,10855,1370,480,47.5696,-122.02
780000,4,3.25,3900,40962,3900,0,47.683,-122.063
625000,3,1.75,3160,76230,2160,1000,47.274,-122.287
239950,3,1.75,1440,7200,1440,0,47.4473,-122.284
335000,3,1.5,2040,6000,1340,700,47.5218,-122.286
612000,3,2.5,2120,7401,2120,0,47.5781,-122.018
200000,2,1,830,8000,830,0,47.4215,-122.318
345000,3,1.75,3140,8571,1670,1470,47.3074,-122.337
520000,4,2.5,2410,6440,1550,860,47.7153,-122.191
855000,4,2.25,2190,4080,1800,390,47.6425,-122.358
567500,4,1.75,2190,5060,1190,1000,47.5846,-122.387
208000,3,1.5,1210,7247,1210,0,47.328,-122.321
452000,3,1.75,1880,16239,880,1000,47.7004,-122.304
555000,3,3,2410,12183,2410,0,47.747,-122.177
519000,5,2.75,2620,8861,1350,1270,47.5226,-122.183
474950,3,2.25,1850,2575,1850,0,47.5525,-122.273
419000,3,2.25,1760,16418,1190,570,47.6525,-121.985
390000,2,1,860,1800,860,0,47.6334,-122.371
539000,7,2.25,2620,6890,2620,0,47.6123,-122.134
569000,4,1.75,2400,21196,1590,810,47.4282,-122.347
611000,3,1,1850,5000,1850,0,47.6727,-122.351
760000,3,2.5,4040,147856,4040,0,47.2711,-122.067
732000,3,2,1940,55756,1940,0,47.5913,-122.149
1.675E+06,3,2.5,3490,8343,2150,1340,47.7265,-122.281
919950,5,2.75,3170,7062,3170,0,47.5937,-122.061
400000,4,2.5,2530,7563,1440,1090,47.7762,-122.21
785000,4,2.5,3230,21781,3230,0,47.6318,-122.01
835000,3,2.25,2120,54014,2120,0,47.6482,-122.159
640500,2,1.75,1640,6750,1340,300,47.7068,-122.308
310000,4,2.5,2130,9013,2130,0,47.3208,-122.273
355000,4,1,1440,7215,1440,0,47.7133,-122.212
685000,3,1.75,1940,7313,1440,500,47.5239,-122.387
202500,3,1,1120,8576,1120,0,47.4896,-122.248
540000,3,2.5,2400,5817,2400,0,47.5371,-121.87
295000,4,2.5,1810,4871,1810,0,47.4088,-122.192
518000,3,1,1270,6612,1270,0,47.5433,-122.264
250000,2,1.75,1350,4023,1350,0,47.3493,-122.023
330000,2,2,1550,435600,1550,0,47.5145,-121.853
481000,2,1,1620,3880,920,700,47.6855,-122.391
898000,3,2.25,2650,12845,1770,880,47.7209,-122.256
570000,5,1.75,2510,9750,2510,0,47.6635,-122.149
475000,4,2.5,2040,16200,2040,0,47.7366,-121.958
265000,3,2.5,1660,5250,1660,0,47.3541,-122.3
380000,3,2.5,1980,17342,1580,400,47.4551,-122.373
790000,4,2.5,2690,8036,2690,0,47.6596,-122.144
620000,2,2.25,2910,6110,2910,0,47.5279,-122.387
709050,4,3.5,2720,9000,2670,50,47.7034,-122.297
296500,3,1,1280,5100,1280,0,47.5259,-122.38
475000,3,2.5,2160,35912,2160,0,47.7273,-122.083
440000,3,2.25,1760,10835,1290,470,47.522,-122.048
405000,2,1,800,6016,800,0,47.6913,-122.369
269500,2,1,930,4000,730,200,47.5321,-122.323
520000,5,1.75,2040,5280,1020,1020,47.5941,-122.144
229500,1,1,1180,22000,1180,0,47.4007,-122.323
335000,4,1.75,2000,10890,1390,610,47.3203,-122.321
680000,4,2.75,3310,50951,3310,0,47.7249,-122.027
1.389E+06,4,3.5,3130,3900,2550,580,47.6849,-122.327
740000,4,2.5,2300,9900,1600,700,47.5256,-122.385
270000,3,2.25,2140,9990,2140,0,47.3484,-122.298
510000,4,2,2210,5572,1760,450,47.5727,-122.376
300000,2,1,970,13700,970,0,47.515,-122.362
1.29889E+06,5,2.25,2690,10800,2020,670,47.5821,-122.247
675000,4,2,1890,5188,1670,220,47.6633,-122.287
925850,6,3.25,3140,14923,3140,0,47.5411,-122.133
255500,2,1,1440,43560,1150,290,47.4916,-122.082
450000,3,2.5,2910,17172,2910,0,47.2789,-122.331
280000,3,1,1310,22652,1310,0,47.2574,-122.072
245000,4,2.25,2140,8800,2140,0,47.3655,-122.291
344950,3,1,1090,6712,1090,0,47.7155,-122.211
381000,3,1.75,1330,7216,1330,0,47.7199,-122.18
1.945E+06,4,4,4690,6900,3480,1210,47.6165,-122.216
1.5E+06,3,1.5,1910,21374,1910,0,47.6453,-122.214
232603,3,1.75,1750,11461,1750,0,47.3173,-122.21
220000,5,2.5,1760,10200,1760,0,47.5271,-122.351
600000,4,1.75,1810,7700,1390,420,47.6976,-122.169
239000,3,2.5,1360,5754,1360,0,47.3645,-122.183
400000,3,1.75,1730,9211,1730,0,47.7149,-122.322
2.18E+06,6,2.75,4710,11000,3690,1020,47.6622,-122.272
350000,3,1,1010,8551,1010,0,47.7351,-122.295
562000,3,2.5,2400,97138,2400,0,47.7361,-122.046
380000,3,1.5,1540,8400,1540,0,47.5237,-122.199
511200,4,1.75,1480,7875,740,740,47.643,-122.397
680000,4,2.5,2520,5000,2520,0,47.5524,-121.992
350000,3,3.25,1210,941,1000,210,47.7114,-122.356
410000,5,2.5,2670,184140,1410,1260,47.3429,-122.097
1.05E+06,4,2.5,3030,12590,3030,0,47.5806,-122.193
391265,3,2,1440,3900,1440,0,47.7022,-122.021
1.41E+06,4,2.25,3250,16684,3250,0,47.6334,-122.229
575000,3,2,1750,5750,870,880,47.5579,-122.384
316000,4,1.5,2120,46173,2120,0,47.6503,-121.968
165000,3,1,1050,5156,1050,0,47.5169,-122.358
850000,3,2.25,1950,3600,1430,520,47.637,-122.363
210000,3,1,1020,6000,1020,0,47.5281,-122.031
325000,4,2.5,1820,9161,1220,600,47.4333,-122.168
682000,4,2.5,2390,53941,2390,0,47.7066,-122.08
430000,3,2.5,1400,7508,1400,0,47.7233,-122.167
325500,3,1.5,1540,8110,1190,350,47.7329,-122.291
385000,3,1.75,2370,6360,1280,1090,47.5039,-122.24
435000,1,1,670,1800,670,0,47.654,-122.35
550000,4,1,2420,15520,2420,0,47.5744,-122.137
400000,3,1,1000,7800,860,140,47.7098,-122.283
503000,4,2.75,2100,7350,1240,860,47.7194,-122.172
676000,4,2.5,2800,5368,2800,0,47.6076,-122.053
180000,3,1,940,11055,940,0,47.3732,-122.295
234000,3,2,1640,5280,1640,0,47.3089,-122.213
734200,4,2.5,2760,5000,1680,1080,47.6726,-122.371
920000,3,3.25,3660,66211,3660,0,47.4087,-122.062
1.92E+06,4,2.5,3070,34412,2070,1000,47.64,-122.24
224000,3,1.75,1100,10125,1100,0,47.3232,-122.103
1.4E+06,3,2.75,3130,19530,1690,1440,47.5895,-122.111
185000,3,1,1320,7155,1320,0,47.2857,-122.22
554600,3,1.75,1470,5000,1470,0,47.6755,-122.369
268000,3,1.75,1480,8009,980,500,47.3657,-122.28
675000,4,2.25,2260,8715,1530,730,47.6237,-122.106
620000,4,2.25,2210,10039,1710,500,47.634,-122.101
396450,3,1.75,1540,12446,1540,0,47.5172,-122.027
565000,5,1.75,1910,9720,1390,520,47.5772,-122.159
410000,3,1.75,1760,3520,1160,600,47.5773,-122.303
1.19E+06,4,3,2240,6000,1270,970,47.6369,-122.35
716125,3,2.25,2110,7279,2110,0,47.6669,-122.17
225000,2,1,1396,111949,1396,0,47.6374,-122.007
640000,4,2.75,3040,7274,2320,720,47.7184,-122.28
374000,2,1,1140,5650,980,160,47.5634,-122.391
415000,4,2,1780,12161,1160,620,47.7746,-122.323
592500,4,2.5,3370,35150,1770,1600,47.461,-122.002
365000,3,2.5,1484,1761,1484,0,47.6844,-122.317
600000,4,2.5,2230,12753,1180,1050,47.6297,-122.033
465000,4,2.5,2820,39413,2820,0,47.3064,-122.1
254999,3,1,1580,7560,1000,580,47.3318,-122.277
279000,4,2.5,2040,8076,2040,0,47.3691,-122.074
460000,3,2.5,2720,40813,2720,0,47.2619,-122.271
507000,4,2.25,1490,956,1020,470,47.6184,-122.301
291000,3,1.75,1560,9788,1560,0,47.4876,-122.226
350000,2,1.5,830,1077,830,0,47.6058,-122.319
90000,3,1,980,2490,980,0,47.317,-122.182
329000,3,1.75,1980,7000,1360,620,47.4442,-122.129
909000,4,2.5,3680,11648,3680,0,47.5604,-122.107
187000,2,1,860,5400,860,0,47.492,-122.171
580000,3,1.75,1850,5100,1020,830,47.6605,-122.326
345000,3,2.5,1620,5992,1620,0,47.736,-121.965
497000,4,2.5,2240,7200,2240,0,47.5636,-122.275
345000,3,1,1010,3060,1010,0,47.5657,-122.285
313500,3,1.75,1610,7350,1610,0,47.4503,-122.131
910000,3,2.5,2720,7250,2720,0,47.6894,-122.195
399950,3,1.5,2080,5244,1190,890,47.7144,-122.293
268000,4,2,1930,6600,1030,900,47.482,-122.332
559000,4,1.75,2250,8458,1450,800,47.5235,-122.383
309000,3,2.25,1980,8755,1300,680,47.3922,-122.321
410000,3,2.5,1960,4400,1960,0,47.5384,-121.889
259000,3,1,1320,8625,1320,0,47.4902,-122.179
950000,5,2,2940,5500,2340,600,47.6466,-122.321
320000,4,1,1460,7200,1460,0,47.7602,-122.306
1.15E+06,4,2.5,2330,30122,1490,840,47.6843,-122.267
394250,3,2,2620,10107,2620,0,47.4096,-122.329
315000,1,1,700,3876,700,0,47.6886,-122.352
480000,2,2,1140,12000,1140,0,47.5277,-122.031
556000,3,2.5,2750,35440,2750,0,47.4745,-121.723
450000,3,2.5,2480,5647,2480,0,47.5355,-121.88
420000,3,1.5,1130,5413,940,190,47.7021,-122.32
890000,6,3.75,2770,5000,1870,900,47.669,-122.365
295000,4,2,1710,8814,1030,680,47.395,-122.174
410000,4,2.25,2150,27345,2150,0,47.469,-122.121
308900,3,2.5,2250,7294,2250,0,47.2636,-122.212
1.161E+06,4,2.5,2960,26742,1480,1480,47.6846,-122.268
665000,2,2.5,2300,6984,2300,0,47.7087,-122.015
577000,3,1.75,1740,5500,970,770,47.577,-122.395
959000,3,2.5,2830,3750,2830,0,47.6799,-122.385
471000,2,1.75,1240,6417,1240,0,47.5439,-122.379
560000,3,2.5,2180,7169,2180,0,47.5714,-122.002
955000,5,2.25,2510,9887,2510,0,47.5339,-122.223
1.24E+06,7,5.5,6630,13782,4930,1700,47.5399,-122.118
579000,3,2.5,2300,18540,1800,500,47.7767,-122.369
335000,4,2.25,3220,7889,3220,0,47.3112,-122.339
485000,3,2.5,2270,7887,2270,0,47.5326,-121.855
552000,3,2.5,1840,9900,1840,0,47.6131,-122.151
950000,4,3.25,3820,15293,3820,0,47.6097,-122.017
203700,3,2,1660,7958,1130,530,47.3187,-122.171
412000,4,3.5,3360,9767,2450,910,47.3047,-122.347
237500,3,2,1350,8960,1350,0,47.3614,-122.045
866800,4,3.5,2970,5000,2200,770,47.6772,-122.399
425000,3,1,1000,5100,860,140,47.6857,-122.293
200000,3,2,1190,6833,1190,0,47.3191,-122.18
280000,3,1.75,1670,6034,990,680,47.5209,-122.286
140000,3,1.5,1200,2002,1200,0,47.4659,-122.189
370000,5,2.5,2250,10400,1280,970,47.4501,-122.139
550000,2,0.75,1040,4000,930,110,47.6489,-122.372
1.4116E+06,2,2.5,3180,9400,2610,570,47.5617,-122.158
1.505E+06,2,2.5,3180,9400,2610,570,47.5617,-122.158
510000,4,1.5,2040,8800,1020,1020,47.5965,-122.139
351000,3,1,1160,10518,1160,0,47.7343,-122.22
210000,3,1,880,10800,880,0,47.4949,-122.338
449999,4,1.75,2290,36900,1690,600,47.2034,-122.003
137000,3,1,950,7620,950,0,47.5178,-122.346
270000,3,1,1010,14510,1010,0,47.3437,-122.078
540000,3,2.5,3100,100188,1820,1280,47.3928,-122.066
565000,5,3,2560,12480,1590,970,47.7657,-122.284
940000,4,1.5,2430,3600,2430,0,47.6351,-122.285
385000,2,1,830,26329,830,0,47.4012,-122.425
400000,3,3,2090,7634,1450,640,47.7408,-121.974
365000,3,2,2030,8649,2030,0,47.5082,-122.166
353250,2,1,1060,1600,1060,0,47.5888,-122.294
455000,2,1.5,1090,6750,950,140,47.6836,-122.397
475000,4,3.5,3400,234352,2500,900,47.4335,-122.449
571500,4,1.75,1920,7455,960,960,47.7106,-122.286
441000,2,1,1150,3000,780,370,47.5624,-122.291
810000,6,2.75,3970,9500,2180,1790,47.5956,-122.178
550000,3,2.25,1880,11556,1880,0,47.6283,-122.032
736000,2,1,1500,4000,1100,400,47.6409,-122.353
375000,3,1.75,2190,17550,2190,0,47.6984,-121.912
717500,3,2.5,2530,9932,2530,0,47.6853,-122.16
581000,2,1.75,1930,11200,1430,500,47.7576,-122.37
629000,3,2,1510,4560,1510,0,47.5689,-122.408
3.8E+06,3,4.25,5510,35000,4910,600,47.7296,-122.37
225000,3,2,1100,5200,1100,0,47.3606,-122.083
315000,3,2.5,1730,6368,1730,0,47.3505,-122.032
425000,3,2.5,1480,1386,1480,0,47.5468,-121.998
346500,3,1,1150,11802,1150,0,47.5624,-122.361
550000,3,2.25,1950,26500,1570,380,47.5784,-122.179
565000,3,1.75,2380,10450,1400,980,47.6409,-122.111
1.001E+06,4,2,3100,8000,2040,1060,47.6852,-122.329
400000,2,2,2010,3797,1450,560,47.5596,-122.315
724950,4,2,2270,5760,2270,0,47.5809,-122.39
623000,3,1.75,2050,16313,2050,0,47.5743,-122.212
295000,2,1,650,5400,650,0,47.6185,-122.295
700000,4,3.25,2780,7875,2780,0,47.7294,-122.352
482000,2,1.5,1300,1229,1160,140,47.6727,-122.375
770000,3,2.5,2730,11380,2730,0,47.58,-122.057
310000,4,2.5,3140,22100,1820,1320,47.319,-122.362
720000,4,2.25,2410,8400,2410,0,47.626,-122.119
355000,3,1,1180,5965,1180,0,47.7281,-122.299
512000,4,2.5,2600,4506,2600,0,47.5146,-122.188
303000,2,1.5,1400,1650,1400,0,47.7222,-122.29
299000,5,2.5,2220,9360,1110,1110,47.4341,-122.169
285000,3,2.5,1660,6263,1660,0,47.3507,-122.141
680000,3,1.75,2330,9652,1590,740,47.5714,-122.211
285000,4,1.75,1440,6720,720,720,47.4571,-122.345
707000,4,2.25,2920,17023,1690,1230,47.5585,-122.134
690000,3,2,1760,6428,980,780,47.6388,-122.397
872000,4,2.25,2860,40284,2860,0,47.7308,-122.115
290000,4,1.75,2090,12750,1360,730,47.4792,-122.357
425000,4,1.75,1910,16785,1110,800,47.7474,-122.235
925000,3,2.75,3280,10558,2040,1240,47.5606,-122.133
340500,3,1,1770,12458,1770,0,47.7715,-122.27
365000,2,1,920,6600,920,0,47.5572,-122.282
725000,3,1.75,1690,8489,1690,0,47.6079,-122.192
811000,3,3,2470,7410,1860,610,47.6937,-122.392
299000,3,1,1040,9514,1040,0,47.4936,-122.102
287500,4,2,1220,9147,1220,0,47.5011,-122.336
879950,4,2.25,3500,13875,1830,1670,47.5083,-122.388
135900,2,1,760,3800,760,0,47.5019,-122.269
1.225E+06,4,2.25,3070,16028,1870,1200,47.5271,-122.228
522500,4,1.75,2100,6480,1300,800,47.7049,-122.359
399500,4,1.5,1660,6617,1660,0,47.739,-122.323
450000,3,1,1430,5960,1430,0,47.562,-122.289
218000,4,1,1620,17500,1620,0,47.3021,-122.388
289999,3,2,1490,9285,1490,0,47.3248,-122.169
540000,2,1,1170,4750,1170,0,47.6729,-122.378
324950,3,1,1240,7500,1240,0,47.6199,-122.062
718500,3,2,2910,6600,1920,990,47.5576,-122.281
495000,3,2,2660,192099,2660,0,47.2098,-122.016
260000,6,2,2220,8797,2220,0,47.2977,-122.227
430000,4,1.5,1920,10000,1070,850,47.5725,-122.133
402500,3,3.25,2780,4002,2780,0,47.7348,-121.966
1.415E+06,4,3,3110,4408,2510,600,47.6583,-122.27
275000,3,2.25,1820,9766,1450,370,47.397,-122.203
250000,3,2.25,1765,7652,1765,0,47.3072,-122.328
665000,3,2.75,1800,9550,1320,480,47.5679,-122.178
425000,3,2.5,2650,144183,2650,0,47.4212,-122.144
760000,2,1,1410,3600,1310,100,47.6695,-122.338
447000,3,2.5,1650,3076,1650,0,47.682,-122.035
205000,3,1,1180,8240,1180,0,47.3325,-122.321
191000,3,1.5,800,8850,800,0,47.3266,-122.348
350000,2,1.75,1430,7921,1430,0,47.5088,-122.371
789888,5,3.5,3300,7860,2410,890,47.5463,-122.192
443000,2,1,1220,10170,980,240,47.7297,-122.327
695000,4,3.5,3530,7202,2660,870,47.7339,-122.36
560000,4,2,1380,4048,1380,0,47.6583,-122.344
550000,3,1.75,1410,5000,810,600,47.6727,-122.395
850000,2,2.5,3360,6750,3360,0,47.7112,-122.033
352750,4,2.75,2270,24237,1360,910,47.4672,-122.175
550000,4,2.5,2890,9045,2890,0,47.7385,-121.965
774900,5,1,1750,3861,1750,0,47.6075,-122.295
250000,3,1,1010,8711,1010,0,47.4914,-122.186
962800,4,2.5,3780,23623,3780,0,47.559,-122.118
299500,3,1.75,1880,11700,1880,0,47.3213,-122.187
250000,2,1,800,5220,800,0,47.7037,-122.32
745000,5,4,4720,493534,3960,760,47.4536,-122.009
279475,2,1,1060,10600,1060,0,47.5375,-121.742
450000,3,2.25,2530,27227,2530,0,47.527,-122.193
307700,5,2.25,1980,13132,1260,720,47.3984,-122.301
665000,3,1,1650,5102,1300,350,47.6524,-122.404
375000,3,2.75,1890,3930,1890,0,47.5337,-121.867
420000,4,2.5,3360,11637,3360,0,47.3018,-122.342
148000,2,1,630,4200,630,0,47.5329,-122.348
707000,3,1.5,1980,4000,1980,0,47.6364,-122.351
399000,3,1,990,4250,840,150,47.5392,-122.39
570000,4,2.5,3420,115434,3420,0,47.3932,-121.988
853000,4,2.25,3440,35025,3440,0,47.6674,-122.055
400000,3,1,1300,14138,1300,0,47.593,-122.165
615000,2,1.75,2040,28593,2040,0,47.3979,-122.465
463000,3,1,1250,7700,1250,0,47.5974,-122.149
600000,4,2.5,1960,14242,1290,670,47.4947,-122.369
429000,5,2.5,2720,8120,1360,1360,47.557,-122.308
980000,4,4.25,3250,11780,2360,890,47.6322,-122.203
359500,6,3.75,3190,4700,3190,0,47.3724,-122.105
715000,4,2.5,2570,7980,2570,0,47.6378,-122.065
240000,3,1.75,1420,6984,980,440,47.3748,-122.18
455000,4,2,2120,9442,1060,1060,47.7675,-122.226
610000,3,2.5,2080,167270,2080,0,47.4032,-121.963
675000,3,2.75,2740,5735,2740,0,47.6862,-122.093
283500,3,1.75,1250,5375,1250,0,47.3787,-122.323
235000,2,1,2150,4500,1260,890,47.5158,-122.267
827000,4,2.5,3230,12100,1870,1360,47.562,-122.146
353000,2,1,860,8511,860,0,47.7312,-122.3
747500,4,2.5,2810,11902,2810,0,47.5303,-122.143
341000,2,1,1040,4000,1040,0,47.5753,-122.303
182000,3,1,1160,18055,1160,0,47.4772,-122.269
250000,3,2,1470,2781,1470,0,47.349,-122.024
655000,4,3.5,2350,13402,1670,680,47.6947,-122.19
405000,3,2.25,1660,8307,1660,0,47.7575,-122.352
390000,4,1.75,2020,9750,1100,920,47.6192,-122.055
275400,2,1,890,8180,890,0,47.737,-122.3
791000,3,2.25,2430,5500,1810,620,47.6812,-122.196
424500,3,1.75,1460,7700,1460,0,47.6981,-122.127
430000,3,1,980,7200,980,0,47.5718,-122.395
865000,4,2.5,2580,10631,2580,0,47.6993,-122.206
163000,2,2,1250,7543,1250,0,47.4051,-122.296
920000,4,2.75,3140,9085,1570,1570,47.5675,-122.16
1.02895E+06,5,3.25,2680,3011,1870,810,47.6115,-122.287
325000,3,1.75,1810,8048,1290,520,47.4484,-122.194
315000,5,2.5,2090,4698,2090,0,47.3538,-122.025
227000,4,1,1120,8763,1120,0,47.508,-122.358
179000,4,1.75,1790,7175,1410,380,47.4963,-122.318
276000,2,1,870,2676,820,50,47.5702,-122.287
335000,4,1.5,3160,19745,1840,1320,47.3103,-122.006
430000,3,2,2350,12480,1600,750,47.7661,-122.262
266490,3,2.5,1810,4113,1810,0,47.3715,-122.126
655000,4,2.75,3160,8197,1580,1580,47.7004,-122.287
635500,3,2,1660,3600,1000,660,47.6789,-122.351
235000,5,2.5,2500,9583,1300,1200,47.3946,-122.312
885000,3,2.5,2880,11443,2880,0,47.5633,-122.111
352500,3,1,1470,8400,1470,0,47.7628,-122.354
450000,3,2.5,1460,7573,1460,0,47.6012,-122.141
3.635E+06,5,6,5490,19897,5490,0,47.6165,-122.236
1.05E+06,3,2.25,2480,15022,1330,1150,47.5497,-122.396
476000,2,2.25,1140,1332,1140,0,47.6543,-122.356
375000,3,2.5,1830,13042,1830,0,47.3738,-122.042
600600,4,3.5,3110,6829,3110,0,47.4349,-122.328
567000,4,1.75,2630,11213,1430,1200,47.7158,-122.366
650000,4,1.75,2390,12000,1470,920,47.7061,-122.163
190000,5,2,1750,10284,1750,0,47.5094,-122.182
858000,4,3.5,4370,422967,2580,1790,47.2332,-122.029
435500,1,1.75,1020,4512,770,250,47.6724,-122.266
685000,3,2,2500,6733,1770,730,47.6691,-122.36
252000,3,2,1540,7210,1540,0,47.3128,-122.351
512500,4,2.25,2200,6900,2200,0,47.7682,-122.261
423800,3,2.5,1940,7415,1940,0,47.542,-122.176
460000,3,2.25,1453,2225,1453,0,47.5429,-122.188
434000,3,2.75,1830,3200,1830,0,47.7155,-122.218
244000,3,1,2000,15900,1000,1000,47.4816,-122.233
348125,3,1,1400,8451,1400,0,47.7719,-122.337
585000,4,3.25,2400,29252,2400,0,47.743,-122.131
230000,3,1,1390,16000,1390,0,47.2898,-122.251
450000,3,2,1680,11250,1680,0,47.4861,-121.786
393000,5,2,1820,5054,910,910,47.5547,-122.299
517000,2,1,1140,3750,1140,0,47.6619,-122.343
400000,3,1,1060,12690,1060,0,47.6736,-122.167
890000,2,1.75,3050,50965,3050,0,47.6744,-122.05
205950,3,1,970,11963,970,0,47.3776,-122.315
209000,3,1,1320,3954,1320,0,47.202,-121.994
430000,4,1.75,1890,6000,1110,780,47.7274,-122.305
534000,4,1.75,2040,2750,1260,780,47.6698,-122.3
735000,4,3,2370,3672,1650,720,47.678,-122.311
873000,3,2.25,2720,54450,2720,0,47.5473,-122.092
475000,4,2.25,1970,7532,1390,580,47.7219,-122.109
325000,3,1.75,2180,10230,1090,1090,47.5158,-122.281
500000,3,2.25,2990,216057,2990,0,47.754,-121.942
279000,4,2.75,2180,8475,1330,850,47.4045,-122.174
350000,3,2,1440,5469,1440,0,47.5753,-122.017
660000,4,2.25,3180,13653,3180,0,47.6316,-122.05
324950,2,1.5,1643,14616,1643,0,47.3973,-122.312
500000,4,2,1530,7816,1530,0,47.7309,-122.332
187300,2,1,1310,7697,850,460,47.4982,-122.348
345600,5,3.5,2800,5120,2800,0,47.6059,-122.31
400000,3,1.5,1510,7642,1510,0,47.5978,-122.116
935000,5,3,2700,5001,2700,0,47.6811,-122.288
374000,4,1.75,2220,15600,1140,1080,47.492,-122.166
328000,3,1.75,1440,45302,1440,0,47.7078,-121.915
257500,3,2,1300,9334,1300,0,47.4865,-122.238
1.003E+06,4,2.5,2230,3600,1630,600,47.6304,-122.309
216500,2,1.75,1390,4482,1390,0,47.3785,-122.32
1.185E+06,3,2.25,2760,40946,2760,0,47.6501,-122.164
360000,4,2.5,3200,7282,3200,0,47.4318,-122.286
699999,3,0.75,1240,4000,1240,0,47.6239,-122.297
535000,3,2.5,1960,47044,1960,0,47.7573,-122.07
464950,3,2,2190,19800,2190,0,47.5106,-122.365
925000,4,2.5,3540,18168,3540,0,47.5441,-122.131
930000,3,3.25,2640,4080,1840,800,47.6636,-122.326
727500,3,2,2660,5000,1940,720,47.5829,-122.382
325000,4,1.75,1670,9500,1670,0,47.7254,-122.31
695000,3,3.25,3080,12100,2080,1000,47.695,-122.399
585000,4,2.75,2890,6825,1560,1330,47.734,-122.182
319000,3,2.25,1800,9597,1200,600,47.4516,-122.267
265000,6,2.5,2000,7650,1790,210,47.3841,-122.288
359000,5,1.75,1940,6654,1940,0,47.4663,-122.359
390000,5,1.75,1940,6654,1940,0,47.4663,-122.359
374500,3,1,960,9531,960,0,47.7619,-122.162
661000,2,1.5,1750,46173,1750,0,47.7397,-122.126
900000,3,2.5,2320,5000,1620,700,47.6278,-122.292
600000,5,2.5,2380,8204,1540,840,47.7,-122.287
2E+06,5,4.25,6490,10862,3940,2550,47.5728,-122.205
512500,4,1.75,1620,4240,1620,0,47.5746,-122.311
229500,3,1.75,1770,33224,1770,0,47.3377,-122.194
589000,3,2.5,2320,5663,2320,0,47.539,-122.07
539950,3,2.5,1330,2183,1330,0,47.6987,-122.365
640000,4,2.5,3420,21344,3420,0,47.45,-122.334
218250,3,1,1270,7344,970,300,47.305,-122.371
675000,4,3.5,2550,3600,1880,670,47.7709,-122.39
338000,5,2,1860,9000,1860,0,47.4484,-121.772
231750,3,1,1020,7615,1020,0,47.4292,-122.152
199900,1,1,720,7140,720,0,47.5119,-122.339
1.059E+06,4,3.5,4460,16271,4460,0,47.5862,-121.97
263000,4,2.75,1830,7315,1250,580,47.2989,-122.38
279950,3,1.5,1520,7200,1160,360,47.3855,-122.302
395000,3,1.5,1080,2940,1080,0,47.6832,-122.304
252500,3,2,1900,8002,1900,0,47.2909,-122.352
1.15E+06,4,3.75,5300,37034,5300,0,47.7283,-122.076
205000,3,1,1370,10708,1370,0,47.2769,-122.264
654000,5,2.5,2960,8968,1640,1320,47.6233,-122.102
200000,3,1,960,213008,960,0,47.5621,-121.862
700000,3,2.5,2190,7982,2190,0,47.6869,-122.187
2.72E+06,4,3.25,3990,18115,3990,0,47.6177,-122.229
306000,2,1.75,1200,2622,800,400,47.7175,-122.292
270000,3,2.5,1780,5015,1780,0,47.3352,-122.052
340000,3,2.25,2630,9916,2630,0,47.3314,-122.202
450000,4,2.5,2300,19250,2300,0,47.4793,-121.776
580000,4,2.75,3210,6825,1810,1400,47.7338,-122.169
435000,4,1.75,2290,4400,1290,1000,47.5698,-122.375
690000,4,2.5,2780,4688,2780,0,47.5225,-122.156
720000,4,2.5,2650,11520,2110,540,47.683,-122.187
403000,3,2.25,1840,13020,1390,450,47.6923,-122.095
440000,3,2.75,1560,7392,1030,530,47.7382,-122.182
178500,3,1,1200,8470,1200,0,47.3864,-122.287
270000,4,2.5,1900,8282,1900,0,47.2089,-122.003
129888,2,1,710,9900,710,0,47.479,-122.339
260000,3,1.75,1360,15210,1360,0,47.3657,-122.047
339950,5,2.5,2990,7292,2990,0,47.3604,-122.091
250000,3,1,1640,26127,1640,0,47.7656,-121.905
680000,3,3.5,3650,103672,2050,1600,47.4002,-122.217
660000,10,3,2920,3745,1860,1060,47.6635,-122.32
1.225E+06,3,3.5,3680,11491,3680,0,47.5647,-122.128
550000,3,2,1830,9152,1830,0,47.5531,-122.181
675000,5,2.75,2570,12906,2570,0,47.5814,-122.05
981000,3,3.25,2730,9588,1900,830,47.6339,-122.09
168000,3,1,1150,8000,1150,0,47.2749,-122.252
1E+06,4,3,4260,18687,4260,0,47.5874,-121.982
320000,3,1,1260,9600,1260,0,47.4444,-121.762
959000,6,3.25,4440,17424,2220,2220,47.5791,-122.23
372000,4,1,2300,7680,1270,1030,47.524,-122.359
391500,3,2.5,1920,9625,1920,0,47.4876,-121.8
390000,2,1,1080,4725,1080,0,47.5275,-122.381
302000,2,1,890,5000,890,0,47.5526,-122.287
495000,3,3.5,1650,1577,1100,550,47.6302,-122.344
504500,3,2.5,1820,1545,1640,180,47.6523,-122.346
555000,4,1.75,2320,4800,2170,150,47.6893,-122.365
1.55E+06,4,3.5,3260,5000,2630,630,47.6598,-122.273
550000,3,1.5,1730,5750,1250,480,47.5645,-122.397
1.8E+06,4,2.5,3320,8325,3320,0,47.6263,-122.314
655000,1,1,1660,5422,830,830,47.6821,-122.388
685000,3,2.5,3290,90796,3290,0,47.3154,-122.079
721000,4,2,2280,8339,1220,1060,47.6986,-122.297
1.51863E+06,4,4.25,3650,5328,2330,1320,47.638,-122.362
365000,4,2.5,1620,219542,1620,0,47.4014,-122.069
458000,3,2,2020,8555,1220,800,47.7278,-122.287
280000,2,1,1150,12861,1150,0,47.4493,-122.171
628000,4,1.75,1940,3060,1000,940,47.6786,-122.317
781500,4,2.5,3440,6332,3440,0,47.5347,-122.155
295000,3,1.75,2000,7560,1300,700,47.4346,-122.171
435000,2,1,750,2786,750,0,47.6892,-122.393
300000,3,1.75,1420,7200,1000,420,47.5069,-122.367
208500,2,1,880,4814,880,0,47.3107,-121.999
930000,2,2.5,2680,11214,2680,0,47.7078,-122.019
316000,2,2,860,3000,860,0,47.5633,-122.288
249900,3,2,1310,6738,1310,0,47.3694,-122.083
675000,3,2.25,1780,4252,1540,240,47.6004,-122.292
447000,3,2.25,1440,4667,1440,0,47.5662,-122.017
675000,3,2,1510,3817,1510,0,47.6088,-122.294
546000,4,2.5,2100,1397,1580,520,47.5928,-122.295
310000,3,2,1310,1361,1310,0,47.7337,-122.343
190000,3,1,1280,5100,880,400,47.5035,-122.259
650000,3,1.5,1320,8114,1320,0,47.5827,-122.195
585000,3,2.5,1740,2350,1130,610,47.6207,-122.297
1.4308E+06,4,2.5,2910,7364,2910,0,47.6906,-122.213
565000,4,2.5,2500,12090,2500,0,47.6346,-122.045
174900,3,1,1100,6000,1100,0,47.5279,-122.318
360000,3,2.25,1381,1180,1381,0,47.711,-122.32
234000,3,1,960,9624,960,0,47.7758,-122.301
575000,8,3,3840,15990,2530,1310,47.7111,-122.211
315000,3,2.5,2200,5954,2200,0,47.3709,-122.125
225000,3,1,1250,7820,1250,0,47.3397,-122.291
370000,3,1.5,2380,14500,1850,530,47.7714,-122.256
606000,3,1,1500,3920,1000,500,47.6718,-122.359
272500,3,2,1410,7622,1410,0,47.4273,-122.147
475000,3,1.75,1680,3420,960,720,47.6855,-122.291
270000,3,1,1500,13500,1500,0,47.4666,-122.072
624000,4,1.75,2710,9216,1440,1270,47.5523,-122.379
355000,3,1.75,1730,7416,1730,0,47.76,-122.349
345000,3,1,960,3844,960,0,47.7027,-122.346
342000,4,2.5,2380,7792,2380,0,47.3273,-122.173
316000,3,1.75,1120,98445,1120,0,47.1853,-122.017
539950,4,2.5,2960,37430,2960,0,47.3988,-122.023
221347,3,2,1580,6655,790,790,47.4927,-122.248
330000,3,2.5,1870,4657,1870,0,47.4615,-122.214
279000,4,2.5,1810,13000,1470,340,47.2202,-121.993
850000,4,3,2550,3784,1750,800,47.6559,-122.338
746000,3,1.75,1910,12321,1100,810,47.5995,-122.198
478000,2,2,1200,1867,600,600,47.627,-122.345
820000,4,2.75,2420,4635,2420,0,47.682,-122.347
2.16E+06,3,3.5,3080,6495,2530,550,47.6321,-122.393
820000,3,3,3850,38830,3850,0,47.5535,-122.191
887000,3,2,3000,22040,2470,530,47.7745,-122.368
159000,3,1,1360,20000,1360,0,47.2861,-122.253
824000,7,4.25,3670,4000,2800,870,47.6375,-122.388
812000,4,2.5,2270,5000,2270,0,47.6916,-122.37
242000,4,2.5,1750,11400,1750,0,47.3149,-122.386
625000,4,2.5,3550,8048,3550,0,47.5422,-121.888
399888,4,1,2370,30200,1570,800,47.5108,-122.366
289000,3,2.25,1670,6600,1670,0,47.3604,-122.089
400000,3,2,1860,12944,1860,0,47.4298,-122.102
1.55E+06,3,2.5,4460,26027,4460,0,47.6573,-122.173
345000,2,1,1080,4000,1080,0,47.6902,-122.387
874950,2,1,1080,4000,1080,0,47.6902,-122.387
875000,3,2.75,2280,4280,1280,1000,47.6685,-122.335
628990,4,2.5,2540,32647,2540,0,47.6324,-121.988
535000,2,3.5,2560,5000,1280,1280,47.6681,-122.368
770126,4,2.75,2390,9300,1430,960,47.6035,-122.206
710000,4,2.5,2870,8995,1870,1000,47.5678,-122.128
465000,3,1.75,1510,4800,860,650,47.5667,-122.372
359000,3,1.75,2200,11520,2200,0,47.7659,-122.341
151000,2,0.75,720,5040,720,0,47.5323,-122.347
820000,3,2.5,2970,9600,2970,0,47.5422,-122.132
160000,3,1.5,960,6497,960,0,47.3018,-122.378
535000,4,1.75,1420,5000,1420,0,47.6771,-122.397
365000,3,2.25,1800,9010,1300,500,47.7722,-122.312
708000,4,2.5,3090,5600,3090,0,47.597,-121.979
215000,3,1,1200,7280,1200,0,47.3724,-122.277
1.95E+06,4,3.5,4065,18713,4065,0,47.6209,-122.237
390000,4,2.5,2570,22215,2570,0,47.4833,-122.157
570000,3,2,1530,5401,1530,0,47.686,-122.304
383000,3,1.75,1500,13430,1500,0,47.7527,-122.082
370000,4,3,2490,5706,2490,0,47.3509,-122.165
454000,4,2.5,3040,12522,3040,0,47.7247,-121.959
1.4E+06,5,3.25,4140,32700,2190,1950,47.7633,-122.369
371000,4,1.75,1690,10854,1690,0,47.5241,-122.199
530000,3,1.75,1430,10350,1430,0,47.6353,-122.123
608000,4,2.75,2490,9714,1400,1090,47.7496,-122.201
450000,3,1.75,1350,7200,1350,0,47.713,-122.284
780000,4,2.5,3140,14421,3140,0,47.5943,-122.018
290000,4,2.5,2340,52272,2340,0,47.3468,-122.091
225000,3,1.75,1610,14182,1100,510,47.3174,-122.18
805000,4,2.5,3320,38032,3320,0,47.7478,-122.036
660000,3,2.5,2390,15669,2390,0,47.7446,-122.193
299000,3,1.75,1180,13927,1180,0,47.4818,-122.094
530000,2,2.25,1260,1312,1260,0,47.6538,-122.356
680000,3,2.5,1800,4400,1350,450,47.6599,-122.396
199900,4,1.75,1790,12000,1790,0,47.2664,-122.256
224000,3,1.75,1760,6300,1060,700,47.5003,-122.26
244000,3,1.75,1540,8885,1440,100,47.4031,-122.201
485000,4,1.75,1260,3880,860,400,47.687,-122.391
330000,4,2.5,2240,7589,2240,0,47.3824,-122.207
509000,4,2,1630,1724,1030,600,47.6472,-122.362
440000,4,2.5,2350,7203,2350,0,47.5123,-122.151
244000,3,2,1350,8587,1350,0,47.2073,-122.012
399700,4,1.75,1320,4800,870,450,47.5534,-122.365
519000,4,2.5,1950,2617,1250,700,47.6696,-122.372
211000,4,1,2100,9200,1050,1050,47.476,-122.292
950000,3,2.5,3480,7800,1750,1730,47.7047,-122.378
410000,3,2.5,1830,2839,1830,0,47.6022,-122.021
750000,4,2,2640,5000,2040,600,47.678,-122.375
133400,3,1,900,2550,900,0,47.3036,-122.363
240000,3,2,1553,6550,1553,0,47.2056,-121.994
539000,3,2.5,1710,2300,1570,140,47.6743,-122.142
688000,4,3,3400,292723,3400,0,47.4883,-121.725
465000,3,1.5,1270,5112,1270,0,47.676,-122.288
936000,3,1.75,2960,12420,1480,1480,47.5739,-122.406
620000,4,2.5,3040,9606,3040,0,47.6884,-122.044
429950,3,1.75,1430,9750,1430,0,47.7441,-122.357
296475,3,2.5,1520,4170,1520,0,47.3842,-122.04
330000,4,2,1820,9450,1100,720,47.7607,-122.329
445000,3,2.25,1800,11200,1270,530,47.7072,-122.164
846000,4,3.25,2720,4000,2070,650,47.5554,-122.267
725000,4,1.75,1980,5850,1380,600,47.5607,-122.391
369000,4,2.5,2550,7349,2550,0,47.3059,-122.349
625000,3,1.75,2210,16200,1390,820,47.5924,-122.175
535000,3,2,2120,4080,2120,0,47.682,-122.037
229950,4,1.5,1570,6717,1570,0,47.307,-122.217
229999,3,1.75,1310,6960,1310,0,47.2761,-122.153
850000,5,3.5,3150,4120,2460,690,47.6754,-122.315
589900,4,4.5,3870,35889,2530,1340,47.4677,-122.01
513000,2,1,1840,4322,1160,680,47.5764,-122.289
401000,3,1,1120,8321,1120,0,47.5631,-122.091
260000,3,2.5,1440,2500,1440,0,47.511,-122.359
525000,4,2.75,2300,26650,2300,0,47.7771,-122.362
470000,3,3.5,2070,11658,1370,700,47.537,-122.178
205000,4,1.5,1420,8063,940,480,47.4174,-122.316
620000,3,2.25,2010,7495,1570,440,47.5613,-122.083
229000,3,1.5,1200,5000,1200,0,47.5122,-122.357
445000,2,2,1150,6634,860,290,47.7001,-122.309
215000,2,1,1240,7200,1240,0,47.4971,-122.282
504975,2,2.5,1900,4871,1900,0,47.7132,-122.034
495000,4,2.25,2350,10072,2350,0,47.7628,-122.168
205000,3,1,1120,8342,1120,0,47.3732,-122.116
152275,1,1,1020,6871,1020,0,47.5051,-122.338
586000,4,2.25,1930,8338,1930,0,47.7026,-122.285
779950,2,2.5,2680,7625,2680,0,47.7094,-122.024
557000,4,1.75,2660,11315,2660,0,47.6204,-122.044
610000,4,2.25,2200,7200,1220,980,47.5818,-122.296
405000,3,1.5,1010,7683,1010,0,47.72,-122.318
320000,4,2.25,2310,7490,2310,0,47.4379,-122.192
356000,3,1,920,3863,920,0,47.5524,-122.27
794500,5,3,3030,4120,1930,1100,47.6771,-122.319
349000,3,1.75,1590,9620,1590,0,47.4815,-122.152
549000,4,2.25,2740,88426,2740,0,47.4734,-122.006
193000,3,1,960,10761,960,0,47.2819,-122.224
700000,3,1.5,2240,7227,1440,800,47.6208,-122.093
523000,3,2.5,2400,6182,2400,0,47.5363,-121.87
565000,5,3.25,2860,20790,1800,1060,47.7757,-122.295
500000,4,2.5,2960,5027,2960,0,47.5328,-121.881
1.45E+06,4,3.25,3770,4103,2710,1060,47.641,-122.349
710000,6,3.5,3830,68825,3830,0,47.4574,-122.003
333000,4,2,2750,9001,2750,0,47.457,-122.189
580000,3,1.75,2100,6874,1300,800,47.6724,-122.279
289950,4,1.75,1500,8400,1200,300,47.4531,-122.273
375000,2,1,710,4618,710,0,47.64,-122.394
505000,2,3,2770,10800,1910,860,47.6082,-122.057
324950,3,1.75,2050,6720,1050,1000,47.5058,-122.235
490000,4,2.25,1960,10275,1960,0,47.6887,-122.124
630000,4,2,1770,6000,1770,0,47.6493,-122.401
595000,3,2.75,3290,22649,3290,0,47.5241,-122.193
872500,4,2,1990,6000,1260,730,47.6515,-122.397
490000,2,1,1760,5250,1000,760,47.5577,-122.379
1.9E+06,4,3.25,5080,27755,5080,0,47.5423,-122.111
310000,2,1,1020,8102,1020,0,47.5135,-122.193
450000,3,1,1350,92721,1200,150,47.4657,-122.198
539000,3,1.5,1740,12000,1740,0,47.6276,-122.053
888550,3,2.5,3540,38322,3540,0,47.6892,-122.048
269950,3,2.5,1520,8720,1080,440,47.4267,-122.157
142000,0,0,290,20875,290,0,47.5308,-121.888
300000,3,1.75,1310,9761,1310,0,47.721,-122.228
780000,2,3.25,3000,24004,2410,590,47.611,-122.157
545000,3,2.5,2660,20369,2660,0,47.5234,-122.055
278000,3,2.25,2120,9804,2120,0,47.3596,-122.16
342000,3,2.25,1200,2845,1200,0,47.7151,-122.203
190000,4,1.75,1900,9861,1900,0,47.3615,-122.057
387000,2,1.5,1010,948,1010,0,47.6529,-122.355
279950,3,2.25,1850,7480,1850,0,47.452,-122.159
550000,6,4.5,4520,40164,3580,940,47.407,-122.216
439000,3,2,2010,251341,1510,500,47.7416,-121.91
774888,3,2.25,2420,23507,2420,0,47.5107,-122.027
480000,5,2.5,2732,9500,1870,862,47.3436,-122.323
835000,4,2,1910,6960,1910,0,47.6893,-122.348
1.5E+06,5,3.5,3520,5400,2400,1120,47.6364,-122.363
771000,4,2,2220,3760,1370,850,47.6876,-122.368
1.225E+06,4,2.25,2020,5800,1760,260,47.6471,-122.412
600000,4,2.5,2090,7290,1420,670,47.624,-122.142
305000,3,1,1580,7424,1010,570,47.4607,-122.171
1.388E+06,5,1.75,2650,11340,2650,0,47.626,-122.213
216500,3,1,1020,11652,1020,0,47.4459,-122.278
370000,3,2.5,1070,1219,720,350,47.5618,-122.384
492650,4,1.75,2120,9786,1640,480,47.7753,-122.365
431200,5,1.75,1360,10609,1060,300,47.7203,-122.229
277500,4,2,1700,12048,1700,0,47.3748,-122.186
278000,5,1.5,1820,8712,1090,730,47.3712,-122.289
351000,4,1,1430,8400,730,700,47.7417,-122.172
850000,4,3.5,4140,7089,3160,980,47.7059,-122.2
885000,2,2,1313,3600,1313,0,47.6369,-122.365
399950,3,2,1590,87120,1590,0,47.2241,-122.072
185000,3,1.75,1080,9262,1080,0,47.4883,-122.248
440000,5,3,2730,6000,1470,1260,47.4994,-122.234
2.395E+06,4,3.25,3800,19798,3800,0,47.5684,-122.19
299000,3,2.25,2540,9961,1320,1220,47.41,-122.208
299500,3,1.75,1810,34500,1230,580,47.3707,-122.275
420000,3,1.5,1540,7506,1540,0,47.7565,-122.325
234000,4,1,1390,18000,1390,0,47.3885,-122.284
540000,2,1.75,1460,4800,850,610,47.6928,-122.339
649950,4,2.5,2350,63162,2350,0,47.7545,-122.047
330000,3,1,1160,7912,1160,0,47.7336,-122.306
840000,4,3.25,3500,5960,3500,0,47.6944,-122.022
370000,3,2.5,1980,6922,1980,0,47.396,-122.184
410000,3,1.5,1250,7700,1250,0,47.5383,-122.178
257000,2,1,770,7200,770,0,47.7143,-122.325
350000,3,1,1920,6710,1320,600,47.5346,-122.286
380000,2,1,1120,7560,1120,0,47.77,-122.39
344000,3,1,1150,12402,1150,0,47.7422,-122.099
488000,3,2.5,1590,2550,1590,0,47.6772,-122.393
465000,3,1,910,3880,780,130,47.6862,-122.392
229500,2,1.75,1870,6625,960,910,47.5071,-122.249
445000,5,3,2420,11250,2420,0,47.5082,-122.362
246000,4,1.5,2120,7110,2120,0,47.3846,-122.227
545000,5,2.5,2730,17240,1660,1070,47.7646,-122.267
518000,4,2.5,2560,5672,2560,0,47.5222,-122.201
565000,4,2.5,2620,10016,2620,0,47.5295,-122.179
445000,4,2.5,2760,8558,2760,0,47.4802,-122.189
968000,5,2.5,2900,9799,1450,1450,47.6255,-122.208
725000,3,2,1820,6324,910,910,47.6823,-122.27
315500,3,1.75,1870,8400,990,880,47.454,-122.164
487585,4,1.75,2010,9211,1470,540,47.7206,-122.171
246500,2,1,940,6000,940,0,47.4631,-122.329
819000,3,1.75,1850,6000,1650,200,47.6528,-122.401
349900,5,2.5,2530,4229,2530,0,47.3531,-122.021
267000,3,1,940,4700,940,0,47.5117,-122.378
480000,3,2.25,1820,15000,1480,340,47.7401,-122.249
525000,2,1,1510,3360,880,630,47.6135,-122.297
578000,4,2.5,2070,5415,2070,0,47.5706,-122.006
345000,3,2.5,1380,1547,1380,0,47.6908,-122.341
499000,3,1,1270,6250,910,360,47.5694,-122.397
425000,3,1.5,1390,9680,1390,0,47.634,-122.125
268000,4,3,1840,7510,1840,0,47.2595,-122.218
240000,3,1,1600,12566,1600,0,47.4431,-121.765
147000,3,1.5,1480,9606,1100,380,47.2978,-122.363
500000,4,2,2120,7806,1770,350,47.6859,-122.166
1.01E+06,4,2.75,2940,5400,1940,1000,47.6366,-122.369
991500,4,3,3820,26895,3820,0,47.7253,-122.092
510000,5,2,2740,3838,1370,1370,47.6819,-122.393
1.98E+06,4,4,4360,12081,4360,0,47.6377,-122.219
484998,4,2.5,1540,1870,1540,0,47.5524,-121.999
1.28E+06,4,3.5,4660,17398,4660,0,47.5422,-122.112
210000,3,1.75,1590,7617,1590,0,47.3819,-122.312
450000,2,1,1180,10720,1180,0,47.5893,-122.135
875000,4,1.75,2360,8286,1320,1040,47.6226,-122.205
529950,4,2.75,1860,7500,1220,640,47.5398,-122.173
415000,3,1.75,1470,4000,1070,400,47.6067,-122.298
590000,4,2,2990,12970,1960,1030,47.7605,-122.258
379950,3,1.5,1690,9144,1140,550,47.739,-122.253
385000,1,1,660,3570,660,0,47.5659,-122.284
588000,3,1.75,2310,7620,2310,0,47.7266,-122.363
252500,2,1,770,2191,770,0,47.5512,-122.323
530000,3,3.5,2320,3174,2060,260,47.6897,-122.175
385000,2,1.5,1370,159865,1370,0,47.7592,-122.092
419000,3,2.25,1700,7650,1340,360,47.7214,-122.166
175000,2,1,960,5508,770,190,47.5307,-122.277
515000,2,1,1150,5664,870,280,47.6894,-122.284
945000,4,2.5,2910,4680,1850,1060,47.6745,-122.31
359900,5,2.25,2290,7420,1290,1000,47.4375,-122.166
419950,4,2.5,2260,5164,2260,0,47.509,-122.166
460000,3,1.75,1300,4000,900,400,47.6368,-122.388
255000,3,2.25,1850,7151,1850,0,47.2843,-122.352
481000,4,1.75,1920,9500,1470,450,47.5683,-122.177
719521,4,1.75,1920,9500,1470,450,47.5683,-122.177
1.08E+06,3,3,4910,43560,4000,910,47.5911,-122.131
334000,4,2.5,2210,6080,1410,800,47.4915,-122.228
675000,4,2.75,2280,3200,1520,760,47.6709,-122.282
556000,3,1.75,1640,7437,1090,550,47.5324,-122.38
900000,4,2,1980,7200,1700,280,47.6318,-122.369
400000,3,1,900,4084,900,0,47.684,-122.393
724950,4,1.75,1960,4340,980,980,47.6847,-122.37
321000,4,2.25,1800,4500,1800,0,47.394,-122.183
1.35692E+06,4,3.5,4270,5800,3170,1100,47.6474,-122.411
171000,4,2,1520,19672,1020,500,47.4683,-122.281
1.36E+06,4,3,5430,108900,5430,0,47.6582,-122.038
323000,3,1.75,1950,15037,1950,0,47.6892,-121.913
491500,4,1.75,2190,125452,2190,0,47.2703,-122.069
226000,4,1.5,1200,10890,1200,0,47.3423,-122.088
580000,6,1.75,2180,4000,1380,800,47.6643,-122.29
640000,4,2.5,2320,11259,2320,0,47.6443,-122.194
619790,3,1.75,1040,5097,800,240,47.6385,-122.401
383962,4,2.5,2700,6998,2700,0,47.4694,-122.263
373000,3,2,1400,2445,840,560,47.5926,-122.299
541338,3,2.5,2060,8123,1010,1050,47.6642,-122.13
254922,2,1,780,8160,780,0,47.7356,-122.34
575000,3,2.25,2400,5000,1440,960,47.6897,-122.393
650000,4,3,2900,15535,1870,1030,47.612,-122.119
269950,3,1.5,1740,9547,1740,0,47.4475,-122.213
270950,2,1,780,6250,780,0,47.5099,-122.33
495000,3,2.75,2430,14861,1530,900,47.7461,-122.247
794154,4,2,2210,8556,1210,1000,47.6498,-122.396
340768,3,1.5,1510,11200,1510,0,47.3347,-122.325
375000,2,1,900,5413,900,0,47.7047,-122.307
820000,4,2.5,3670,7000,3670,0,47.5854,-122.08
555000,2,2.25,1160,954,960,200,47.6647,-122.284
312500,2,1.5,1070,1200,1070,0,47.697,-122.347
450000,2,1,950,4560,950,0,47.6288,-122.3
739000,3,2.75,2950,6667,2950,0,47.5577,-122.026
320000,3,2,1420,1716,1050,370,47.7364,-122.295
235000,3,1,1590,13000,1590,0,47.4789,-122.346
275500,4,1,1290,5000,1290,0,47.5128,-122.358
564000,2,2,1690,4500,1690,0,47.7133,-122.031
263000,4,1.75,1340,8700,1340,0,47.4514,-122.287
257000,3,1.75,1397,18000,1397,0,47.3388,-122.166
725000,4,2.5,3750,218506,3750,0,47.3045,-122.103
300000,3,2.25,2000,7560,1400,600,47.4798,-122.228
328000,3,2,2250,7904,2250,0,47.3165,-122.252
187500,3,1,840,8400,840,0,47.3281,-122.344
400000,3,1,1100,5100,1100,0,47.679,-122.386
515000,3,1.5,1660,5100,1210,450,47.5345,-122.383
1.41E+06,2,2,2180,18525,1580,600,47.5036,-122.387
235000,3,1,1460,8400,1460,0,47.4243,-122.198
669000,4,2.5,2470,4945,2470,0,47.6898,-122.015
282000,3,1,1250,13503,1250,0,47.526,-121.829
663000,3,2,1480,3876,860,620,47.6808,-122.382
279900,3,3.25,2240,5000,1540,700,47.4114,-122.334
335000,3,2,1570,7200,1570,0,47.7501,-122.314
689000,4,2.75,3250,10000,3250,0,47.7557,-122.309
413100,3,2.25,1790,231303,1250,540,47.7558,-122.027
506950,3,2.5,2080,4931,2080,0,47.5342,-121.868
500000,3,2.5,1480,1171,1480,0,47.62,-122.3
540000,5,3,3610,9775,3610,0,47.3545,-122.011
812000,3,2.5,2040,4559,2040,0,47.6156,-122.295
1.2E+06,4,3.25,3850,19842,3180,670,47.6239,-122.065
370000,3,2.25,3230,35306,3230,0,47.3065,-122.113
338000,3,2,2440,23512,1640,800,47.4594,-122.326
185000,4,1,1490,6600,1490,0,47.4835,-122.332
450000,3,1,1150,35415,1010,140,47.5974,-122.129
451000,2,1,900,6000,900,0,47.6855,-122.289
785000,4,2.5,3210,24527,3210,0,47.6399,-122.052
850000,5,3,3900,5250,2620,1280,47.5577,-122.389
235000,3,1,1240,18000,1240,0,47.3514,-122.315
1.15E+06,3,1.75,1760,6788,1760,0,47.7336,-122.284
377500,3,2.25,1410,1377,1290,120,47.5342,-122.067
825500,3,2.5,2780,11964,2780,0,47.7127,-122.216
1.0595E+06,5,3.25,3230,3825,2480,750,47.6785,-122.392
880000,5,3.5,4600,8764,3180,1420,47.5491,-122.19
413800,3,2,1440,4421,1440,0,47.7188,-122.024
504200,2,1.5,1200,1687,1200,0,47.6491,-122.334
421500,4,3,2793,5703,2793,0,47.3682,-122.178
855169,4,2.5,2970,5050,2970,0,47.7043,-122.122
380000,3,2,1440,3218,850,590,47.5655,-122.36
580000,3,2.25,1480,1026,1480,0,47.6536,-122.354
377000,3,2.5,1870,5333,1870,0,47.7447,-121.984
329900,4,2.75,2475,4000,2475,0,47.3452,-122.209
921800,4,2.5,2950,7024,2950,0,47.6651,-122.403
529500,3,2.25,1410,905,1410,0,47.5818,-122.402
363990,4,2.5,2240,3712,2240,0,47.3551,-122.061
834950,5,2.75,3230,6500,3230,0,47.6237,-122.023
399000,3,2,2100,31550,2100,0,47.6907,-121.917
338900,3,2.25,1936,9495,1936,0,47.3714,-122.197
419950,3,2.5,3120,6000,3120,0,47.3473,-122.03
493000,4,2.5,2070,4270,2070,0,47.773,-122.265
650000,4,2.5,3700,4500,3700,0,47.7473,-122.23
456000,3,2.5,2130,5205,2130,0,47.4832,-121.774
425000,3,2.25,1620,997,1540,80,47.54,-122.026
348000,3,2.5,1490,2478,1490,0,47.7236,-122.353
1.04089E+06,5,4,4180,7232,4180,0,47.7049,-122.125
299000,2,2.5,1400,1262,1160,240,47.5342,-122.349
1.264E+06,4,3.75,3490,9170,3490,0,47.5991,-122.2
155000,3,1,1300,6098,1300,0,47.7074,-121.364
319500,4,2.5,2730,4962,2730,0,47.3363,-122.216
274000,3,2.5,1830,2517,1830,0,47.4496,-122.189
429000,5,2.5,2340,4500,2340,0,47.4911,-122.154
267800,3,1.75,1410,1899,1410,0,47.5171,-122.347
369950,3,2.5,1930,8254,1930,0,47.4973,-122.346
480000,6,5,3028,18055,3028,0,47.3651,-122.197
440000,4,3.5,3180,4869,2390,790,47.4482,-122.206
839704,4,3.25,2950,4161,2210,740,47.5297,-122.073
535000,3,3.25,1430,1276,1430,0,47.6712,-122.38
290000,2,1.5,1020,1275,1020,0,47.7003,-122.346
370000,3,2.5,1650,1793,1650,0,47.7107,-122.332
405000,3,2,1060,651,1060,0,47.6828,-122.345
499431,4,2.75,2620,6019,2620,0,47.484,-121.771
275000,4,2.5,1830,3868,1830,0,47.5186,-122.276
320000,3,2.25,998,844,798,200,47.6983,-122.367
425000,4,2.5,2070,4427,2070,0,47.5208,-121.869
1.45E+06,4,3.5,2860,2199,2860,0,47.6262,-122.323
340000,3,2,1920,5688,1920,0,47.1952,-121.976
299900,3,2.5,1210,2046,920,290,47.5212,-122.357
865950,5,3.5,4890,12039,3590,1300,47.7338,-122.208
720000,4,2.5,3420,17038,3420,0,47.718,-122.241
460000,4,3.5,2870,3225,2070,800,47.5009,-122.225
375000,3,2.5,1600,2042,1600,0,47.5341,-122.067
386180,2,1.5,960,1829,960,0,47.6032,-122.308
280000,3,2.75,1740,5639,1740,0,47.1942,-121.977
359000,4,2.5,2575,4725,2575,0,47.3058,-122.277
785000,5,3.25,3660,11995,3660,0,47.5337,-121.86
425000,3,2.25,1420,1230,940,480,47.5703,-122.288
575000,5,2.5,3070,7200,3070,0,47.4939,-122.137
465000,3,2.5,1920,144619,1920,0,47.2683,-121.946
1.85E+06,4,3.25,4160,10335,4160,0,47.6235,-122.192
720000,4,3.25,3276,10801,3276,0,47.4585,-122.361
390000,5,3.75,2890,5000,1310,1580,47.5701,-122.296
2.205E+06,3,2.5,3430,10177,3430,0,47.7159,-122.251
1.05469E+06,4,3.5,3390,3979,2610,780,47.6482,-122.408
915000,6,3.75,2930,14980,2930,0,47.5441,-122.117
562000,2,2.25,1300,1314,1300,0,47.6536,-122.356
349000,2,1.75,1250,1208,1040,210,47.6004,-122.299
375000,4,2.5,2310,7800,2310,0,47.3737,-122.164
479950,2,2.25,1360,1336,1360,0,47.6714,-122.392
319000,4,2.5,2020,5100,2020,0,47.2822,-122.357
325000,3,1.5,1270,1067,1270,0,47.7236,-122.353
505657,4,2.75,2790,8092,2790,0,47.4834,-121.773
340000,4,2.5,2320,4142,2320,0,47.3662,-122.019
250000,3,2.5,1750,6351,1750,0,47.2589,-122.256
349500,4,2.5,2030,4596,2030,0,47.3515,-122.275
290750,3,2.5,1270,865,1080,190,47.5351,-122.279
715000,5,3.25,2710,2356,2230,480,47.5394,-122.028
689950,4,2.75,2520,8433,2520,0,47.7214,-122.289
425000,2,2.5,1340,1263,1340,0,47.6788,-122.388
657000,2,3,1570,1281,1570,0,47.6741,-122.384
359950,4,3.5,2690,5564,2690,0,47.3537,-122.018
319900,4,2.75,2475,4276,2475,0,47.345,-122.21
532000,3,3.75,2260,2050,1170,1090,47.566,-122.29
291000,2,1,840,863,840,0,47.6974,-122.349
675000,3,3.25,1720,1330,1030,690,47.62,-122.309
885000,3,2.25,2940,6500,2940,0,47.5482,-122.388
1.45E+06,5,3.5,4170,9090,4170,0,47.5918,-122.196
780000,6,4.25,4310,10000,2950,1360,47.6214,-122.062
839950,4,2.75,3010,7200,3010,0,47.6948,-122.179
645000,3,2.5,2170,1984,2170,0,47.5401,-122.027
263000,3,2.5,1584,3200,1584,0,47.3451,-122.215
345000,2,2.25,1110,1290,1110,0,47.6968,-122.34
505000,4,2.5,2420,5006,2420,0,47.4795,-122.126
522500,2,2.25,1430,1210,1340,90,47.6765,-122.301
400000,3,2.5,2393,4788,2393,0,47.4517,-122.204
543000,3,2.25,1240,949,1240,0,47.6488,-122.334
495000,4,2.5,2980,12075,1910,1070,47.5074,-122.172
549995,4,3.5,2970,6587,2260,710,47.4776,-122.122
327555,3,2.5,2329,5720,2329,0,47.362,-122.2
690000,5,3.25,3340,9075,2600,740,47.5446,-121.88
673000,4,2.25,2580,2875,2580,0,47.5674,-122.392
384435,3,2.5,2029,3906,2029,0,47.341,-122.18
780000,4,2.75,3430,6500,3050,380,47.7079,-122.106
1.375E+06,5,3.75,3330,5042,2470,860,47.6497,-122.339
950968,5,3.5,3220,5081,3220,0,47.7048,-122.111
334950,2,2.25,1240,750,1150,90,47.5322,-122.073
489000,3,3.5,1500,1249,1240,260,47.6727,-122.373
600000,3,3,3530,8345,3530,0,47.7338,-122.234
282000,3,2.25,1260,915,1020,240,47.555,-122.363
442000,4,4,4168,8485,3222,946,47.3029,-122.387
220000,2,1.5,1030,2850,1030,0,47.3845,-122.039
489000,3,2.5,3080,5598,3080,0,47.4372,-122.206
250000,3,1.5,1072,4339,1072,0,47.386,-122.162
484259,4,2.75,2790,5000,2790,0,47.4831,-121.773
1.68E+06,3,2.5,4090,16972,3590,500,47.7258,-122.37
450000,3,2.5,1800,4357,1800,0,47.5337,-121.841
299000,2,1.5,830,1276,830,0,47.6175,-122.297
450000,3,2.5,2280,4557,2280,0,47.7733,-122.266
585000,4,3,2110,1286,1710,400,47.5444,-122.014
660000,3,2.25,1570,1680,1570,0,47.6585,-122.348
301500,2,1.5,830,1333,830,0,47.5506,-122.381
949950,4,3.75,4120,8258,4120,0,47.5872,-122.055
759990,4,2.5,2540,5760,2540,0,47.5405,-121.993
355000,4,2.75,2050,4000,2050,0,47.3522,-122.275
889950,4,2.75,3080,7242,3080,0,47.6948,-122.178
629800,3,2.5,2390,1984,2220,170,47.5405,-122.027
745000,4,2.5,3170,5100,3170,0,47.5187,-122.208
379900,2,1.5,1240,1331,1050,190,47.5959,-122.298
335000,3,2.5,1090,1139,960,130,47.5664,-122.369
809000,5,4.5,4630,6324,3210,1420,47.5382,-121.86
569950,4,2.5,3230,5899,3230,0,47.515,-121.869
723000,4,3.5,3510,9263,3510,0,47.5413,-121.877
282000,4,2.5,1785,2552,1785,0,47.3582,-122.2
569900,5,3.25,2360,3873,1990,370,47.5635,-122.299
385000,4,2,2340,9716,2340,0,47.4842,-122.347
420000,3,2.25,1620,1075,1540,80,47.5405,-122.026
2.25E+06,3,3.25,3890,3452,2890,1000,47.626,-122.323
1.205E+06,4,3.5,3590,5335,3140,450,47.6762,-122.267
292000,4,3,1984,4460,1984,0,47.3532,-122.211
645000,3,2.25,1640,1023,1640,0,47.6636,-122.319
304500,4,2,1350,942,1350,0,47.5394,-122.026
489500,4,3.5,2730,5707,2000,730,47.7327,-121.965
1.583E+06,4,4,5610,11063,4750,860,47.65,-122.065
390000,2,1,962,1992,962,0,47.6911,-122.313
815000,4,3.5,3040,4006,2350,690,47.5439,-122.011
719000,3,3.5,2540,10578,2010,530,47.547,-122.192
331210,4,2.5,2240,4800,2240,0,47.2911,-122.266
245000,3,1.5,1260,1270,1040,220,47.7111,-122.331
465000,5,4,3210,7200,2410,800,47.7329,-121.966
580000,3,2.5,1620,1171,1470,150,47.6681,-122.355
540000,3,2,1580,1972,1180,400,47.5903,-122.386
399000,3,2.5,1430,1250,1430,0,47.6904,-122.342
328000,4,2.5,1850,5388,1850,0,47.3494,-122.041
701000,4,2.5,3340,5314,3340,0,47.5167,-121.885
408000,3,2.75,2670,4800,2670,0,47.3483,-122.042
2.6411E+06,5,4.25,4660,16200,4660,0,47.6326,-122.216
445000,3,2.5,1550,930,1060,490,47.5857,-122.314
672500,4,2.5,3470,6651,3470,0,47.5426,-121.879
538000,3,2.5,3010,7014,3010,0,47.4949,-122.149
450000,5,3.5,3931,9497,2650,1281,47.3008,-122.386
362500,3,2.5,1800,2700,1800,0,47.5458,-122.369
414950,3,2.5,1570,1551,1570,0,47.6961,-122.341
679950,3,2.5,2230,3939,2230,0,47.73,-122.335
290000,4,2.5,2423,7292,2423,0,47.3227,-122.37
230000,3,2,1160,1174,790,370,47.5225,-122.357
439950,2,2,1440,4666,1440,0,47.709,-122.019
349900,4,2.5,2052,3723,2052,0,47.2824,-122.295
550000,5,2.5,2780,9272,2780,0,47.5168,-122.378
1.05E+06,4,4.25,3720,5750,2960,760,47.5632,-122.399
655000,2,2.25,1460,1851,1180,280,47.6461,-122.362
385000,3,3.5,1370,1540,1100,270,47.5638,-122.388
729999,6,4.5,3600,6110,2510,1090,47.5687,-122.291
523950,3,2.25,1420,1282,1420,0,47.6533,-122.346
369000,2,2.5,980,895,670,310,47.5874,-122.386
509900,3,2.5,1790,2700,1790,0,47.564,-122.093
282000,3,2.5,2010,5399,2010,0,47.3338,-122.052
387865,3,2.5,2370,4200,2370,0,47.3696,-122.018
385000,4,2.5,2560,6238,2560,0,47.4899,-122.255
536000,3,2.5,1900,6224,1900,0,47.5941,-122.004
395000,2,2.25,1350,1493,1050,300,47.5421,-122.388
545000,4,2.75,2650,6717,2650,0,47.4947,-122.171
715000,4,2.5,3020,7035,3020,0,47.5344,-121.874
348000,3,2.5,1500,2255,1500,0,47.5538,-121.997
455000,3,1.75,1320,1014,1320,0,47.6047,-122.305
575000,4,2.75,3120,7644,3120,0,47.5156,-121.884
449950,3,2.25,1540,1270,1540,0,47.6935,-122.341
364000,3,2.5,1800,2790,1800,0,47.5455,-122.371
932990,4,2.5,3640,6389,3640,0,47.7049,-122.123
710000,3,2.5,2440,4153,2440,0,47.665,-122.087
949990,4,4,3970,7314,3970,0,47.6173,-122.056
326989,3,2.5,2060,4200,2060,0,47.3706,-122.017
335606,3,2.5,2538,4600,2538,0,47.2584,-122.196
1.5325E+06,5,4.5,4270,8076,3400,870,47.699,-122.206
299950,3,2.5,1320,3150,1320,0,47.5328,-122.282
962000,4,2.75,3340,5700,3340,0,47.5059,-122.146
395825,2,2.5,1590,1679,1590,0,47.5449,-122.011
419354,5,2.75,2710,4500,2710,0,47.3547,-122.062
920000,4,2.75,3140,7258,3140,0,47.7064,-122.232
366000,3,2.25,1445,1028,1300,145,47.5339,-122.067
480000,4,2.5,2430,5000,2430,0,47.515,-121.873
388000,3,3.25,1370,915,1100,270,47.5639,-122.388
2.32E+06,4,3.5,5050,9520,3610,1440,47.6364,-122.209
730000,3,2.5,1860,1290,1240,620,47.6179,-122.301
950000,5,3.75,5330,6000,3570,1760,47.5401,-122.073
358990,3,3.25,1710,2171,1400,310,47.5434,-122.368
398651,4,2.5,2650,4120,2650,0,47.5019,-122.34
530000,4,2.5,2590,7891,2590,0,47.5055,-122.194
610360,4,2.5,2610,5562,2610,0,47.5137,-122.169
436110,3,2.5,1770,1235,1600,170,47.6965,-122.342
925000,4,2.75,3730,8014,3730,0,47.6036,-122.059
449950,4,2.5,2420,5244,2420,0,47.4729,-122.35
760000,4,2.5,3330,7399,3330,0,47.679,-122.153
293000,3,2.25,1910,3481,1910,0,47.4293,-122.188
695000,2,2.5,2170,7665,2170,0,47.7112,-122.019
285000,3,2.5,2437,5136,2437,0,47.3517,-122.21
1.25578E+06,5,4,4180,12042,4180,0,47.5959,-122.014
379900,3,2.5,1800,2791,1800,0,47.5442,-122.371
472000,5,2.5,2570,7412,2570,0,47.7265,-121.957
300000,4,2.5,2090,5195,2090,0,47.3986,-122.166
272000,4,2.5,2789,3960,2789,0,47.3059,-122.28
418395,4,2.5,2906,5893,2906,0,47.2599,-122.192
465000,5,2.5,2550,6405,2550,0,47.5191,-121.869
659950,4,2.75,3550,9400,3550,0,47.4827,-122.131
484950,3,2.25,1590,926,1590,0,47.5402,-122.387
359000,3,2.25,1950,1968,1160,790,47.5179,-122.195
519000,4,2.5,3250,4500,3250,0,47.4944,-122.149
1.71E+06,5,4.5,4590,14685,4590,0,47.664,-122.2
535000,4,2.75,3070,7201,3070,0,47.4897,-122.147
622950,4,3.25,3030,7644,2830,200,47.5457,-121.881
515000,3,2.5,2610,5845,2610,0,47.4821,-122.142
330000,4,3.5,3150,6202,3150,0,47.3993,-122.162
318000,3,1.5,1240,983,1240,0,47.7235,-122.353
439000,3,2.5,1680,2801,1680,0,47.745,-122.181
540000,3,2.5,2220,5279,2220,0,47.5132,-122.387
1.079E+06,4,3.25,4800,12727,4800,0,47.5311,-122.134
435000,4,2.5,3100,4699,3100,0,47.3785,-122.023
2.7E+06,4,4,7850,89651,7850,0,47.5406,-121.982
1.1E+06,4,2.75,3590,5625,3590,0,47.6959,-122.133
293467,4,2,1590,942,1590,0,47.54,-122.026
328000,3,2.5,2242,4800,2242,0,47.2581,-122.2
550000,3,3.5,2490,3582,1720,770,47.5338,-122.067
649000,3,2,1530,1442,1530,0,47.6692,-122.372
435000,4,2.5,2150,3143,2150,0,47.5048,-122.154
625000,3,2.5,2440,4800,2440,0,47.5595,-122.365
415000,3,1.5,1270,1483,1270,0,47.6987,-122.317
400000,3,2.25,1450,4706,1450,0,47.761,-122.232
979000,3,2.5,2690,4047,2690,0,47.6797,-122.385
625250,4,2.5,2755,4831,2755,0,47.685,-122.039
665000,4,3.5,2650,3474,2230,420,47.5377,-122.046
589500,3,3.25,2310,3075,1730,580,47.5644,-122.383
437000,2,3,1460,1452,1140,320,47.5224,-122.39
320000,3,1,1400,9000,1400,0,47.5022,-122.145
333500,3,2.5,2196,7475,2196,0,47.3803,-122.204
430000,3,2.25,2020,2750,1680,340,47.5633,-122.297
995500,5,4.5,4280,8465,4280,0,47.7325,-122.165
427874,3,3,2340,5002,2340,0,47.4831,-121.773
334990,4,2.5,2220,4228,2220,0,47.5014,-122.341
909500,4,4,4420,5940,3410,1010,47.5397,-122.072
210000,3,2,1580,4961,1580,0,47.3338,-122.053
952990,4,2.75,3550,6558,3550,0,47.7076,-122.115
622500,2,1.75,1510,851,1420,90,47.6536,-122.358
515000,3,3.5,1360,1419,1040,320,47.6697,-122.371
350000,3,2.5,2040,13590,2040,0,47.3122,-122.04
310000,1,1.5,1120,912,1120,0,47.5924,-122.299
700000,4,3.5,4490,5099,3390,1100,47.5394,-121.861
907687,4,2.5,3560,6786,2930,630,47.5756,-122.071
741500,2,2.5,2150,5760,2150,0,47.7094,-122.018
395000,3,2.5,2130,5088,1840,290,47.7329,-121.976
559950,5,2.75,2990,6370,2990,0,47.4853,-122.154
215000,4,2.5,1847,8000,1847,0,47.2872,-122.257
390000,4,2.5,2610,7227,2610,0,47.314,-122.023
425000,3,2.25,1670,107157,1670,0,47.2743,-122.009
472000,3,2.5,1860,415126,1860,0,47.3974,-122.005
1.33E+06,4,3.5,3440,9776,3440,0,47.5374,-122.216
695000,4,3.5,3510,9364,3510,0,47.54,-121.876
545000,3,2.5,1740,1279,1740,0,47.589,-122.387
389950,4,2.5,2240,5500,2240,0,47.496,-122.169
380000,3,2.25,1550,1485,1550,0,47.6989,-122.346
288790,4,2,1390,745,1390,0,47.5401,-122.026
432500,3,3,2500,6000,2500,0,47.4408,-122.161
615000,3,3.5,2710,3326,1650,1060,47.5371,-122.073
500000,3,2.5,1720,3012,1720,0,47.7312,-122.334
615000,3,2.25,1760,1146,1760,0,47.6073,-122.304
500000,4,2.25,2270,8196,1150,1120,47.7214,-122.227
622000,3,3.5,1690,1765,1370,320,47.6536,-122.34
802945,5,3.5,4000,9234,4000,0,47.5265,-121.887
1.26E+06,4,2.5,2880,9003,2880,0,47.6844,-122.199
598950,3,2.5,1480,1531,1480,0,47.669,-122.402
430000,3,2.5,1950,4949,1950,0,47.5155,-121.87
515000,4,2.75,2700,5150,2700,0,47.5209,-121.874
1.262E+06,2,3,2210,3917,1500,710,47.6166,-122.291
400000,4,3.5,2370,3692,2370,0,47.5044,-122.17
390000,3,2.5,1310,1254,850,460,47.5622,-122.384
450000,3,2.5,2410,4293,2410,0,47.5196,-121.869
804995,5,1.5,3360,5402,3360,0,47.6067,-122.053
825000,4,3.25,3040,4155,2350,690,47.5429,-122.012
435000,4,2.25,2140,6355,2140,0,47.5367,-121.88
398000,3,2.5,1720,1715,1240,480,47.5481,-122.384
411605,4,2.5,2658,3960,2658,0,47.2603,-122.194
315000,3,3.25,1480,983,1180,300,47.5555,-122.363
455000,2,2,1350,1209,1350,0,47.649,-122.383
452950,3,2.5,1150,1194,1020,130,47.6684,-122.365
380000,3,1.75,1690,1468,1380,310,47.563,-122.297
340000,2,1.75,1270,1916,1270,0,47.5648,-122.294
409950,3,2.5,2655,5080,2655,0,47.2972,-122.348
360000,2,1,880,1165,880,0,47.6192,-122.297
1.595E+06,4,4.25,4645,7757,3855,790,47.6248,-122.29
440000,3,1.5,1270,1443,1270,0,47.699,-122.317
730000,2,1.75,1728,95950,1728,0,47.4579,-122.443
408000,3,2.25,1950,7221,1950,0,47.431,-122.285
820000,4,2.5,3170,3862,3170,0,47.6705,-122.145
360000,2,2.5,1233,1244,963,270,47.5533,-122.381
339990,3,2.5,2570,4600,2570,0,47.2582,-122.196
515000,3,2,1560,1020,1560,0,47.605,-122.304
541000,3,1.75,1630,1166,1020,610,47.6646,-122.367
375000,4,2.5,2510,7245,2510,0,47.5096,-122.363
320000,4,2.5,2223,5780,2223,0,47.3586,-122.157
325000,2,2.25,1230,1058,1160,70,47.5325,-122.073
740000,5,2.75,3050,7520,3050,0,47.5245,-122.184
450000,5,2.75,2710,6220,2710,0,47.3555,-122.061
455000,4,2.5,2090,4400,2090,0,47.5403,-122.286
292500,3,2.5,1440,1068,1160,280,47.5393,-122.361
650000,3,2.5,2500,51836,1510,990,47.4694,-121.989
530000,4,2.75,2740,7872,2740,0,47.4954,-122.172
829995,5,3.25,3360,6120,3360,0,47.607,-122.053
395000,4,2.75,2280,5013,2280,0,47.7333,-121.976
859990,4,2.75,3520,5500,3520,0,47.6181,-122.056
342500,2,1.5,1320,826,1100,220,47.5879,-122.304
743000,4,2.75,3410,5838,3410,0,47.6931,-122.022
345000,3,2.25,2730,9388,1390,1340,47.3785,-122.185
443000,3,2.5,1780,2778,1530,250,47.5487,-122.372
260000,3,2.5,1427,4337,1427,0,47.3857,-122.162
810000,4,2.5,2910,6555,2910,0,47.6659,-122.172
570000,4,2.75,3250,5600,3250,0,47.4806,-122.125
1.5631E+06,5,3.5,3630,8100,3630,0,47.5951,-122.2
840000,2,2.5,1680,975,1680,0,47.6321,-122.361
950000,3,2.5,2280,2296,1890,390,47.6256,-122.299
572800,3,2.5,3310,4682,2380,930,47.5201,-121.885
305000,3,3,1290,1112,1290,0,47.7282,-122.296
1.695E+06,5,4.75,3940,7067,3230,710,47.6232,-122.205
445000,4,2.5,2170,6000,1630,540,47.5589,-122.365
801000,4,3.5,3290,8059,3290,0,47.5573,-122.02
711000,3,2.5,2550,5376,2550,0,47.6647,-122.083
268500,3,2.25,1140,977,850,290,47.5439,-122.375
320000,4,2.5,2300,3825,2300,0,47.3594,-122.082
500000,4,3.25,2670,5001,1640,1030,47.5666,-122.293
631625,4,2.5,2440,6651,2440,0,47.6971,-122.371
850000,2,2.5,1611,2210,1611,0,47.6291,-122.347
600000,3,3.5,2710,3290,1650,1060,47.5367,-122.072
988500,3,2.75,2015,16807,2015,0,47.45,-122.377
430236,4,3.25,3444,5166,2714,730,47.2966,-122.348
1.26652E+06,3,2.5,3060,9576,3060,0,47.5928,-122.199
689500,4,2.5,2050,2772,2050,0,47.5431,-122.011
175003,3,1.5,1390,1882,1390,0,47.5667,-122.297
459000,2,2.5,1240,1249,1240,0,47.6718,-122.386
1.18E+06,4,3.25,3750,74052,3750,0,47.658,-122.006
358000,3,3.25,1410,1442,1360,50,47.7183,-122.317
447055,4,2.5,2448,4949,2448,0,47.3428,-122.179
415000,3,2.75,2600,64626,2600,0,47.7185,-121.405
1.21E+06,4,3.25,3330,9000,2870,460,47.6836,-122.208
495000,2,2.25,1160,1010,1000,160,47.6207,-122.301
479000,2,2.25,1330,1380,1060,270,47.577,-122.41
1.898E+06,3,2.5,2830,4334,2830,0,47.6318,-122.071
249900,3,2.5,1610,3517,1610,0,47.4496,-122.189
1.465E+06,4,2.5,2800,4000,2800,0,47.6695,-122.339
1.037E+06,5,3.75,4570,10194,4570,0,47.718,-122.161
897000,4,2.5,2820,6120,2820,0,47.6911,-122.293
1.1E+06,4,2.5,2570,9470,2570,0,47.6548,-122.19
685000,3,2.25,1710,1193,1140,570,47.6173,-122.31
295000,3,1.5,1220,3286,1220,0,47.7168,-122.189
619000,3,2.25,1650,946,1650,0,47.6536,-122.354
439108,2,1.5,1130,1340,910,220,47.5761,-122.41
260000,3,2.25,1489,2800,1489,0,47.3452,-122.215
279000,5,2.5,2690,5557,2690,0,47.4914,-122.253
380000,3,2.25,1530,1305,1116,414,47.7034,-122.357
287000,3,2.5,1600,6315,1600,0,47.2611,-122.198
377000,2,1.5,1000,1251,930,70,47.6529,-122.384
649950,4,3.5,2440,3012,2440,0,47.6923,-122.392
445000,3,2.5,1260,1102,1260,0,47.675,-122.387
605000,3,2.5,1660,1692,1610,50,47.6801,-122.322
475000,3,2.25,1190,1137,960,230,47.677,-122.325
399000,3,3,1520,1884,1520,0,47.7176,-122.284
718000,5,2.75,3250,8100,3250,0,47.7133,-122.311
1.4E+06,4,3.25,4700,9160,2520,2180,47.5744,-122.406
341000,3,2.5,1480,1663,1180,300,47.5443,-122.375
818000,2,2.5,2380,9374,2380,0,47.7095,-122.019
759000,3,2.25,1640,1873,1640,0,47.6196,-122.297
547500,3,3.5,1650,2262,1650,0,47.6823,-122.347
2.7E+06,5,4.75,5305,8401,3745,1560,47.6864,-122.215
358000,2,2.5,1278,987,1002,276,47.5532,-122.381
412000,3,2.5,1200,813,1200,0,47.5894,-122.315
245000,2,1.5,690,1058,690,0,47.6951,-122.343
460940,4,2.5,3202,4964,3202,0,47.3412,-122.179
321000,3,2.25,1347,1292,1347,0,47.7306,-122.291
633634,4,3.5,2960,6000,2960,0,47.5183,-121.886
290000,1,0.75,740,1284,740,0,47.6741,-122.406
445000,2,2.25,1200,1137,1200,0,47.6715,-122.392
887250,5,3.5,4320,7502,3500,820,47.5235,-122.168
739000,3,2.5,2310,7348,2310,0,47.7116,-122.019
429900,3,2,1490,1286,1490,0,47.57,-122.288
459000,3,2,1480,800,1000,480,47.5492,-122.387
240000,3,2.25,1481,2820,1481,0,47.3457,-122.217
566950,3,3,1730,1902,1730,0,47.6944,-122.377
1.04E+06,4,3.5,3900,8391,3900,0,47.6979,-122.205
343000,3,3.5,1130,1449,1130,0,47.6968,-122.348
572115,4,3.25,3230,4838,3230,0,47.3559,-122.023
918000,5,3.5,3920,5150,2820,1100,47.6638,-122.084
555000,2,1.5,1190,1361,1190,0,47.6161,-122.302
399440,4,2.5,2311,4396,2311,0,47.3276,-122.163
450000,3,2.5,1810,914,1380,430,47.5732,-122.387
648000,4,2.5,3290,6203,3290,0,47.5441,-121.86
580000,4,2.5,3250,5000,3250,0,47.4988,-122.148
415000,4,2.5,2544,4071,2544,0,47.341,-122.179
527500,3,2.5,1380,1389,1380,0,47.6427,-122.327
384000,3,2.25,1430,800,1140,290,47.5477,-122.388
692000,3,2.5,3490,28213,2242,1248,47.365,-122.456
455000,2,1.5,910,966,820,90,47.627,-122.361
1.28E+06,4,3.25,3080,4120,2380,700,47.6845,-122.359
415000,3,2.5,2280,6031,2280,0,47.7322,-121.966
975000,3,2.5,1660,1344,1660,0,47.644,-122.327
799950,4,2.5,3320,7429,3320,0,47.7189,-122.225
545000,5,4,1680,7268,1370,310,47.5571,-122.356
429900,4,3.5,2584,5005,2584,0,47.296,-122.35
275000,3,2.5,2217,8019,2217,0,47.2776,-122.251
498000,3,2.5,2480,4136,2480,0,47.493,-122.147
754950,3,2.5,2610,7256,2610,0,47.695,-122.18
895000,4,3,3240,5562,3240,0,47.5919,-121.975
580000,4,3.25,3569,8327,3569,0,47.4595,-122.208
379900,4,2.5,3181,5831,3181,0,47.2716,-122.297
245000,4,2.5,1921,4888,1921,0,47.2689,-122.24
417000,3,2.5,1570,4926,1570,0,47.5342,-121.842
555000,3,2.5,1940,3211,1940,0,47.5644,-122.093
555000,3,2.5,1940,3211,1940,0,47.5644,-122.093
353000,4,2.5,2210,13721,2210,0,47.3122,-122.039
539000,3,2.25,1280,1187,1080,200,47.6651,-122.368
434900,3,2,1520,5040,1520,0,47.777,-122.362
325000,2,2.25,1230,1078,1160,70,47.5324,-122.073
650000,3,2.5,1480,2159,1480,0,47.6533,-122.341
379950,4,2.5,2612,5850,2612,0,47.3751,-122.189
700000,3,2.5,2350,4975,2350,0,47.5418,-122.01
675000,3,2.5,1300,1590,1100,200,47.6384,-122.343
379000,4,1.5,2020,7560,2020,0,47.502,-122.146
571000,3,2.5,2140,2867,1960,180,47.5357,-122.073
475000,3,2.25,1380,1621,1140,240,47.678,-122.375
769900,4,3.5,2730,3047,2400,330,47.5797,-122.391
633000,4,3.5,4220,5817,2910,1310,47.5392,-121.862
635000,3,2.5,1570,1433,1570,0,47.6858,-122.336
1.238E+06,4,3.5,4670,6000,3820,850,47.5414,-121.994
524000,3,2.25,1370,1007,1330,40,47.6682,-122.361
485000,4,3.5,3273,5115,2671,602,47.4477,-122.204
1.03E+06,3,4,3880,13095,3700,180,47.6996,-122.233
650000,3,3.5,1494,1262,1494,0,47.6826,-122.324
754842,3,2.5,2930,5641,2930,0,47.71,-122.113
428900,4,2.5,2598,5553,2598,0,47.3412,-122.178
329900,3,2.5,2242,4995,2242,0,47.2595,-122.202
1.03529E+06,4,2.5,2830,5932,2830,0,47.6479,-122.408
544999,4,2.5,2710,6937,2710,0,47.5153,-121.871
449950,4,2.75,2320,4344,2320,0,47.4862,-122.163
635000,4,2.5,2720,7991,2720,0,47.7168,-122.331
599000,3,1.75,1650,1180,1650,0,47.6638,-122.319
478000,3,3.25,1430,1348,1160,270,47.6743,-122.374
388000,4,2.5,2090,5040,2090,0,47.4797,-122.23
809950,4,3.5,3660,4903,2760,900,47.7184,-122.156
1.06E+06,4,3.5,4220,8417,4220,0,47.5869,-122.054
659000,2,2.5,1450,1213,1110,340,47.6692,-122.372
971971,4,3.75,3460,6738,3460,0,47.506,-122.145
389000,3,2.5,1350,874,1270,80,47.5491,-122.387
355000,4,2.75,3000,5470,3000,0,47.3613,-122.038
551500,4,2.5,2950,10003,2950,0,47.489,-122.14
417838,4,2.5,2530,5048,2530,0,47.3559,-122.063
1.75E+06,4,4.5,4650,7660,3640,1010,47.6349,-122.198
399950,2,1,710,1131,710,0,47.6413,-122.329
740000,4,2.5,3050,8000,3050,0,47.7465,-122.231
335000,3,2.5,1150,683,1150,0,47.5323,-122.071
2.25E+06,5,5.25,3410,8118,3410,0,47.6295,-122.236
667000,3,1.75,1370,1921,1370,0,47.6595,-122.351
920000,4,2.5,3540,7009,3540,0,47.6749,-122.176
368000,3,2.5,1370,1350,1010,360,47.5534,-122.382
307000,4,2.5,1714,3080,1714,0,47.429,-122.188
550000,4,2.75,3650,4534,2940,710,47.7397,-122.224
594491,4,2.5,2990,6037,2990,0,47.4766,-121.735
460458,4,2.5,3284,6516,3284,0,47.3393,-122.181
859000,4,2.25,3550,13900,1830,1720,47.5681,-122.127
399950,3,3,1860,2875,1710,150,47.5511,-122.373
547500,3,3.25,1720,1977,1360,360,47.6127,-122.299
310000,3,2.5,2540,4775,2540,0,47.3341,-122.052
939000,4,2.75,3270,12880,3270,0,47.6679,-122.172
329900,2,2.5,980,1021,980,0,47.6844,-122.387
436000,3,2.5,1150,1193,1020,130,47.6684,-122.365
320000,3,2.5,1820,1855,1570,250,47.4643,-122.346
375000,3,2.5,1580,3825,1580,0,47.5458,-122.369
392137,3,2,1460,3696,1460,0,47.6861,-122.013
520000,4,2.5,2900,4950,2900,0,47.7717,-122.236
535000,5,2.75,2620,6389,2620,0,47.77,-122.236
407000,2,2.5,1340,999,940,400,47.5655,-122.386
424950,4,3.25,3266,5398,3266,0,47.2975,-122.35
290000,2,1.5,1076,1060,1076,0,47.7167,-122.298
399000,3,3.25,1680,1478,1360,320,47.5674,-122.369
439990,3,2.5,1930,1348,1300,630,47.6513,-122.384
635000,4,2.5,2880,3091,1940,940,47.5711,-122.286
635000,4,2.25,2240,5000,2240,0,47.6212,-122.058
351000,3,2.5,2594,4455,2594,0,47.3054,-122.276
437500,2,1.5,1210,1232,1210,0,47.6712,-122.39
919204,4,3.5,3760,5000,2860,900,47.6826,-122.394
923990,4,2.5,3600,6055,3600,0,47.7053,-122.126
639888,4,2.5,2050,2772,2050,0,47.5421,-122.011
675000,3,3.25,1510,2064,1220,290,47.6398,-122.345
899900,4,2.5,2580,3909,2580,0,47.6852,-122.21
252000,3,2.5,1670,4020,1670,0,47.53,-122.268
925000,4,2.5,3190,10034,3190,0,47.6379,-122.111
552000,3,2.5,1280,1920,1280,0,47.6621,-122.324
388500,4,2.5,2718,6197,2718,0,47.3255,-122.164
548000,2,2,1370,1878,1370,0,47.6721,-122.387
254950,3,2.5,1794,4769,1794,0,47.3052,-122.283
1.2375E+06,4,4.5,5120,41327,3290,1830,47.7009,-122.059
629000,3,2.5,2160,1912,1970,190,47.5642,-122.292
734000,4,2.5,2180,7204,2180,0,47.7221,-122.352
309000,3,2.25,1490,1294,1220,270,47.5569,-122.363
554950,3,2.5,2950,10254,2950,0,47.4888,-122.14
785000,3,2.75,2990,207781,2990,0,47.662,-121.944
550000,4,2.5,2700,5150,2700,0,47.5071,-122.148
1.01E+06,4,3.5,3130,5000,3130,0,47.5656,-122.403
1.575E+06,3,2,3620,14250,3220,400,47.5767,-122.225
309000,5,2.75,2481,4045,2481,0,47.2602,-122.284
328423,3,2.5,1730,3600,1730,0,47.5019,-122.34
345000,3,1.5,1420,1192,1140,280,47.5881,-122.304
660000,5,3.5,3160,5175,3160,0,47.755,-122.216
385000,3,3.25,1320,1327,1040,280,47.6506,-122.383
459000,2,2.25,1010,1107,710,300,47.6363,-122.371
248000,3,2.5,1870,4046,1870,0,47.342,-122.059
1.481E+06,4,3.5,5220,15411,3550,1670,47.592,-122.085
379000,4,2.5,2260,5824,2260,0,47.3496,-122.042
2.945E+06,5,4.5,4340,5722,4340,0,47.6715,-122.406
395000,2,2.25,1620,1841,1540,80,47.5483,-122.004
535000,3,2.5,2280,2289,1880,400,47.5375,-122.073
970000,5,3.5,3400,9804,2550,850,47.543,-122.266
205000,2,1.5,830,1020,830,0,47.5604,-122.363
310000,4,2.5,2310,7384,2310,0,47.3737,-122.165
334500,2,1.5,830,1858,830,0,47.5828,-122.314
995000,5,3.25,4130,7197,4130,0,47.6022,-122.06
370228,4,3,2050,4000,2050,0,47.3525,-122.275
383000,4,2.5,2050,4953,2050,0,47.3448,-122.024
384500,3,2.5,1600,2610,1600,0,47.5344,-122.068
865000,5,2.5,3190,8160,3190,0,47.7246,-122.363
1.051E+06,4,3.75,3860,5474,3860,0,47.5396,-121.995
502000,4,2.5,2040,5616,2040,0,47.7737,-122.238
1.75E+06,4,3.5,3845,8400,3845,0,47.6354,-122.198
569995,4,2.5,2650,6875,2650,0,47.479,-122.124
749950,4,2.5,3430,64441,3430,0,47.7694,-122.064
550000,3,2.5,2430,5400,2430,0,47.6062,-122.057
525000,3,3.5,2876,5086,2360,516,47.7511,-122.173
516000,4,3.5,2550,8698,2550,0,47.5216,-121.869
1.35E+06,4,3.75,4100,61419,4100,0,47.5626,-122.005
440000,4,2.5,2730,4526,2730,0,47.491,-122.153
660000,3,2.5,1780,1729,1080,700,47.6594,-122.355
261950,3,2.5,1880,5000,1880,0,47.3359,-122.054
551000,5,3.75,3090,4943,3090,0,47.4594,-122.133
665000,3,3.5,2460,14155,1900,560,47.7743,-122.279
610000,4,3.5,2910,5260,2910,0,47.5168,-121.883
645000,4,3.5,2910,5260,2910,0,47.5168,-121.883
536751,3,1.75,1930,6360,1930,0,47.5181,-121.885
260000,3,2.25,1413,3403,1413,0,47.4196,-122.193
1.312E+06,3,3.25,4030,6300,3630,400,47.6664,-122.276
429900,4,3.25,2880,5929,2880,0,47.2752,-122.349
535000,4,2.75,2360,15100,2360,0,47.5117,-122.365
462550,2,1.75,1070,1276,1070,0,47.6719,-122.39
602000,3,3.25,1460,1367,1460,0,47.6485,-122.334
730000,4,2.75,3800,9606,3800,0,47.7368,-122.208
300500,2,1.5,1190,801,1190,0,47.5212,-122.358
675000,5,2.5,3200,6455,3200,0,47.5446,-121.862
415000,3,2.25,1970,2377,1680,290,47.5631,-122.297
614000,3,2.5,2830,5831,2830,0,47.7744,-122.224
385000,4,2.5,2630,5701,2630,0,47.375,-122.16
594000,4,2.75,2720,4613,2720,0,47.7352,-122.223
860000,4,2.75,3160,8097,3160,0,47.6709,-122.166
1.1045E+06,4,4,3770,8899,2940,830,47.6476,-122.079
775000,4,2.75,3500,6226,3500,0,47.6846,-122.045
430760,5,2.75,2710,4685,2710,0,47.3555,-122.062
755000,2,2.5,2170,6361,2170,0,47.7109,-122.017
640000,2,2.25,1540,958,1540,0,47.6179,-122.318
613500,3,3.25,1876,1531,1876,0,47.6864,-122.265
780000,4,3.5,3720,213073,3720,0,47.3216,-121.94
550000,4,2.5,3148,9612,3148,0,47.3994,-122.311
789500,4,3.25,3240,4852,3240,0,47.695,-122.022
592000,5,3.5,3340,5000,2580,760,47.5168,-121.871
454950,4,2.5,2413,5701,2413,0,47.3731,-122.159
475000,4,2.5,2500,4500,2500,0,47.4928,-122.149
659000,2,1.75,1180,904,780,400,47.6396,-122.329
570000,4,2.5,2890,5801,2890,0,47.7349,-122.238
347500,5,3,2230,6551,1330,900,47.487,-122.32
205000,4,2.5,1767,4500,1767,0,47.2607,-122.25
380000,3,3.25,1450,1468,1100,350,47.5664,-122.37
718000,5,2.75,2930,7663,2930,0,47.5308,-122.184
515805,5,2.75,2710,4136,2710,0,47.4786,-122.123
1.02928E+06,4,3.25,3600,18645,3000,600,47.5294,-122.154
437718,3,2.5,1800,3265,1800,0,47.5338,-121.841
450000,4,2.5,2290,5515,2290,0,47.5518,-122.357
515000,3,2.5,1510,1178,1060,450,47.6181,-122.301
204000,2,2.5,1090,13444,1090,0,47.4166,-122.319
360000,3,2,1270,1323,1270,0,47.6934,-122.342
550000,3,2.25,1540,1005,1540,0,47.6827,-122.346
650880,3,2.5,2930,6050,2930,0,47.5151,-121.883
1.78995E+06,5,3.75,4360,8504,3530,830,47.6936,-122.19
895900,4,3.5,3640,4983,2790,850,47.5619,-122.027
585000,4,2.5,2430,4747,2430,0,47.5285,-122.031
380000,3,2.25,1520,1464,1240,280,47.543,-122.375
565997,5,2.75,2730,5820,2730,0,47.4856,-122.154
459000,3,3,2440,2076,1930,510,47.5476,-122.37
550000,3,3.75,1580,1303,1340,240,47.5875,-122.315
500000,3,2.25,1420,983,1420,0,47.6533,-122.346
461500,5,3.25,2820,3275,2230,590,47.5339,-122.284
2.15E+06,4,5.5,5060,10320,5060,0,47.6245,-122.21
790000,4,2.5,2650,5000,2650,0,47.5605,-122.396
735000,3,2.25,1490,1212,1040,450,47.6226,-122.313
588000,4,2.5,3060,7710,3060,0,47.4828,-122.136
724500,3,3.25,3240,4185,2770,470,47.5794,-122.03
749000,3,2.75,2820,5348,2820,0,47.7073,-122.118
720000,5,3.5,4140,7642,4140,0,47.591,-122.008
250000,2,1.5,982,846,806,176,47.7034,-122.345
790000,3,2.75,2460,3600,2460,0,47.5409,-121.994
392440,4,2.5,2547,4800,2547,0,47.2592,-122.194
280000,4,2.25,1834,7460,1834,0,47.3568,-122.163
1.333E+06,4,4.5,3130,5126,2450,680,47.6239,-122.29
649000,4,2.5,2730,4847,2730,0,47.549,-122.374
457000,2,2.5,1380,1329,1050,330,47.6903,-122.37
2.225E+06,4,4.25,4700,10800,3910,790,47.6882,-122.214
453000,3,3,2330,4284,1920,410,47.5547,-122.308
329780,3,2.5,1730,3600,1730,0,47.5014,-122.34
1.05E+06,2,2.5,2350,2390,2000,350,47.5999,-122.286
771005,5,4.5,4000,6713,4000,0,47.5254,-121.886
1.3E+06,3,2.5,3350,7752,2180,1170,47.6263,-122.099
607500,3,3.25,1530,1612,1530,0,47.6706,-122.378
278000,2,2.25,1610,1968,1610,0,47.5184,-122.196
475000,4,2.75,2620,6178,2620,0,47.4823,-121.771
270000,3,2,1300,1920,850,450,47.5183,-122.376
1.302E+06,4,3.5,3590,5334,3140,450,47.6763,-122.267
778983,4,2.5,2490,5647,2490,0,47.7043,-122.114
221000,3,2.5,1320,1780,880,440,47.528,-122.269
338800,4,2.25,1800,2752,1800,0,47.5165,-122.346
834995,5,1.5,3360,5225,3360,0,47.6072,-122.053
550000,4,2.5,3220,9328,3220,0,47.7273,-121.958
575000,3,3.5,2514,1559,2024,490,47.7044,-122.209
649000,4,2.75,3130,9711,3130,0,47.4823,-122.124
545000,4,2.5,2720,4738,2720,0,47.515,-121.869
625000,2,2.25,1390,916,1165,225,47.6168,-122.314
1.042E+06,4,4.5,4920,270236,3820,1100,47.4695,-121.775
611000,3,2.5,2134,1984,2134,0,47.5402,-122.027
300000,3,2.5,1741,5701,1741,0,47.379,-122.184
577000,3,2.5,2560,5238,2560,0,47.6887,-122.04
349990,4,2.5,2220,3561,2220,0,47.3561,-122.063
650000,3,2.5,1910,4363,1910,0,47.5482,-121.996
378000,2,1.5,980,853,820,160,47.5925,-122.295
313200,3,2.5,1950,4197,1950,0,47.3613,-122.081
1.20669E+06,5,4.25,4150,12015,4150,0,47.5816,-122.021
252500,2,1.5,1110,986,950,160,47.5427,-122.272
308000,3,2.5,1250,1150,1080,170,47.5582,-122.363
803100,4,2.5,3310,5404,3310,0,47.6635,-122.083
415000,4,2.5,2020,5501,2020,0,47.4937,-122.15
785000,4,3.5,3310,4850,3310,0,47.6954,-122.022
499950,4,2.5,2798,4473,2798,0,47.4295,-122.205
216000,4,2.5,1847,8000,1847,0,47.2874,-122.257
380000,4,2.5,2420,4981,2420,0,47.3785,-122.023
345000,4,2.5,2020,3600,2020,0,47.3535,-122.017
456500,4,2.5,2400,6811,2400,0,47.4959,-122.15
382495,3,2.5,1760,5390,1760,0,47.3482,-122.042
324950,4,2.5,2110,4178,2110,0,47.3612,-122.081
436472,4,2.5,2692,8392,2692,0,47.3519,-122.197
365250,3,2.25,1490,4522,1490,0,47.7611,-122.233
919990,5,3.25,3960,6352,3960,0,47.5806,-122.055
316475,4,2.5,1740,4642,1740,0,47.3686,-122.117
425000,4,2.5,1940,4517,1190,750,47.776,-122.26
302860,2,1,970,3279,790,180,47.5469,-122.383
298000,3,2.5,1852,4000,1852,0,47.3455,-122.21
3.204E+06,4,4,4810,18851,4810,0,47.6364,-122.214
950000,4,4,5635,9695,4360,1275,47.3389,-122.334
333000,3,2.5,1520,3041,1520,0,47.4874,-122.152
289950,3,2.5,2099,4275,2099,0,47.3521,-122.211
419950,3,2.25,1250,811,1250,0,47.5419,-122.388
306000,2,1.5,1090,1183,1090,0,47.6974,-122.349
498445,4,2.5,3216,5902,3216,0,47.3425,-122.179
775950,4,2.5,2970,4400,2970,0,47.705,-122.114
605000,3,2.5,2610,6405,2610,0,47.5373,-121.874
520000,2,1.75,1340,1368,1060,280,47.618,-122.311
849990,4,2.75,3300,4987,3300,0,47.6175,-122.056
767450,3,2,1630,7599,1630,0,47.6981,-122.376
665000,3,2.25,1590,929,1060,530,47.6172,-122.31
525000,2,2.75,1310,1268,1310,0,47.6534,-122.355
870515,4,3.5,3600,5697,2940,660,47.5755,-122.071
390000,4,2.5,2154,4153,2154,0,47.4557,-122.13
500000,3,1.75,1530,825,1530,0,47.5929,-122.308
399950,3,2.25,1360,1041,1094,266,47.6925,-122.375
305000,3,2.5,1320,2480,1320,0,47.536,-122.284
255000,4,2.5,1660,6724,1660,0,47.259,-122.256
415000,4,2.5,2891,6499,2891,0,47.3359,-122.257
716500,3,2.5,2340,2155,2120,220,47.53,-122.073
425000,3,2.5,2320,2267,2320,0,47.7027,-122.359
540000,4,2.5,2190,3855,2190,0,47.7705,-122.169
324747,3,2.5,2060,4742,2060,0,47.3706,-122.017
385000,3,2.5,1740,4145,1740,0,47.6875,-122.015
270000,3,2.25,1400,3825,1400,0,47.3596,-122.082
1.24E+06,5,4,4410,14380,4410,0,47.6463,-122.121
672000,3,2.5,1780,1647,1080,700,47.6597,-122.355
310000,3,2.5,1760,10137,1760,0,47.355,-122.059
3E+06,3,3.5,4410,10756,3430,980,47.5283,-122.205
2.35E+06,6,4.25,5550,11547,4270,1280,47.6547,-122.202
427000,3,2.5,2432,9391,2432,0,47.3453,-122.267
389950,3,2.5,2283,3996,2283,0,47.4221,-122.192
309620,3,2.5,1860,3730,1860,0,47.7442,-121.984
399895,4,2.5,2701,4500,2701,0,47.2586,-122.194
442515,4,2.5,2930,4875,2930,0,47.3421,-122.179
375000,3,2.25,1540,1561,1540,0,47.6991,-122.346
309780,3,2.5,2242,4500,2242,0,47.2583,-122.198
425000,3,2.5,1950,4345,1950,0,47.5202,-121.873
405000,2,3,1160,1073,880,280,47.5788,-122.315
356250,3,2.5,2060,5115,2060,0,47.3261,-122.163
550000,3,2.25,1230,875,1230,0,47.6521,-122.4
340000,2,1.5,1160,1438,1160,0,47.5917,-122.295
362865,4,2.5,2245,4301,2245,0,47.3555,-122.063
1.36E+06,4,3.5,4120,12626,3970,150,47.7089,-122.245
830000,4,2.5,3400,9692,3400,0,47.708,-122.109
1.598E+06,5,3.75,4270,7500,3210,1060,47.6845,-122.207
855000,4,3.5,2890,5911,2370,520,47.5754,-122.071
1.205E+06,5,3.5,3220,8000,2900,320,47.6834,-122.2
1.385E+06,4,3.5,4010,15365,4010,0,47.5528,-122.093
400200,4,3.5,2260,30250,2260,0,47.4493,-122.281
235000,2,1,1140,1730,1010,130,47.5494,-122.372
349950,3,2,1640,4714,1640,0,47.3539,-122.021
659950,4,2.75,3510,9400,3510,0,47.4827,-122.131
785000,3,2.75,3010,1842,3010,0,47.5836,-121.994
475000,2,2.25,1060,925,980,80,47.6386,-122.388
263900,3,2.5,1658,2700,1658,0,47.3667,-122.307
342000,3,2.5,1960,3540,1960,0,47.3568,-122.055
367899,3,2.5,2420,4725,2420,0,47.371,-122.018
657044,3,3.5,3420,23786,3420,0,47.4739,-122.11
359950,2,1.5,893,965,893,0,47.6187,-122.301
879950,4,2.75,3020,7203,3020,0,47.6948,-122.178
550000,4,2.5,2470,5954,2470,0,47.7685,-122.236
279000,4,2.5,2009,4800,2009,0,47.2586,-122.2
255000,3,2.5,1530,1116,1530,0,47.7385,-122.25
609500,3,1.75,1590,1113,1590,0,47.6691,-122.402
420000,5,3,2630,3149,1670,960,47.5065,-122.171
570000,4,2.5,3230,7187,3230,0,47.4995,-122.15
439000,3,2.25,1430,2343,1430,0,47.5648,-122.294
310000,3,2.5,2242,5744,2242,0,47.2597,-122.199
635000,4,2.5,2500,4000,2500,0,47.5902,-122.311
399950,3,2.5,1230,922,1080,150,47.6518,-122.384
805000,4,2.5,3020,3600,3020,0,47.5407,-121.993
1.8E+06,4,3.5,3480,4000,2460,1020,47.6356,-122.281
1.205E+06,4,3,3330,7650,1830,1500,47.6889,-122.352
745000,4,2.5,3400,4840,3190,210,47.5066,-122.146
329445,2,1.5,830,1119,830,0,47.5828,-122.314
588000,5,3,3110,4464,3110,0,47.7719,-122.168
494815,3,2.5,1910,2091,1910,0,47.5445,-122.013
591975,3,2.75,3230,5250,2680,550,47.5196,-121.878
600000,5,2.75,3380,8179,3380,0,47.4827,-122.135
673000,3,2.75,2830,3496,2830,0,47.5606,-122.011
889950,5,3.5,3700,7055,3700,0,47.5929,-122.057
500000,4,3,2520,4104,2520,0,47.5352,-121.88
500000,3,2.25,1530,1396,1240,290,47.666,-122.367
890000,4,4.25,4420,5750,3410,1010,47.5404,-122.073
437000,3,3,1460,1180,1460,0,47.6998,-122.367
419700,3,2.25,1450,1486,1160,290,47.5694,-122.387
394000,3,2,1160,3441,580,580,47.5314,-122.392
342000,3,2,1640,4802,1640,0,47.3538,-122.021
420000,3,1.75,1444,249126,1444,0,47.4104,-122.486
580000,3,2.5,1620,1173,1470,150,47.6681,-122.355
343000,2,1.5,1100,1228,900,200,47.5538,-122.282
390000,2,1.5,1340,1402,1120,220,47.588,-122.304
274000,3,1.5,1450,4694,1450,0,47.3654,-122.021
700000,4,2.5,3040,7200,3040,0,47.7747,-122.366
838000,4,2.5,2560,7210,2560,0,47.5535,-122.395
300000,6,3,2744,9926,2744,0,47.2773,-122.216
467000,3,2.25,1420,990,1420,0,47.6801,-122.348
395000,2,1,700,7457,700,0,47.5348,-122.295
734000,5,4.25,4110,42755,2970,1140,47.3375,-122.337
480000,5,2.75,2670,4780,2670,0,47.4866,-122.155
539000,3,2.75,2130,1400,1080,1050,47.5661,-122.29
459950,5,2.75,3078,6371,3078,0,47.3587,-122.163
306500,2,1,840,892,840,0,47.5396,-122.387
408474,3,2.5,1800,2731,1800,0,47.5342,-121.841
437000,3,2.75,2580,5200,2580,0,47.496,-122.151
160797,3,1.5,1270,2356,1270,0,47.5671,-122.298
729000,4,3.5,3065,5440,3065,0,47.524,-122.2
499000,3,2.5,1861,1587,1578,283,47.7043,-122.209
359950,4,2.75,2260,5705,2260,0,47.3726,-122.159
929000,5,3.25,4150,7100,4150,0,47.6026,-122.06
529950,2,2.5,1500,1174,1140,360,47.6689,-122.363
461000,3,2.25,1620,998,1540,80,47.5394,-122.027
271115,2,1.5,830,1325,830,0,47.5472,-122.384
653000,4,2.5,3120,5137,3120,0,47.6842,-122.04
565000,3,2.5,1870,1058,1380,490,47.6512,-122.345
529950,3,2.25,1240,1250,1240,0,47.6748,-122.377
585000,4,2.5,2820,5612,2820,0,47.7477,-122.236
609000,3,1.75,1630,1526,1630,0,47.6536,-122.354
267000,3,2.25,1584,2800,1584,0,47.3454,-122.214
557000,4,2.5,2840,4500,2840,0,47.7678,-122.237
709950,4,3.25,3910,6293,3130,780,47.5389,-121.86
625000,3,2.5,1730,1301,1730,0,47.653,-122.352
599000,3,2.75,1840,2060,1700,140,47.53,-122.073
920000,4,3.75,4030,503989,4030,0,47.4807,-121.795
1.285E+06,4,3.5,3440,3800,3440,0,47.6408,-122.307
324500,4,2.5,2110,3825,2110,0,47.3602,-122.082
471500,3,2.5,2430,5866,2430,0,47.5158,-121.871
1.015E+06,4,3.75,4690,207141,4030,660,47.7072,-121.983
998000,4,3.5,3500,43560,2850,650,47.5481,-122.103
262000,4,2.5,2070,8685,2070,0,47.4697,-122.267
844000,4,3.5,3350,6350,2610,740,47.5602,-122.39
745641,4,2.5,2440,4850,2440,0,47.7043,-122.114
659950,5,3,3010,7357,3010,0,47.7226,-122.33
339989,3,2.5,2060,4200,2060,0,47.3706,-122.018
352500,2,2.5,1570,2399,1180,390,47.5488,-122.364
525000,3,2.5,1580,1161,1010,570,47.6206,-122.299
1.13899E+06,5,3.5,4280,6530,4280,0,47.5941,-121.973
491000,5,3.5,2815,4900,2815,0,47.3424,-122.179
675000,4,2.5,2620,6114,2620,0,47.5603,-122.013
344000,3,2.25,1250,1033,1250,0,47.6907,-122.343
530000,4,2.5,3250,4500,3250,0,47.4944,-122.15
290500,4,3.25,2510,7686,2510,0,47.4785,-122.228
335000,2,1.75,1270,1685,1270,0,47.5646,-122.295
2.998E+06,5,4,6670,16481,4960,1710,47.6409,-122.221
379000,3,2.5,1580,3075,1580,0,47.545,-122.368
385000,3,1.5,1360,2030,1360,0,47.6961,-122.349
500012,4,2.5,2400,9612,1230,1170,47.4799,-122.127
366750,3,3,1571,2017,1571,0,47.7338,-122.309
405000,2,2,1405,1073,1140,265,47.612,-122.295
356999,3,1.5,1010,1546,1010,0,47.5998,-122.311
590000,2,2.5,1450,1281,1220,230,47.665,-122.285
294000,3,1.75,1420,1361,960,460,47.5684,-122.314
731500,4,2.5,2650,4644,2650,0,47.6945,-122.018
837219,5,2.75,3030,7679,3030,0,47.593,-122.057
1.6E+06,4,5.5,6530,871200,6530,0,47.664,-121.878
798800,3,2.75,2670,3738,1720,950,47.5299,-122.203
482500,2,2.5,1170,809,1170,0,47.6875,-122.339
820000,4,2.5,3260,26772,3260,0,47.5115,-122.031
319000,3,1.5,1480,1722,1480,0,47.728,-122.292
950000,3,2.5,2700,6947,2700,0,47.5172,-122.208
1.2675E+06,4,3.5,4640,13404,4640,0,47.531,-122.134
378000,3,2.5,1601,2491,1536,65,47.719,-122.317
3.345E+06,5,3.75,5350,15360,3040,2310,47.648,-122.218
489950,3,2.5,2540,5237,2540,0,47.5492,-122.276
345000,2,1.75,1030,1106,765,265,47.5397,-122.387
510000,3,2.5,2730,7136,2730,0,47.3938,-122.321
432500,4,2.5,3172,5033,3172,0,47.2961,-122.348
650000,4,2.5,3160,8530,3160,0,47.5075,-122.148
750000,4,2.5,2850,12429,2850,0,47.6915,-122.177
870000,4,3.5,2780,3100,2120,660,47.6886,-122.364
900000,4,3.5,3860,6543,3860,0,47.5934,-121.974
664950,2,1.75,1180,900,780,400,47.6395,-122.329
391000,3,2.25,1410,1290,1290,120,47.5345,-122.069
1.8E+06,4,3.5,6370,205603,6370,0,47.5016,-121.905
479349,5,3,3223,6371,3223,0,47.3584,-122.163
661000,4,3.25,2600,2074,2150,450,47.5402,-122.028
379000,3,3.25,1380,1234,1380,0,47.6935,-122.342
415000,3,2.25,1620,998,1540,80,47.5401,-122.027
375000,3,3.25,1370,1227,1370,0,47.6964,-122.341
355000,3,2,1220,1186,1220,0,47.6972,-122.341
540000,3,2.5,1280,1889,1280,0,47.6619,-122.324
290000,2,1.5,770,850,770,0,47.5644,-122.388
500000,3,2.5,1210,1200,1210,0,47.6543,-122.345
416000,4,2.5,2890,6322,2890,0,47.3494,-122.044
349900,3,2.5,1580,2765,1580,0,47.5444,-122.369
465000,3,2.25,1530,1245,1050,480,47.6018,-122.297
950000,4,2.5,3670,7680,3670,0,47.5401,-121.993
496800,4,2.25,1850,2340,1850,0,47.543,-122.372
680000,4,2.5,2440,6581,2440,0,47.7321,-122.334
920000,4,3.25,2190,4265,1540,650,47.6178,-122.29
1.28999E+06,5,4,4360,8030,4360,0,47.5923,-121.973
825000,4,2.75,3990,6637,3990,0,47.6835,-122.045
292000,3,2.5,1270,1283,1270,0,47.7209,-122.291
576000,4,2.5,3340,6924,3340,0,47.495,-122.149
670000,2,2,1500,761,1500,0,47.6522,-122.346
953007,4,3.5,3120,5086,2480,640,47.6762,-122.288
399000,4,2.5,2480,4334,2480,0,47.3826,-122.036
399000,2,2,1110,1155,980,130,47.5496,-122.388
847093,4,2.75,2760,5670,2760,0,47.5819,-122.047
599950,3,2.5,1510,1493,1510,0,47.669,-122.402
499000,3,2.5,1460,1614,1180,280,47.6781,-122.374
760000,4,2.75,3980,285318,3980,0,47.4803,-121.795
1.69999E+06,4,3.75,3320,8234,3320,0,47.5963,-122.2
1.03389E+06,4,3.25,3270,5187,3110,160,47.6966,-122.133
515000,4,2.5,2670,8765,2670,0,47.4876,-122.146
355000,3,2.25,1410,1332,1290,120,47.5345,-122.069
319900,4,2.75,2475,4000,2475,0,47.3452,-122.21
460000,3,3.5,1600,1431,1240,360,47.6865,-122.363
305000,2,1,1290,3383,1290,0,47.6968,-122.025
280000,3,2.5,1608,4818,1608,0,47.2583,-122.203
394950,2,2.25,1300,2104,1010,290,47.5477,-122.388
382000,4,3.5,2530,3000,1850,680,47.4919,-122.336
560000,3,2.5,1390,1411,1390,0,47.6485,-122.334
772000,3,2.25,1640,1204,1640,0,47.6196,-122.297
324950,4,2.5,2229,5723,2229,0,47.3693,-122.286
530000,3,2.5,1790,3078,1790,0,47.5638,-122.094
384000,3,2.25,990,736,880,110,47.6605,-122.319
719950,5,2.75,3240,6863,3240,0,47.5033,-122.193
319950,2,2.5,1280,819,1060,220,47.6905,-122.364
292000,3,2.5,1610,3848,1610,0,47.4497,-122.188
1.5E+06,6,3.5,3670,3959,2410,1260,47.6356,-122.373
425000,2,2.5,1150,1027,1150,0,47.6534,-122.356
799950,5,3.75,3760,4702,2780,980,47.7202,-122.223
499000,2,2.5,1320,1157,990,330,47.6689,-122.363
572000,4,2.75,2700,7992,2700,0,47.4831,-122.135
459000,2,2,1480,804,1480,0,47.602,-122.308
529500,3,2.25,1410,905,1410,0,47.5818,-122.402
374500,4,2.5,3135,5811,3135,0,47.3263,-122.18
584000,3,2.5,1480,1485,1280,200,47.6376,-122.326
1.898E+06,4,4.5,4020,9656,4020,0,47.6358,-122.207
505000,2,2.25,1060,1209,940,120,47.6369,-122.327
565000,2,2.5,1950,2457,1950,0,47.5925,-122.302
799000,4,2.75,3340,5677,3340,0,47.709,-122.118
547000,3,2.5,1570,1452,1240,330,47.648,-122.396
550000,3,2.5,1930,6604,1930,0,47.4692,-122.351
250000,3,2,1590,8100,1060,530,47.3611,-122.047
960000,4,4.5,3720,7746,3720,0,47.7323,-122.165
2.95E+06,4,4.25,4470,5884,3230,1240,47.6387,-122.405
441000,2,1,1290,1289,1030,260,47.6006,-122.305
265000,3,2.25,1489,2800,1489,0,47.3454,-122.214
430000,3,2.5,2075,39553,2075,0,47.3601,-122.032
286800,3,2.5,1413,3600,1413,0,47.4222,-122.193
375000,3,2.5,1300,1362,880,420,47.5893,-122.317
312500,3,3.25,1480,983,1180,300,47.5555,-122.363
850000,4,2.75,3320,5559,3320,0,47.5607,-122.031
390500,3,2.25,1530,1279,1116,414,47.7035,-122.357
455000,3,2.5,1180,932,1180,0,47.638,-122.375
455000,2,2,1190,1303,800,390,47.6675,-122.368
515000,3,2.25,1300,1180,1300,0,47.6871,-122.339
362500,3,3.5,1710,2212,1400,310,47.5459,-122.368
460000,3,2.5,2390,47480,2390,0,47.4517,-122.084
540000,4,3.5,3510,6005,2750,760,47.5168,-121.87
230000,3,1.75,1140,1165,1140,0,47.5638,-122.295
425000,2,2.5,1320,1329,1180,140,47.6728,-122.374
298450,5,3,2100,9752,1200,900,47.3341,-122.304
344000,4,2.5,2400,4848,2400,0,47.3626,-122.04
416286,3,2.5,1408,989,1408,0,47.6856,-122.315
379500,4,2.5,2560,5102,2560,0,47.3404,-122.181
350000,2,2.5,1260,1347,1260,0,47.6994,-122.341
258800,2,1.75,1290,1624,1290,0,47.5171,-122.347
620000,4,2.5,2730,9260,2730,0,47.7222,-122.331
295000,2,2.5,1630,1368,1280,350,47.5489,-122.363
908990,4,2.75,3530,6844,3530,0,47.5975,-121.985
485230,4,2.5,2714,12558,2714,0,47.3522,-122.201
475000,3,2.25,1630,2520,1630,0,47.5493,-121.998
1.24042E+06,5,3.25,5790,13726,4430,1360,47.5388,-122.114
635000,3,3,2230,1407,1850,380,47.5446,-122.017
350000,3,2.5,1380,1590,1160,220,47.5444,-122.375
345000,3,3.5,1320,1161,1320,0,47.7162,-122.294
700000,2,2,1490,713,1490,0,47.6356,-122.346
490000,3,2.25,1280,1520,1080,200,47.6651,-122.368
1.29989E+06,5,4,3870,5929,3870,0,47.6965,-122.134
579000,2,2.5,1280,1051,1080,200,47.6273,-122.359
552500,3,1.5,1300,1435,1120,180,47.6114,-122.31
467000,4,2.75,2170,5024,2170,0,47.495,-122.145
305000,4,2.25,1763,3717,1763,0,47.4213,-122.194
212000,2,1.5,1020,1525,1020,0,47.704,-122.347
429000,4,2.5,1840,4593,1840,0,47.6866,-122.013
479950,3,2,1820,1358,1820,0,47.5433,-122.376
825000,3,3.5,2670,3000,1870,800,47.6813,-122.372
1.18E+06,6,6.5,6260,10955,4840,1420,47.5947,-122.039
250000,3,2.25,1400,3814,1400,0,47.3584,-122.083
289000,2,1.5,1160,2158,1160,0,47.7178,-122.19
265000,3,2.5,1400,3368,1400,0,47.5134,-122.342
344000,3,2.5,1232,1130,1232,0,47.7185,-122.317
749000,4,2.75,2700,6000,2100,600,47.586,-122.383
492000,4,2.5,2550,6382,2550,0,47.5202,-121.87
552500,4,2.5,3260,6902,3260,0,47.4829,-122.156
653500,2,2.5,1680,1240,1120,560,47.6372,-122.324
855000,4,3.25,2630,2550,2030,600,47.6775,-122.385
333000,3,1.5,1260,5758,1260,0,47.5524,-122.139
415000,4,2.5,2550,4500,2550,0,47.4916,-122.153
445000,4,3.25,3450,5000,3450,0,47.4925,-122.273
273500,3,2.5,1550,3402,1550,0,47.3523,-122.212
969990,4,2.5,4150,8436,4150,0,47.5802,-122.039
1.2E+06,5,3.5,3900,4400,2650,1250,47.6607,-122.362
430000,3,3.25,1550,1444,1550,0,47.6767,-122.291
392000,4,2.5,2130,4000,2130,0,47.5108,-122.362
795000,4,2.5,2890,7798,2890,0,47.5456,-122.129
457000,3,2.5,1220,1330,1010,210,47.6904,-122.37
453000,4,2.5,2502,8306,2502,0,47.2953,-122.265
376000,3,2,1340,1384,1340,0,47.6973,-122.35
469995,4,2.5,2350,3800,2350,0,47.4783,-122.123
540000,3,2.5,1810,3930,1810,0,47.7169,-122.02
555000,4,2.5,3310,6500,3310,0,47.515,-121.87
445000,3,2,1620,5101,590,1030,47.5448,-122.288
256950,2,2,1070,635,720,350,47.5212,-122.357
297000,4,2.5,2230,4952,2230,0,47.3363,-122.211
320000,4,2.5,1970,4558,1970,0,47.3627,-122.04
805000,5,4.5,4600,7810,3200,1400,47.5381,-121.86
799990,4,2.75,3110,6050,3110,0,47.705,-122.126
680000,4,2.5,3490,3677,2850,640,47.774,-122.162
395000,3,2.5,1600,1936,1600,0,47.5629,-122.297
732000,3,2.5,1960,3060,1960,0,47.6764,-122.389
163800,2,2.5,1000,1092,990,10,47.5419,-122.271
220000,2,2.5,1000,1092,990,10,47.5419,-122.271
308625,2,2,1500,1408,1500,0,47.7293,-122.343
375000,3,2.5,2424,5931,2424,0,47.3515,-122.134
300000,4,2.5,2303,3826,2303,0,47.3258,-122.165
284000,3,2.5,1880,6008,1880,0,47.3366,-122.052
610000,2,2,1210,740,780,430,47.6206,-122.3
955000,4,3.25,3720,6765,3720,0,47.688,-122.018
982000,4,2.75,3610,8580,3610,0,47.6706,-122.173
359000,3,1.5,1360,885,1360,0,47.6961,-122.349
779380,5,2.5,2590,7084,2590,0,47.7053,-122.113
1.51E+06,5,3.25,4390,11250,4390,0,47.5785,-122.225
635000,3,3,2290,1407,1890,400,47.5446,-122.017
1.06E+06,4,3.75,3880,9979,3880,0,47.5408,-121.992
389500,3,2.5,1350,874,1270,80,47.549,-122.387
359800,5,2.5,2170,2752,2170,0,47.5165,-122.346
399950,3,3,1296,1051,1296,0,47.7175,-122.284
320000,3,3.25,1530,1602,1140,390,47.5555,-122.362
255900,3,2.5,1489,3266,1489,0,47.3452,-122.217
380000,4,2.5,2130,4467,2130,0,47.5108,-122.363
580000,3,2.75,1430,1521,1130,300,47.6353,-122.371
545000,5,3.75,2380,7268,1430,950,47.5571,-122.357
451300,3,2.5,1420,814,1140,280,47.5429,-122.387
852880,4,3.25,3450,6184,3450,0,47.6072,-122.054
305000,4,2.5,1914,3150,1914,0,47.43,-122.188
295000,2,1.5,988,1080,988,0,47.7123,-122.301
261000,3,2.25,1584,2800,1584,0,47.3451,-122.214
560000,4,2.5,2630,5710,2630,0,47.5342,-121.876
795000,4,3.25,3520,5250,3520,0,47.6869,-122.019
384950,4,2.5,2380,4913,2380,0,47.3607,-122.038
500000,3,1.75,1410,1197,1410,0,47.6558,-122.348
640000,4,3.5,3220,5741,3220,0,47.5169,-121.886
418000,4,3.25,3266,5969,3266,0,47.2975,-122.35
799000,3,2,2550,4794,2550,0,47.6955,-122.29
552900,4,3.5,3828,18900,3828,0,47.2851,-122.277
539950,3,2.25,1670,1596,1670,0,47.5402,-122.387
524225,4,2.5,3056,11385,3056,0,47.2905,-122.264
424950,2,1.5,1000,1188,1000,0,47.6823,-122.327
560000,3,3.25,1530,1786,1200,330,47.6783,-122.366
715000,5,3,3490,6091,3490,0,47.7744,-122.225
300000,5,2.5,2760,6000,2760,0,47.5289,-122.321
405000,3,2.5,1440,2163,1440,0,47.554,-121.998
327000,3,3,1370,1001,1370,0,47.7302,-122.355
859950,6,4,3180,6551,3180,0,47.6236,-122.023
560000,4,3,2720,7570,2720,0,47.7113,-122.349
379900,3,2.5,1800,2792,1800,0,47.5442,-122.371
625000,3,2.5,3220,6409,3220,0,47.4815,-122.127
398096,3,2.5,2370,5321,2370,0,47.37,-122.019
315000,3,2.5,1410,1325,1180,230,47.5582,-122.363
939000,4,3.5,3640,6049,3640,0,47.7049,-122.125
674000,3,2.5,1920,3624,1920,0,47.6647,-122.087
306000,4,2.5,2267,3577,2267,0,47.3384,-122.18
2.321E+06,5,4.75,5780,17004,4260,1520,47.5802,-122.212
394950,2,1,1131,1304,1131,0,47.6912,-122.313
914154,3,3.5,2940,6431,2940,0,47.5818,-122.047
496000,3,2.5,2180,4533,2180,0,47.754,-122.215
430100,3,2.25,1400,1078,940,460,47.5701,-122.288
449990,4,2.5,2680,5539,2680,0,47.4759,-121.734
502000,4,2.5,2680,5539,2680,0,47.4759,-121.734
310000,3,2.5,1300,3612,1300,0,47.5328,-122.282
349950,4,3.5,2796,3520,2796,0,47.3427,-122.278
625000,2,1.75,1460,1500,1000,460,47.6853,-122.356
1.05471E+06,4,3.5,4210,6481,3260,950,47.5765,-122.072
680000,4,2.75,2330,3920,2330,0,47.5525,-121.99
828950,4,3.5,3930,5680,2820,1110,47.5528,-122.076
274950,3,2.5,1608,4000,1608,0,47.2582,-122.198
293000,2,2.25,1610,1968,1610,0,47.5184,-122.196
795000,4,3.5,3200,3250,2670,530,47.5515,-122
282900,4,2.5,1710,3500,1710,0,47.3448,-122.217
909950,5,3.75,3050,8972,3050,0,47.6819,-122.172
922755,4,3.5,3560,4951,3560,0,47.6178,-122.055
424000,4,2.5,2650,8685,2650,0,47.344,-122.269
630000,3,2.5,3490,12410,2590,900,47.4714,-122.071
810000,4,3.25,4140,46173,4140,0,47.7647,-122.213
256703,3,2,1670,4441,1670,0,47.1948,-121.975
386380,3,2.5,1720,3600,1720,0,47.6856,-122.013
485000,2,2,1510,3961,1510,0,47.709,-122.018
275000,3,2.25,1450,4040,1450,0,47.3665,-122.022
370000,4,2.5,1812,5026,1812,0,47.4513,-122.202
499950,2,2.25,1060,1208,940,120,47.6371,-122.327
502000,3,2.5,1600,3073,1600,0,47.5934,-122.298
654000,3,3.25,1530,1565,1280,250,47.6179,-122.312
575000,4,2.25,2070,1230,1500,570,47.5775,-122.41
500000,4,2.5,3630,7482,3630,0,47.4565,-122.287
554000,3,2.5,2140,4126,1960,180,47.5368,-122.073
360000,4,1.75,2010,12188,1150,860,47.5013,-122.147
619990,4,2.75,2630,4501,2630,0,47.7748,-122.244
317500,4,2.5,2233,6025,2233,0,47.2599,-122.256
564950,4,2.75,2990,4521,2990,0,47.7401,-122.226
545000,2,1.25,1240,2150,1240,0,47.6884,-122.374
333700,3,2.5,2230,5050,2230,0,47.3359,-122.055
1.48E+06,3,3.25,3700,2264,2280,1420,47.6653,-122.205
530000,4,3,2290,5105,2290,0,47.7727,-122.237
396000,2,1.5,950,865,950,0,47.6714,-122.382
305000,2,1.75,1120,758,1120,0,47.5325,-122.072
380000,5,3.5,2420,4670,2420,0,47.5241,-122.285
305000,4,2.5,1714,3250,1714,0,47.429,-122.189
440000,4,2.5,2230,5650,2230,0,47.5073,-122.168
459000,4,3,2530,10000,2530,0,47.431,-122.335
530000,3,3.5,1550,1233,1160,390,47.6034,-122.309
600000,4,2.75,3110,11225,3110,0,47.4865,-122.143
515000,3,3,2100,2409,1660,440,47.5973,-122.298
275000,4,2.5,2150,3721,2150,0,47.3363,-122.215
540000,3,1.75,1630,1404,1020,610,47.6646,-122.367
445000,3,2.5,2230,7934,2230,0,47.5439,-121.88
285000,3,2.5,1320,955,1320,0,47.5202,-122.357
480000,3,2.5,1590,1431,1060,530,47.5893,-122.309
440000,5,3.25,2610,3642,2080,530,47.535,-122.284
287450,3,2.5,1440,2500,1440,0,47.5123,-122.358
507950,4,2.5,2630,6283,2630,0,47.5079,-122.158
750000,3,3.5,3390,10078,3040,350,47.537,-122.185
425000,3,1.5,1400,1022,1400,0,47.6989,-122.317
420000,3,3.5,1900,2133,1520,380,47.5675,-122.369
394950,3,2.5,1350,1250,1270,80,47.5491,-122.387
635000,4,3.25,3420,6752,3030,390,47.517,-121.876
513000,3,2.5,2150,161607,1330,820,47.4178,-121.937
380000,4,2.5,2110,5306,2110,0,47.356,-122.057
1.13E+06,4,3.25,3810,8519,2680,1130,47.699,-122.207
540000,5,3,2870,4369,2090,780,47.7449,-122.192
352499,2,2.25,1240,705,1150,90,47.5321,-122.073
603000,4,3.5,3610,6345,2370,1240,47.4283,-122.102
685000,4,2.5,2310,5100,2310,0,47.7039,-122.36
330675,4,3,1930,3031,1200,730,47.7457,-121.985
275000,3,3,1390,1080,1140,250,47.5323,-122.281
259950,3,2.5,1578,7340,1578,0,47.3771,-122.186
441000,3,2,1720,15000,1720,0,47.6927,-121.92
1.135E+06,5,3.75,4700,11237,2930,1770,47.6624,-122.197
590000,3,3.5,1970,5079,1680,290,47.5816,-122.296
497000,3,2.25,1460,1353,1050,410,47.5774,-122.412
345500,3,2.5,1930,4000,1930,0,47.3518,-122.275
562500,3,2.25,1300,907,1000,300,47.6371,-122.327
355000,3,2.25,1445,1087,1300,145,47.5339,-122.067
345000,2,2.25,860,696,860,0,47.5663,-122.29
478000,3,2.5,3040,4535,3040,0,47.51,-122.185
391500,3,2.5,2424,6143,2424,0,47.3512,-122.135
265000,2,1.5,1084,3427,1084,0,47.7117,-122.326
395000,3,2.5,2510,5320,2510,0,47.5374,-122.357
286308,2,1.5,1220,1036,1220,0,47.7348,-122.347
370000,2,2.25,1280,835,1080,200,47.5592,-122.284
1.079E+06,5,3.5,3740,5610,2860,880,47.6764,-122.392
298900,3,2.5,1852,4000,1852,0,47.3451,-122.209
775000,4,2.5,2580,5787,2580,0,47.5416,-121.994
790000,4,3.5,3190,31450,3190,0,47.501,-121.902
1.05E+06,3,2.5,3400,5119,2300,1100,47.6843,-122.305
249000,2,1.5,1090,2686,1090,0,47.717,-122.19
348000,3,2,2360,6145,2360,0,47.3564,-122.198
358000,5,2.5,2460,5604,2460,0,47.3658,-122.037
260000,5,2.5,2025,7760,2025,0,47.2671,-122.256
765000,4,3,4410,5104,3400,1010,47.5392,-121.861
739000,3,2.5,2810,5400,2810,0,47.7065,-122.118
890000,5,3.5,4490,6000,3200,1290,47.5396,-122.073
462000,4,2.5,3070,6432,3070,0,47.4487,-122.205
380000,4,2.5,1984,32400,1564,420,47.36,-122.318
770000,5,3.5,4750,8234,3350,1400,47.3574,-122.318
641000,4,3.25,2760,4104,1900,860,47.5286,-122.187
2.3E+06,4,4,4360,8175,3940,420,47.5724,-122.104
369000,4,2.5,3060,27251,3060,0,47.1967,-121.966
1.112E+06,4,3,2770,2650,2180,590,47.6435,-122.354
357000,5,2.5,2990,9240,2990,0,47.7384,-122.348
650000,3,2.75,1540,1251,1230,310,47.6298,-122.321
563500,3,2.5,1400,1312,1400,0,47.6534,-122.355
345000,3,2.5,1680,2229,1680,0,47.7484,-122.322
479950,3,2,2260,7163,2260,0,47.4593,-122.136
660000,4,3.5,3400,5196,3400,0,47.5169,-121.884
800000,4,2.5,2930,5000,2760,170,47.5424,-122.12
253101,3,2,1239,6036,1239,0,47.3689,-122.175
555000,3,3.5,2100,2479,1450,650,47.562,-122.292
240000,4,1,1200,2171,1200,0,47.7076,-122.342
380000,4,1,1200,2171,1200,0,47.7076,-122.342
239000,2,1.5,680,772,680,0,47.695,-122.343
760000,4,3.25,2690,3995,2060,630,47.532,-122.384
430000,4,2.5,2750,7200,2750,0,47.7327,-121.966
660000,3,2.5,2450,4332,2450,0,47.6942,-122.016
399963,4,2.5,2620,4050,2620,0,47.5017,-122.34
411000,2,2,1130,1148,800,330,47.6023,-122.314
483453,4,2.75,2790,5527,2790,0,47.4827,-121.773
469950,3,2,1820,1357,1820,0,47.5432,-122.376
504058,4,2.75,2910,7467,2910,0,47.4841,-121.772
425996,4,2.5,2568,5000,2568,0,47.2596,-122.194
760005,4,2.75,3090,5859,3090,0,47.6057,-122.047
699999,2,2,1460,1085,950,510,47.6205,-122.299
749950,3,2.5,2010,2263,1340,670,47.6088,-122.311
674600,4,2.5,2610,5140,2610,0,47.6951,-122.346
450000,2,1.5,960,1000,920,40,47.6489,-122.335
272000,3,2.5,1528,7616,1528,0,47.3774,-122.186
450000,2,1.5,1310,1264,1120,190,47.5772,-122.409
643950,3,2.25,1760,2122,1760,0,47.5633,-122.385
290000,3,2.5,1420,3542,1310,110,47.7731,-122.343
378000,3,2.5,1650,2082,1650,0,47.7108,-122.332
728050,3,2.5,2320,6775,2320,0,47.7158,-122.016
499160,4,2.5,2628,11466,2628,0,47.2904,-122.264
536000,4,2.5,2520,4831,2520,0,47.7711,-122.168
419900,5,3.5,2880,5000,2260,620,47.3455,-122.023
469000,3,2.25,1440,1362,1440,0,47.6908,-122.365
374000,3,2.5,2185,6042,2185,0,47.3573,-122.202
182568,4,1.5,1500,2106,1500,0,47.5669,-122.297
334888,3,2.5,1769,7324,1769,0,47.3307,-122.188
799900,4,4,3650,18223,3330,320,47.5442,-122.116
383000,4,2.5,2160,6223,2160,0,47.3494,-122.042
580000,3,2.5,1820,374616,1820,0,47.6539,-121.959
351999,3,2.5,2370,4200,2370,0,47.3706,-122.017
1.325E+06,3,3,3180,2758,2240,940,47.6377,-122.342
312000,3,2.5,1780,4077,1780,0,47.3568,-122.056
674950,4,3.5,2650,3127,2230,420,47.5381,-122.046
1.105E+06,5,2.75,3300,7560,3300,0,47.6467,-122.118
415000,2,2.5,1160,1219,1160,0,47.6543,-122.358
1.25E+06,3,3,3460,5353,2850,610,47.5858,-122.393
208800,3,2.5,1390,2450,1390,0,47.5298,-122.269
452000,2,2.5,1260,1131,1260,0,47.6715,-122.384
837000,5,2.75,2940,5225,2760,180,47.6879,-122.107
780000,5,3.5,3190,4247,2430,760,47.7016,-122.103
1.485E+06,4,3.5,3930,6120,3310,620,47.6646,-122.28
1.6E+06,5,3.75,3570,10125,3570,0,47.5639,-122.223
369946,3,2.5,2420,4725,2420,0,47.371,-122.018
530000,3,2.75,3400,7200,2470,930,47.4878,-122.191
386000,4,2.5,2478,6079,2478,0,47.3524,-122.175
1.9E+06,4,2.5,3070,7830,1970,1100,47.593,-122.291
735000,4,3.5,3200,7605,2500,700,47.3443,-122.327
1.75E+06,5,3.25,5790,12739,4430,1360,47.538,-122.114
489950,3,2.25,1590,926,1590,0,47.5402,-122.387
357500,3,3,1730,1442,1440,290,47.5344,-122.348
329995,4,2.5,2303,3680,2303,0,47.2599,-122.283
414000,3,2.5,1790,3754,1790,0,47.534,-121.841
533500,3,3.5,2490,3517,1720,770,47.5341,-122.067
402395,4,2.5,2669,5385,2669,0,47.3262,-122.165
725000,4,3.25,2610,2552,2160,450,47.5322,-122.076
1.275E+06,6,5.25,6160,27490,4040,2120,47.6094,-122.023
239800,2,1.75,1290,1493,1290,0,47.5171,-122.346
616950,5,3.5,3560,5008,2810,750,47.5542,-122.359
1.258E+06,4,3.25,4360,6000,3400,960,47.5408,-121.994
435000,3,2.25,1230,1238,1080,150,47.6519,-122.384
925000,4,3.25,3640,60086,3640,0,47.6328,-122.016
631500,2,2.5,1780,2493,1780,0,47.6704,-122.358
399995,3,1.5,1140,1069,1140,0,47.6907,-122.342
369950,3,2,1270,1320,1270,0,47.6937,-122.342
475000,5,3.5,2780,3583,2180,600,47.4879,-122.152
353000,4,2.5,1912,5000,1912,0,47.3511,-122.275
329950,4,2.5,2300,9690,2300,0,47.2793,-122.352
367000,3,2.5,2828,4050,2828,0,47.382,-122.197
447500,4,2.5,2425,9017,2425,0,47.3003,-122.263
595000,4,3.25,3730,4560,2760,970,47.6725,-122.33
325000,1,1,730,1942,730,0,47.5943,-122.299
690000,2,2.5,1990,1756,1780,210,47.6264,-122.323
329950,3,2.5,1300,812,880,420,47.5893,-122.317
399500,4,2.5,2560,7492,2560,0,47.4467,-122.287
555000,5,2.5,2450,5047,2450,0,47.7724,-122.168
427000,2,1.5,1440,725,1100,340,47.5607,-122.378
375000,3,2.25,1140,1557,1140,0,47.6947,-122.342
499000,2,1.5,1110,957,930,180,47.6319,-122.362
750000,3,2.5,2620,43832,2620,0,47.655,-122.009
336900,3,2.5,1690,1200,1410,280,47.5388,-122.367
555000,2,2.75,1950,1610,1950,0,47.5925,-122.302
1.275E+06,4,3.5,3530,8126,3530,0,47.6847,-122.2
999950,4,3.5,3310,4684,2290,1020,47.579,-122.389
975000,5,3,2620,5477,2620,0,47.6804,-122.288
299000,3,2.25,1350,3582,1350,0,47.4214,-122.191
479000,2,2.5,1741,1439,1446,295,47.7043,-122.209
428000,3,2.5,1650,2201,1650,0,47.7108,-122.333
409000,3,2.5,1890,6500,1890,0,47.6225,-122.058
798500,3,3,1950,1833,1610,340,47.6078,-122.202
689000,4,3.5,4490,5805,3390,1100,47.5389,-121.86
375000,6,2.25,3206,5793,3206,0,47.369,-122.287
775000,4,3.5,4130,77832,4130,0,47.3229,-122.045
639983,5,3,2800,5700,2800,0,47.4969,-122.145
300000,4,3,1984,4419,1984,0,47.3514,-122.213
627000,4,2.5,2750,11830,2750,0,47.4698,-122.121
275000,3,2.75,1740,5757,1740,0,47.1941,-121.979
352800,4,2.25,1800,2752,1800,0,47.5167,-122.346
565000,3,2.25,1540,1005,1540,0,47.6828,-122.346
765000,4,2.25,2030,2222,1610,420,47.679,-122.375
644000,4,2.5,3310,4839,3310,0,47.773,-122.161
461000,3,1.5,1270,1416,1270,0,47.6988,-122.317
270500,5,2.5,2406,7093,2406,0,47.2615,-122.252
640000,2,2.25,1540,965,1540,0,47.6181,-122.318
457000,4,2.5,2820,6983,2820,0,47.2958,-122.265
355000,5,2.5,2540,5100,2540,0,47.5123,-122.316
356000,2,2.25,1230,989,1230,0,47.6975,-122.348
425000,4,2.5,1900,2766,1900,0,47.543,-122.368
562500,5,2.75,2920,6327,2920,0,47.4935,-122.145
460000,3,2.5,1450,1053,940,510,47.6754,-122.374
790000,4,3,5370,69848,3500,1870,47.3166,-122.046
401000,3,2,1270,1333,1270,0,47.6933,-122.342
1.095E+06,3,2.5,2550,5100,2550,0,47.6757,-122.326
850000,4,3,3070,7150,3070,0,47.7079,-122.107
274500,3,2.25,1450,4050,1450,0,47.367,-122.019
1.94E+06,5,3.5,4230,16526,4230,0,47.5933,-122.199
808000,4,2.5,3480,6262,3480,0,47.6857,-122.045
312000,3,2.25,1490,974,1220,270,47.5567,-122.363
320000,3,2.25,1200,1400,1200,0,47.7046,-122.357
410000,3,2.5,2150,4332,2150,0,47.7373,-121.969
725000,3,3.5,3690,8837,3690,0,47.5402,-121.876
335000,4,2.5,1900,3301,1900,0,47.489,-122.249
519990,4,3.25,1690,1321,1320,370,47.678,-122.117
533112,4,2.75,2790,8853,2790,0,47.4842,-121.772
274900,3,2,1936,6612,1936,0,47.2602,-122.246
325000,2,2.25,1150,711,1150,0,47.5323,-122.07
350000,4,2.5,2040,22653,2040,0,47.4991,-122.299
550000,4,2.5,2470,7539,2470,0,47.7407,-122.226
311850,4,2.5,1890,4158,1890,0,47.343,-122.056
526000,3,2.5,1626,1583,1419,207,47.6031,-122.309
375000,4,2.5,2250,5306,2250,0,47.356,-122.057
299999,3,2.25,1350,1234,1160,190,47.5565,-122.363
436000,3,2.5,1460,1238,1200,260,47.6719,-122.374
303000,3,2.5,2056,3564,2056,0,47.338,-122.181
525000,2,2.5,1160,1458,1040,120,47.6384,-122.373
575000,3,3,1384,1287,1144,240,47.6295,-122.32
420000,2,1.5,1100,1107,1100,0,47.6584,-122.35
329950,3,2.5,2456,7566,2456,0,47.297,-122.351
1.83E+06,4,4.25,4500,215186,2630,1870,47.559,-122.045
1.175E+06,4,3.25,3780,10099,2240,1540,47.5508,-122.192
499950,2,2.5,1320,1157,990,330,47.6689,-122.363
1.149E+06,4,3,5940,11533,4950,990,47.5443,-121.87
400000,3,2,1650,5027,1650,0,47.515,-121.874
246950,3,3,1670,4440,1670,0,47.1948,-121.975
630000,3,3.25,1610,1275,1220,390,47.6236,-122.318
561000,5,2.75,3370,10315,3370,0,47.4893,-122.146
287000,4,2.5,2660,4082,2660,0,47.3414,-122.055
600000,3,3.25,1690,1473,1380,310,47.6397,-122.345
490000,3,2.25,1620,1062,1620,0,47.6051,-122.304
330000,3,1.75,1300,958,840,460,47.5677,-122.314
286950,4,2.5,1610,4052,1610,0,47.3603,-122.081
1.55E+06,3,3.25,3530,4920,2660,870,47.641,-122.357
880000,4,2.5,3550,8618,3550,0,47.6776,-122.161
577450,3,3,1730,1755,1730,0,47.6944,-122.377
405000,5,2.75,2400,4900,2400,0,47.355,-122.057
510000,3,2.5,1420,1237,1420,0,47.674,-122.387
465000,2,1.5,1220,1120,1110,110,47.6374,-122.388
1.3E+06,4,2.25,2360,4000,2360,0,47.6198,-122.289
609000,4,3.5,3990,11270,2930,1060,47.488,-122.225
336000,3,2.5,1260,1211,1260,0,47.6969,-122.343
375000,3,2.5,1580,2407,1580,0,47.5455,-122.368
294500,3,2.5,1760,2688,1760,0,47.4903,-122.166
925000,5,3.5,3420,4216,2520,900,47.6799,-122.304
730000,5,2.75,2870,6593,2870,0,47.7075,-122.102
280000,4,2.5,1934,5677,1934,0,47.2602,-122.252
500000,3,1.5,1220,962,1220,0,47.674,-122.387
605000,3,2.75,2450,5750,2450,0,47.5439,-121.862
379950,3,3.25,1860,1787,1860,0,47.7563,-122.316
605000,3,2.5,1500,1119,1110,390,47.6327,-122.346
720000,2,1.75,1570,1108,1570,0,47.6215,-122.2
549900,3,2,1280,960,1040,240,47.602,-122.311
427000,3,2.5,3192,5653,3192,0,47.2956,-122.35
492000,3,2.5,1690,1479,1420,270,47.6022,-122.311
419190,2,2.5,1590,1426,1590,0,47.5441,-122.013
650000,3,2.5,2870,7288,2870,0,47.7745,-122.225
379950,4,2.5,2580,4818,2580,0,47.3607,-122.038
269800,4,2.75,1830,3420,1830,0,47.366,-122.308
407000,4,2.5,2927,6000,2927,0,47.3737,-122.16
580000,3,1.5,1320,1250,1320,0,47.6536,-122.341
389700,3,2.5,1720,3581,1720,0,47.6861,-122.013
110000,2,1,828,4524,828,0,47.2655,-122.244
230000,3,1.5,1040,1264,900,140,47.5951,-122.301
533380,4,2.75,2790,6685,2790,0,47.4838,-121.773
295500,3,2.5,1410,1332,960,450,47.5683,-122.314
860000,4,4.5,4040,8400,3220,820,47.7067,-122.131
812000,4,3.5,3370,3634,2750,620,47.5519,-122.001
324500,3,2.5,1660,3990,1660,0,47.5298,-122.268
193000,2,1.75,910,2550,910,0,47.3494,-122.022
355000,3,2.25,1280,959,1280,0,47.6914,-122.343
525000,4,2.75,2360,4924,2360,0,47.7737,-122.235
370950,3,2.5,2529,9653,2529,0,47.3738,-122.161
1.242E+06,4,3.5,4700,10183,2660,2040,47.6728,-122.189
950000,3,2.5,2780,275033,2780,0,47.4496,-121.766
888990,4,2.75,3540,5500,3540,0,47.6181,-122.056
705000,3,2.5,1580,1321,1080,500,47.6688,-122.402
268000,3,2.5,1700,2250,1700,0,47.4914,-122.334
305450,3,2.5,1600,3573,1600,0,47.507,-122.181
399900,2,1.75,1410,1005,900,510,47.5446,-122.018
495000,3,1.5,1580,1228,1580,0,47.6765,-122.32
857326,3,3.5,3940,11632,3940,0,47.438,-122.344
845950,5,2.75,4450,9600,3650,800,47.7336,-122.21
303210,4,2.5,2009,5000,2009,0,47.2577,-122.198
343000,6,5,2732,7655,2732,0,47.3045,-122.211
300000,3,2.5,2090,4590,2090,0,47.3992,-122.163
334900,2,2.5,980,1013,980,0,47.6844,-122.387
477500,5,3.5,2815,5619,2815,0,47.4299,-122.207
820000,4,2.5,3170,8523,3170,0,47.6854,-122.184
580000,5,3.25,3030,7410,2150,880,47.553,-122.354
350000,2,2.5,1280,940,1060,220,47.6904,-122.364
910000,3,2.5,2030,1160,1970,60,47.6213,-122.2
414000,3,2.5,2490,4540,2490,0,47.5051,-122.155
525000,3,2.5,3030,4500,3030,0,47.4944,-122.15
650000,2,2.5,1470,690,1470,0,47.6523,-122.346
450000,3,2.25,1620,997,1540,80,47.5394,-122.027
1.27E+06,4,3,5520,8313,3570,1950,47.5655,-122.129
699000,3,3.5,3200,10344,3200,0,47.7636,-122.216
899000,4,2.5,2580,3943,2580,0,47.6853,-122.21
353500,4,3,2050,4000,2050,0,47.3523,-122.275
485000,3,2.5,2430,5867,2430,0,47.5162,-121.872
782900,4,3.25,3060,3898,2300,760,47.5311,-122.073
529000,2,2,1540,9714,1540,0,47.7628,-122.359
514700,3,3.25,1310,1072,1060,250,47.6744,-122.374
409316,3,2.5,1800,3168,1800,0,47.5342,-121.841
388598,3,2.5,2370,4200,2370,0,47.3699,-122.019
415000,3,2.25,1445,1512,1300,145,47.5341,-122.069
521500,3,2.25,1450,1619,1140,310,47.6076,-122.304
580000,3,2.5,1740,1236,1740,0,47.5891,-122.387
882566,4,2.5,3560,5265,3560,0,47.7047,-122.113
525000,3,2.75,2130,1400,1080,1050,47.5661,-122.29
515000,5,2.75,2980,4502,2980,0,47.7698,-122.235
589410,3,3,2840,7201,2840,0,47.5165,-121.883
757500,4,2.5,3420,6845,3420,0,47.6777,-122.156
284000,3,2.5,1660,4083,1660,0,47.3595,-122.045
338500,2,2.25,1150,711,1150,0,47.5323,-122.071
379500,3,2.25,1410,1287,1290,120,47.5344,-122.068
550000,3,2,1420,1369,1340,80,47.6472,-122.357
294900,3,2.5,1860,5025,1860,0,47.3557,-122.059
345000,2,1.5,1340,1210,1120,220,47.588,-122.305
450000,2,1.5,1530,1012,1200,330,47.602,-122.306
420000,3,2.5,1509,1114,1509,0,47.7049,-122.34
740000,3,2.5,2350,3798,2350,0,47.543,-122.01
286000,2,1.5,1010,825,1010,0,47.7124,-122.301
870000,5,3.5,4495,10079,3580,915,47.7339,-122.209
727000,3,2.5,1580,991,1580,0,47.6276,-122.359
395000,4,3,2750,7965,2750,0,47.3479,-122.028
535000,4,2.25,1890,3615,1890,0,47.5493,-121.999
255000,3,2.25,1320,963,1040,280,47.5199,-122.357
260000,4,2.5,2150,3721,2150,0,47.3363,-122.217
810000,4,2.5,3340,8384,3340,0,47.6761,-122.152
359782,3,2.5,1850,3400,1850,0,47.6871,-122.014
500000,2,2.5,1950,2162,1500,450,47.5622,-122.292
1.04999E+06,5,3.25,4240,9588,4240,0,47.6901,-122.018
810000,4,3.5,2700,2868,1920,780,47.5685,-122.286
605000,5,4,3040,6000,2280,760,47.5189,-121.876
730000,4,2.5,2460,7930,2460,0,47.6684,-122.175
327000,4,2.5,2110,3825,2110,0,47.359,-122.082
370000,2,1,780,1133,780,0,47.5924,-122.295
459000,5,3.5,2640,6895,2640,0,47.5298,-121.879
2.9E+06,5,4,5190,14600,5190,0,47.6102,-122.225
365000,4,2.5,2420,8404,2420,0,47.372,-122.13
255000,4,2.5,1987,6000,1987,0,47.2679,-122.255
375000,1,1,720,3166,720,0,47.5811,-122.389
375000,2,1.5,1130,912,1000,130,47.5638,-122.388
518380,4,2.5,2810,4500,2810,0,47.3552,-122.023
346000,3,3.25,1500,1442,1150,350,47.5592,-122.362
302059,4,2,1390,745,1390,0,47.5393,-122.026
575000,4,2.5,2500,4945,2500,0,47.5185,-121.885
549950,4,3.5,3906,9674,3906,0,47.2931,-122.264
900000,5,6,7120,40806,5480,1640,47.5451,-122.114
397500,3,2.5,1470,1256,930,540,47.6033,-122.309
1.075E+06,5,3.5,3230,7560,3230,0,47.6467,-122.118
775900,3,2.5,2700,5764,2700,0,47.5618,-122.027
510000,4,2.5,4073,17334,4073,0,47.2949,-122.27
471275,4,2.5,3361,5038,3361,0,47.3269,-122.165
288000,4,2.25,1610,3560,1610,0,47.3669,-122.02
989990,4,3.5,3830,7150,3830,0,47.7049,-122.126
300000,3,3.25,1470,1235,1180,290,47.5537,-122.313
664950,5,3,3190,7081,1890,1300,47.509,-122.24
699188,4,3.25,3250,5478,3250,0,47.5178,-121.887
390000,3,2.25,1490,4539,1490,0,47.7607,-122.233
670000,5,2.75,2900,5155,2900,0,47.5977,-122.008
487000,4,2.5,2540,5001,2540,0,47.5423,-122.302
769995,5,2.75,3360,12080,3360,0,47.7757,-122.173
321950,2,1.25,860,1277,860,0,47.5842,-122.314
613500,4,2.5,3020,6068,3020,0,47.773,-122.16
300000,3,2.5,1330,1200,1330,0,47.7034,-122.344
400950,4,2.5,2578,4554,2578,0,47.2603,-122.194
389517,4,2.5,2640,4725,2640,0,47.371,-122.017
255000,3,1.75,1260,1133,810,450,47.5261,-122.361
1.08E+06,3,2.5,1990,1891,1990,0,47.6271,-122.324
637850,5,3.25,3340,4900,2500,840,47.5193,-121.877
636230,4,2.5,2840,6284,2840,0,47.5135,-122.169
375000,3,2.5,1530,1131,1530,0,47.6993,-122.346
586500,3,2.5,1780,1487,1600,180,47.6539,-122.351
544000,4,2.5,2340,6973,1930,410,47.5451,-121.882
425000,4,2.5,2390,5021,2390,0,47.5353,-121.879
374950,4,2.5,2090,3777,2090,0,47.3595,-122.042
294570,3,1,1140,8400,1140,0,47.5022,-122.144
300000,3,2.5,1960,1477,1670,290,47.4873,-122.166
395950,5,3.5,2738,6031,2738,0,47.2962,-122.35
800000,4,2.5,3691,11088,3691,0,47.6122,-122.059
439990,3,2.5,2340,5171,2340,0,47.4832,-121.772
680000,4,3.5,2510,3763,1990,520,47.7002,-122.103
677790,6,3,2800,4213,2800,0,47.6892,-122.389
424950,3,2.5,1650,4777,1650,0,47.5336,-121.841
223990,2,2.25,1061,2884,1061,0,47.346,-122.218
498000,4,2.5,3402,14355,2846,556,47.3009,-122.385
359950,4,2.5,2542,6120,2542,0,47.3751,-122.188
720000,3,2.5,3150,151588,3150,0,47.572,-121.926
530000,4,2.5,3010,9000,3010,0,47.4987,-122.147
295000,3,2.5,1660,4898,1660,0,47.3588,-122.044
255500,3,2.5,1770,5000,1770,0,47.3358,-122.051
556000,3,3,1960,1168,1600,360,47.5445,-122.014
277950,4,2.5,1889,6000,1889,0,47.2676,-122.256
431000,4,2.5,3040,6000,3040,0,47.3473,-122.03
780000,4,2.75,3420,6787,3420,0,47.6962,-122.023
649000,3,3.25,1720,936,1030,690,47.6201,-122.309
447000,3,2.5,1740,3043,1740,0,47.744,-122.181
712198,4,2.5,2450,4247,2450,0,47.7048,-122.113
277140,3,1.5,1190,785,920,270,47.6781,-122.117
363000,4,2.5,3753,7204,3336,417,47.3011,-122.385
598992,5,3.5,3440,6037,3440,0,47.4765,-121.734
585000,3,2.5,2160,1250,1830,330,47.6515,-122.375
1.27495E+06,4,2.75,3820,8850,3820,0,47.6506,-122.195
380950,2,2,1120,1039,840,280,47.5788,-122.315
333490,4,2.5,2250,3916,2250,0,47.3413,-122.18
520000,3,3.25,1540,1487,1540,0,47.5397,-122.027
315000,2,2.25,1240,705,1150,90,47.5321,-122.073
487000,2,1.5,1160,1118,1020,140,47.6754,-122.375
424950,5,3.5,2760,3865,2760,0,47.5049,-122.17
542300,3,2.25,1580,1487,1580,0,47.6514,-122.386
320000,3,3.25,1480,1192,1180,300,47.5556,-122.363
1.13999E+06,4,3.25,3740,11467,3740,0,47.581,-122.022
425000,4,2.5,1950,5000,1950,0,47.515,-121.872
474950,3,3,1530,1568,1530,0,47.6998,-122.367
307635,3,2.5,1820,4200,1820,0,47.3693,-122.017
834538,3,2.5,2760,6187,2760,0,47.5821,-122.047
769995,5,2.75,3010,5398,3010,0,47.6067,-122.053
820875,5,3.25,3860,9387,3860,0,47.538,-121.858
595500,4,2.5,2490,6537,2490,0,47.5185,-121.884
450000,4,2.5,3236,9608,3236,0,47.3838,-122.195
695000,4,2.5,2830,14538,2830,0,47.5405,-121.882
300000,3,2,1451,7159,1451,0,47.3754,-122.163
515000,5,3.25,2910,5027,2040,870,47.5543,-122.359
545000,3,2.5,1280,1845,1280,0,47.662,-122.324
365000,3,2.25,1110,979,960,150,47.5999,-122.3
718500,4,2.75,2840,8800,2840,0,47.7029,-122.171
279800,3,1.75,1410,2052,1410,0,47.5171,-122.347
486940,4,2.5,3250,13360,3250,0,47.3524,-122.198
525000,4,2.75,3030,6625,3030,0,47.4815,-122.152
345000,4,2.5,1983,6002,1983,0,47.3281,-122.164
613000,3,3.25,2440,2812,1710,730,47.5362,-122.072
370000,3,2.5,2313,5700,2313,0,47.3572,-122.202
449500,3,2.25,1260,2556,1260,0,47.5482,-121.998
515000,3,2.5,2000,3837,2000,0,47.7713,-122.167
346100,2,1.75,1150,698,1150,0,47.5323,-122.071
398500,4,2.5,2820,6666,2820,0,47.3473,-122.031
310000,2,1.75,1160,2500,1160,0,47.6489,-121.911
250000,3,2.25,1481,2820,1481,0,47.3457,-122.217
1.88E+06,5,3.5,4390,6220,3170,1220,47.6789,-122.273
695000,2,1.75,1570,1207,1570,0,47.6215,-122.201
1.085E+06,4,3,3410,6541,2680,730,47.5416,-122.38
864327,5,3.25,3480,6507,3480,0,47.607,-122.053
749995,4,3.25,3430,9870,3430,0,47.776,-122.173
525000,5,2.75,2880,8364,2880,0,47.4893,-122.147
659950,3,2.5,2990,9413,2990,0,47.7341,-122.234
1.8E+06,5,5,4490,10279,3930,560,47.5974,-122.202
950000,5,4,4100,8120,4100,0,47.6917,-122.02
1.39995E+06,4,2.75,3870,10046,3870,0,47.6651,-122.191
265050,2,1.5,800,2119,800,0,47.554,-122.362
450000,3,2.25,1620,1057,1540,80,47.5396,-122.026
915000,4,2.5,2910,4356,2910,0,47.6705,-122.146
963000,4,3.25,3530,8589,3530,0,47.6975,-122.195
270000,4,2.5,2701,5821,2701,0,47.2873,-122.177
294000,2,2.5,1380,889,1140,240,47.5441,-122.369
700000,3,2.5,2050,4185,2050,0,47.6922,-122.371
1.065E+06,3,4,3370,8252,3370,0,47.5965,-122.013
494900,3,2.5,2040,2500,1470,570,47.573,-122.372
415000,3,2.5,1610,3600,1610,0,47.771,-122.169
459990,3,2.5,2680,5539,2680,0,47.4761,-121.734
882990,4,3.5,3560,6562,3560,0,47.5929,-121.974
620000,4,3.5,3880,8244,3060,820,47.7426,-121.976
375900,3,2,1824,7120,1824,0,47.3457,-122.27
654000,3,2.5,2220,2873,2010,210,47.5311,-122.074
1.8399E+06,4,3.25,4140,11007,4140,0,47.5707,-122.217
215000,3,2.5,1322,6006,1322,0,47.2706,-122.254
630500,3,2.5,1909,1300,1766,143,47.6538,-122.352
855000,4,3.5,3460,7702,3460,0,47.5942,-121.977
235245,4,2.5,1954,5075,1954,0,47.2606,-122.253
770000,5,2.5,3000,7912,1610,1390,47.6765,-122.175
734990,4,2.5,2650,6884,2650,0,47.6901,-122.015
880000,4,2.5,2580,3436,2580,0,47.6853,-122.21
525000,4,3,2650,4924,2650,0,47.7734,-122.238
775000,4,3.5,3390,3960,3390,0,47.5406,-121.995
687015,3,1.75,1470,873,1470,0,47.6256,-122.362
663000,3,2.5,1910,5125,1910,0,47.5481,-121.995
815000,4,2.5,3030,7187,3030,0,47.6934,-122.166
1.05E+06,4,3.25,2930,25020,2930,0,47.5514,-122.023
433190,3,2.5,1650,2787,1650,0,47.5336,-121.838
725000,4,2.5,2870,5118,2870,0,47.5544,-121.99
279950,3,2.5,1608,4800,1608,0,47.2585,-122.201
272167,2,2.5,1620,3795,1620,0,47.5321,-122.034
468500,3,2.5,1350,1186,1120,230,47.6786,-122.375
298000,3,2.5,1950,3600,1950,0,47.3658,-122.021
303500,6,4.5,3390,7200,2440,950,47.5205,-122.288
308000,3,1.75,1300,1237,1060,240,47.539,-122.026
646800,3,3,2230,1407,1850,380,47.5446,-122.017
530200,4,2.5,1880,3853,1880,0,47.5636,-122.094
405000,5,2.5,3370,5092,3370,0,47.3594,-122.036
529000,2,2.5,1320,1395,990,330,47.6689,-122.362
675900,3,2.5,2920,9096,2920,0,47.4855,-122.149
570000,3,3.25,1550,1280,1220,330,47.6493,-122.384
375500,4,2.5,2301,6452,2301,0,47.346,-122.269
445000,3,3.25,1710,1960,1360,350,47.5479,-122.003
1.1E+06,4,3.75,2890,4164,2240,650,47.676,-122.197
477000,3,2.5,2100,5060,2100,0,47.563,-122.298
450000,3,2.75,2240,3360,2100,140,47.4999,-122.232
427005,3,3,1460,1200,1460,0,47.7,-122.367
720000,3,1.75,1370,1990,1370,0,47.6434,-122.324
2.23E+06,3,3.5,3760,5634,2830,930,47.5285,-122.205
450800,4,3.25,2510,5311,2510,0,47.5028,-122.17
461100,2,2.25,1210,1267,1120,90,47.6783,-122.376
1.0616E+06,4,3,2990,6695,2990,0,47.5817,-122.047
590000,3,2.5,1710,2875,1710,0,47.5787,-122.392
478830,4,2.5,3274,4950,3274,0,47.2603,-122.195
760000,4,2.25,3300,8365,3300,0,47.5363,-122.377
1.025E+06,4,3.5,4370,10860,4370,0,47.5066,-122.148
385000,4,2.5,2050,5276,2050,0,47.491,-122.15
500000,2,2.5,1310,1500,1160,150,47.6112,-122.309
425000,3,1.5,1680,8000,1680,0,47.6923,-121.869
552100,3,3,1330,1379,1120,210,47.6126,-122.313
785000,3,3,1950,1983,1610,340,47.6078,-122.202
615000,5,3.25,3090,7069,3090,0,47.5114,-122.196
309000,3,2.5,1950,3825,1950,0,47.3588,-122.082
369500,3,2,1108,1128,1108,0,47.6961,-122.318
391000,4,2.25,2190,3850,2190,0,47.4861,-122.161
465000,3,1.75,1590,1322,1060,530,47.5753,-122.294
879950,4,2.75,3010,7215,3010,0,47.6952,-122.178
372000,3,2,1330,1042,1060,270,47.5522,-122.382
259000,3,2.5,1550,3569,1550,0,47.3528,-122.211
374000,2,1.5,1260,1575,1260,0,47.5914,-122.295
561000,4,2.5,2550,5395,2550,0,47.5355,-121.874
610000,3,2.5,1300,1331,1300,0,47.6607,-122.352
635000,3,3,2230,1407,1850,380,47.5446,-122.017
235000,1,1.5,1170,1456,1070,100,47.5493,-122.372
623300,4,3.5,4170,4524,3500,670,47.7726,-122.162
412500,3,2,1680,5246,1680,0,47.5206,-121.868
380000,4,3.25,2864,8035,2864,0,47.3746,-122.189
497000,3,2.25,1630,3817,1630,0,47.5485,-121.999
452000,4,2.5,2716,7850,2716,0,47.352,-122.197
312000,3,2.5,1750,4076,1750,0,47.3597,-122.045
469950,5,3,3223,6371,3223,0,47.3588,-122.163
775000,5,2.5,2600,4284,2600,0,47.5409,-122.39
679990,4,2.75,3320,8653,3320,0,47.7521,-122.334
288790,4,2,1350,942,1350,0,47.5401,-122.026
800000,5,2.5,3410,4726,3410,0,47.5459,-122.184
299000,3,2.5,1572,4000,1572,0,47.2615,-122.198
332000,4,2.5,2300,4482,2300,0,47.3599,-122.082
525000,1,1.5,1030,5923,1030,0,47.6653,-122.305
620000,3,1.75,1458,858,950,508,47.592,-122.293
452000,4,2.5,2190,6896,2190,0,47.5191,-121.869
630000,4,3,3640,5096,2740,900,47.5428,-122.27
485000,4,2.75,2790,7803,2790,0,47.4823,-121.772
349950,4,2.5,2632,4117,2632,0,47.3428,-122.278
499990,4,2.75,2910,6334,2910,0,47.4826,-121.771
510000,2,2.25,1470,1101,1340,130,47.6768,-122.301
1.08E+06,3,2.5,2240,21477,2240,0,47.5745,-122.18
494000,3,2.5,2310,4729,2310,0,47.7734,-122.237
429900,3,2.5,2370,5353,2370,0,47.7333,-121.975
505000,4,2.75,2980,9825,1910,1070,47.5073,-122.172
272000,4,2,1870,6551,1870,0,47.1934,-121.977
671500,3,2.5,1770,1714,1770,0,47.6532,-122.348
729950,4,3.5,3510,10010,3510,0,47.5412,-121.876
471835,4,2.5,3281,5354,3281,0,47.3273,-122.163
249950,3,2,1670,4438,1670,0,47.1948,-121.974
424950,5,3.5,2760,3846,2760,0,47.5047,-122.17
1.24E+06,5,3.5,5430,10327,4010,1420,47.5476,-122.116
440000,4,2.5,2990,7928,2990,0,47.3139,-122.024
495000,4,3.5,3170,3858,2530,640,47.5049,-122.155
870000,4,2.5,3520,6773,2650,870,47.5317,-122.391
559000,2,3,1650,960,1350,300,47.6611,-122.346
495000,4,2.75,2656,21195,2656,0,47.3162,-122.272
722000,3,2.5,2230,4850,2230,0,47.7295,-122.334
567500,3,2.5,2280,2502,1880,400,47.5364,-122.073
440000,4,2.5,2798,5085,2798,0,47.3308,-122.187
400000,4,2.5,2398,5988,2398,0,47.452,-122.204
459995,4,2.5,2350,3760,2350,0,47.4786,-122.123
365000,5,2.75,2410,5003,1410,1000,47.5298,-122.274
389950,3,2.25,1580,920,1580,0,47.5578,-122.363
320000,3,3.25,1450,1387,1180,270,47.5556,-122.362
415500,4,2.5,1750,4779,1750,0,47.7608,-122.232
775000,3,2.5,3020,4120,2360,660,47.5714,-122.373
590000,3,3,1740,1100,1740,0,47.67,-122.391
950000,2,2.25,2200,2043,1760,440,47.6213,-122.2
378950,4,2.5,1867,15314,1867,0,47.3524,-122.198
441750,2,1.5,1020,1060,1020,0,47.6801,-122.348
335900,4,2.75,2475,4000,2475,0,47.345,-122.209
229800,2,1.75,1110,1773,1110,0,47.5647,-122.293
645000,3,2.5,1900,1258,1700,200,47.6465,-122.358
448000,3,3.25,1560,1345,1260,300,47.5637,-122.375
706000,4,2.5,2510,5436,2510,0,47.6894,-122.016
988990,4,4.75,4150,6303,4150,0,47.7047,-122.123
716000,3,3,1660,1849,1660,0,47.6649,-122.353
319000,2,1.5,1090,847,1090,0,47.7235,-122.352
300000,4,2.5,1914,3272,1914,0,47.4297,-122.189
625000,4,3.25,2730,54014,1560,1170,47.5133,-122.11
773000,3,2.75,2470,3600,2470,0,47.5406,-121.994
392000,5,2.5,2340,5670,2340,0,47.4913,-122.152
549995,4,3.5,2660,5690,1920,740,47.4775,-122.122
480000,3,2.5,2410,4656,2410,0,47.5203,-121.874
355000,3,2.25,1430,4777,1430,0,47.4867,-122.152
208400,2,2.5,1570,1268,1570,0,47.534,-122.365
831548,5,2.75,3010,4919,3010,0,47.6067,-122.052
279500,4,2.5,1613,4338,1613,0,47.3859,-122.162
445000,3,2.5,2380,5269,2380,0,47.5066,-122.192
492500,5,2.5,2570,9962,2570,0,47.7275,-121.957
435000,4,2.5,2550,5200,2550,0,47.4919,-122.153
325000,3,2.25,1330,969,1330,0,47.7177,-122.292
453000,2,1.5,1160,1269,970,190,47.6608,-122.335
612995,5,3.5,3240,6919,2760,480,47.4779,-122.122
540000,4,2.5,2710,9248,2710,0,47.5164,-121.875
465000,3,1,1150,18200,1150,0,47.4262,-122.187
799950,3,2.25,1860,1386,1860,0,47.6368,-122.279
495000,3,2.25,1280,1517,1080,200,47.6651,-122.368
579950,3,2.5,1810,1585,1810,0,47.6957,-122.376
331000,2,2.25,1240,720,1150,90,47.5322,-122.072
580000,4,3.5,1460,951,1460,0,47.6821,-122.326
669000,2,2.5,1640,1953,1640,0,47.5639,-122.292
2.35196E+06,4,4.25,5010,19412,4000,1010,47.5455,-122.211
539900,3,3.25,1300,1325,1080,220,47.6584,-122.346
490000,4,2.5,2510,4349,2510,0,47.4927,-122.147
627000,3,3.5,2710,3475,1650,1060,47.5359,-122.072
458000,4,3.5,3217,4000,2587,630,47.4483,-122.203
440000,3,2.5,1650,4929,1520,130,47.5634,-122.298
1.698E+06,4,3.5,3950,6240,3950,0,47.6221,-122.29
935000,2,2.5,1680,977,1680,0,47.632,-122.361
641000,5,3.5,3420,6403,2700,720,47.5162,-121.874
452000,3,2.75,2300,5090,1700,600,47.545,-122.36
625000,4,2.75,3010,6854,2570,440,47.5171,-121.876
1.35E+06,4,3.5,4680,12495,3040,1640,47.6984,-122.206
834950,5,3.5,3630,4911,2790,840,47.718,-122.156
1.5E+06,3,3.5,3530,3610,2370,1160,47.6857,-122.339
305000,4,2.5,2280,3800,2280,0,47.3586,-122.036
659000,3,2.5,3090,384634,3090,0,47.7072,-121.927
353000,1,1,550,1279,550,0,47.616,-122.314
535000,4,3.25,2840,4000,2330,510,47.5529,-122.293
999000,4,2.5,3130,10849,3130,0,47.6828,-122.186
375000,3,2.5,1440,1102,1440,0,47.6995,-122.346
685000,4,3.5,2840,4637,2840,0,47.7033,-122.321
333000,4,2.5,2623,7184,2623,0,47.259,-122.202
245000,1,1,390,2000,390,0,47.6938,-122.347
1.99995E+06,4,3.25,5640,35006,4900,740,47.5491,-122.104
329950,2,2.25,1260,1032,1170,90,47.5323,-122.072
403000,2,1,894,1552,894,0,47.6911,-122.313
559630,4,2.5,3370,4934,3370,0,47.3562,-122.022
344000,3,2.25,1250,871,1250,0,47.6907,-122.343
435000,3,1.5,1180,1231,1180,0,47.6845,-122.315
430000,2,2.5,1520,1588,1240,280,47.5825,-122.313
417000,3,2.5,2000,4500,2000,0,47.4937,-122.149
895950,5,2.75,3180,9255,3180,0,47.6232,-122.023
563950,4,2.75,3050,4750,3050,0,47.4857,-122.153
332220,3,1.5,2580,47480,1360,1220,47.5333,-121.933
1.488E+06,5,6,6880,279968,4070,2810,47.4624,-121.779
680000,3,2.5,2570,3600,2570,0,47.5412,-121.994
825750,4,3.5,2950,3737,2270,680,47.5313,-122.074
338000,3,2.5,1690,1760,1410,280,47.5387,-122.367
535365,4,2.75,2790,6969,2790,0,47.4836,-121.769
608000,3,2.25,1720,5234,1240,480,47.5547,-122.278
930000,3,2.25,2890,5000,2890,0,47.6983,-122.389
565000,2,1.75,1130,276170,1130,0,47.2673,-122.027
495000,2,2.25,1460,1623,1260,200,47.6764,-122.301
667000,3,2.5,2510,3819,2510,0,47.6987,-122.096
495000,4,2.5,3390,7870,3390,0,47.4536,-122.274
928990,4,2.5,3570,6054,3570,0,47.7053,-122.126
345000,4,2.5,2280,5000,2280,0,47.3593,-122.037
1.065E+06,5,3.5,2920,3000,2260,660,47.6846,-122.349
519995,4,3,2590,6160,2590,0,47.4784,-122.122
924000,5,2.75,3210,8001,3210,0,47.5935,-122.061
295000,3,2,1230,3405,1230,0,47.438,-122.179
472000,3,2.5,3800,104979,3210,590,47.4304,-121.841
405000,3,2.5,1500,2314,1500,0,47.5537,-121.998
410000,4,2.25,2510,4090,1840,670,47.7345,-121.967
419500,3,1.5,1400,1091,1400,0,47.6989,-122.317
382000,3,2.25,1450,4667,1450,0,47.7611,-122.233
370000,2,2.5,1390,1821,1180,210,47.5537,-122.282
553000,3,2.75,3160,9072,3160,0,47.5147,-122.177
2.065E+06,4,3.75,4350,7965,4350,0,47.6289,-122.205
455950,4,2.5,2720,5771,2720,0,47.4917,-122.17
331000,3,3.25,1290,1153,1290,0,47.6904,-122.346
417250,3,2.25,1606,1452,1606,0,47.7175,-122.284
490000,5,3.5,4460,2975,3280,1180,47.6313,-122.37
325000,4,3.25,2800,5291,2800,0,47.1937,-121.977
705000,5,3.5,3250,4800,2410,840,47.5618,-122.362
1.17466E+06,6,3.5,4310,7760,3260,1050,47.5297,-122.155
365000,3,2.25,1310,915,1060,250,47.5738,-122.293
403000,2,1.5,1240,1101,1080,160,47.5758,-122.309
409000,3,2.5,1950,7263,1950,0,47.5194,-121.869
391000,3,2.5,1800,1120,1800,0,47.5436,-122.369
542525,4,2.5,2650,5600,2650,0,47.4786,-122.122
339950,2,1,820,681,820,0,47.6619,-122.352
499990,4,2.75,2620,7001,2620,0,47.4838,-121.769
1.765E+06,4,3.25,3980,10249,3980,0,47.5873,-122.196
608000,3,3.5,1660,2298,1260,400,47.5809,-122.403
392000,4,2.5,2130,4028,2130,0,47.5108,-122.363
320000,3,1.75,1790,66250,1790,0,47.7179,-121.403
274800,3,1.75,1410,1988,1410,0,47.5171,-122.347
325000,3,2.25,1330,1198,1080,250,47.555,-122.362
418500,4,2.5,2190,4866,2190,0,47.4907,-122.152
300000,3,2.5,2540,5050,2540,0,47.3358,-122.055
269950,3,2.5,2244,4079,2244,0,47.2606,-122.254
358000,3,2.5,2026,7611,2026,0,47.3733,-122.162
350000,3,2.5,1730,4086,1730,0,47.5016,-122.341
782000,4,3.5,3910,8095,3130,780,47.5588,-122.036
779000,3,2.5,1580,1487,1580,0,47.6276,-122.359
685000,4,2.5,2510,3479,2510,0,47.6981,-122.099
305000,2,2.25,1000,905,1000,0,47.6842,-122.387
350000,4,2.5,1660,2500,1660,0,47.5437,-122.283
775000,4,3.5,3060,4573,2410,650,47.5522,-122.001
317750,3,2.5,1980,4500,1980,0,47.3682,-122.117
438000,2,1,980,1179,980,0,47.6381,-122.375
325000,2,2.5,1050,1609,1050,0,47.5854,-122.313
830000,4,3.25,3080,4287,2230,850,47.5313,-122.076
353000,3,2.25,1900,3800,1900,0,47.4866,-122.16
460000,4,2.5,2200,6400,2200,0,47.4856,-122.156
370000,3,1.5,1360,1167,1360,0,47.6962,-122.349
330000,3,2.5,2238,7209,2238,0,47.2966,-122.353
569888,4,2.5,2590,6474,2590,0,47.5164,-122.19
353900,3,2.5,2517,3900,2517,0,47.3211,-122.182
695000,4,3.5,3510,9084,3510,0,47.5402,-121.875
288790,3,1.75,1290,1237,1060,230,47.54,-122.026
334950,5,3,2230,8642,1330,900,47.487,-122.32
869950,4,2.75,3140,7928,3140,0,47.5923,-122.058
557500,3,3.5,3350,5025,2670,680,47.5699,-122.296
389990,4,2.5,2245,4330,2245,0,47.3557,-122.063
455000,3,1.75,1420,1189,1420,0,47.6625,-122.352
598500,3,3,1560,2091,1560,0,47.6604,-122.352
750000,4,2.75,2810,5497,2810,0,47.7081,-122.116
729999,2,2.25,1630,1686,1330,300,47.6113,-122.314
299950,3,2.5,1740,4497,1740,0,47.3697,-122.117
374950,3,2.25,1390,1484,1390,0,47.6912,-122.343
386950,3,2.5,1070,1089,900,170,47.5902,-122.387
535000,5,3.25,2850,4551,2370,480,47.4916,-122.144
890000,5,3.25,4100,7578,4100,0,47.5955,-121.974
1.05E+06,4,2.5,3260,5974,2820,440,47.6772,-122.267
1.10746E+06,4,3.5,3660,4760,2840,820,47.6482,-122.409
436952,4,2.5,2708,4772,2708,0,47.3413,-122.178
365000,3,2.5,1800,2700,1800,0,47.5458,-122.369
288000,3,2.5,1150,887,1150,0,47.7072,-122.356
700000,3,2.5,2230,4006,2230,0,47.73,-122.335
800000,4,3.25,3540,159430,3540,0,47.6285,-121.899
899000,4,3.5,2490,5500,1780,710,47.5499,-122.393
465750,3,2.5,2670,4534,2670,0,47.51,-122.184
485000,2,2.5,1430,923,1410,20,47.6683,-122.355
494995,5,2.75,2670,3800,2670,0,47.4783,-122.123
255000,3,2.5,2555,5720,2555,0,47.386,-122.184
530000,3,2.5,1970,6295,1970,0,47.5158,-121.874
435000,3,2,1980,2674,1980,0,47.5524,-122.382
639000,3,2.5,2010,3300,1610,400,47.5573,-122.287
440000,3,1.5,1270,1413,1270,0,47.6989,-122.317
914500,4,2.5,3950,10856,3950,0,47.5818,-121.996
580000,3,2,1870,5300,1870,0,47.7106,-122.02
250000,1,1.5,1180,1688,1070,110,47.549,-122.372
410000,3,2.5,1420,1269,1420,0,47.6904,-122.342
531155,4,2.75,2810,5046,2810,0,47.3559,-122.022
358000,3,2.5,1400,1529,1400,0,47.5535,-121.997
425000,3,2.5,1950,5689,1950,0,47.5158,-121.873
326000,3,2.25,1930,3462,1930,0,47.7453,-121.985
650000,4,2.5,2210,4861,2210,0,47.6959,-122.364
749950,4,3.5,2630,3757,2200,430,47.5322,-122.075
239950,3,1.75,1600,4888,1600,0,47.383,-122.097
315000,3,2.5,1480,1590,1150,330,47.5302,-122.362
375000,2,2.5,750,1430,750,0,47.6093,-122.31
375000,3,1.5,1290,1213,1290,0,47.6965,-122.34
349000,3,3.25,1340,1151,1340,0,47.6904,-122.346
450000,2,1.5,1020,1049,1020,0,47.68,-122.348
669950,3,3,2330,1944,1950,380,47.5446,-122.016
504600,5,3,2360,5000,1390,970,47.6931,-122.33
400000,3,2.5,1495,936,1405,90,47.593,-122.295
1.02E+06,4,3.5,3770,8501,3770,0,47.6744,-122.196
518000,5,2.5,2890,13104,2890,0,47.7277,-121.958
535000,3,2.75,1320,1125,1320,0,47.6598,-122.348
337500,4,2.5,2330,4907,2330,0,47.359,-122.081
380000,4,2.5,3120,5001,3120,0,47.2779,-122.349
875000,5,3,2960,15152,2960,0,47.6689,-122.179
385000,3,2.25,1630,1598,1630,0,47.6904,-122.347
1.9875E+06,5,3.5,5230,8960,4450,780,47.5964,-122.201
649500,4,3,3150,6599,3150,0,47.5279,-122.199
1.05E+06,4,3.75,3280,11000,2320,960,47.6855,-122.201
249000,3,1,1030,24750,1030,0,47.3343,-122.362
525000,4,2.5,3130,5795,3130,0,47.4997,-122.151
402000,3,3.5,1240,1666,1000,240,47.5496,-122.388
1.75E+06,4,2.75,3560,8975,3560,0,47.6322,-122.209
359800,5,2.5,2170,2752,2170,0,47.5167,-122.347
330000,3,2.5,1520,3003,1520,0,47.4876,-122.153
433000,3,2.5,1270,1062,1060,210,47.6568,-122.321
1.0108E+06,4,3.25,3610,4000,2640,970,47.658,-122.396
599832,3,2.75,3230,5200,2680,550,47.519,-121.878
312891,5,3,2300,8214,2300,0,47.3052,-122.276
449000,2,2.5,1460,1296,1160,300,47.5923,-122.296
495000,3,2.5,1750,1548,1750,0,47.5532,-122.282
819995,5,2.75,3030,10335,3030,0,47.5305,-122.184
407500,3,3.5,1522,1465,1248,274,47.6922,-122.375
850000,4,3.75,3890,22000,3890,0,47.5052,-121.906
1.72E+06,5,4,4590,35046,4590,0,47.6647,-122.16
1.459E+06,4,4,4620,130208,4620,0,47.5885,-121.939
579000,4,2.75,3220,9825,3220,0,47.4863,-122.143
890776,5,2.75,3170,8093,3170,0,47.5933,-122.06
352500,2,2.5,980,1010,980,0,47.6844,-122.387
529000,3,1.75,2340,7724,2340,0,47.4593,-122.134
484000,3,2.25,1620,1425,1540,80,47.5405,-122.026
400000,3,2.5,1910,4408,1910,0,47.7634,-122.35
649950,3,2.5,2420,6847,2420,0,47.7329,-122.356
915000,3,4.5,3850,62726,3120,730,47.6735,-122.058
534950,5,2.5,3220,10572,3220,0,47.7268,-121.957
776000,4,2.5,3040,6425,3040,0,47.6788,-122.117
370000,3,1.75,1496,1423,1248,248,47.715,-122.355
610000,3,1.75,1630,1500,1630,0,47.6536,-122.354
850000,5,3.5,4200,5400,3140,1060,47.7077,-122.12
443000,3,2.5,2430,7049,2430,0,47.5399,-122.352
1.15E+06,5,4.25,4010,8252,4010,0,47.5974,-122.013
453000,3,2.5,1510,1618,1330,180,47.6515,-122.384
735000,4,3.5,2340,2810,1730,610,47.5403,-122.028
810000,2,2.75,2700,8572,2700,0,47.7236,-122.033
1.555E+06,3,3.5,4360,6240,2960,1400,47.6791,-122.354
2.23889E+06,5,6.5,7270,130017,6420,850,47.5371,-121.982
377500,3,2.5,1350,886,1270,80,47.5491,-122.387
482000,3,3.25,1380,1120,1380,0,47.6617,-122.349
600000,2,2.5,1830,1988,1530,300,47.5779,-122.409
420000,3,2.5,1470,1571,1180,290,47.5722,-122.387
480000,4,2.5,2940,9172,2940,0,47.3444,-122.269
406000,2,2,1110,1095,980,130,47.5494,-122.388
505000,4,2.5,2790,5602,2790,0,47.4959,-122.15
1.865E+06,4,3.75,3790,8797,3290,500,47.6351,-122.236
942990,4,2.5,3570,6218,3570,0,47.7046,-122.123
440000,3,2.25,1230,1097,1230,0,47.6697,-122.372
390000,3,3.25,1370,913,1100,270,47.5636,-122.388
475000,3,3.25,1380,1121,1380,0,47.6617,-122.349
420000,1,2,1070,675,880,190,47.5574,-122.284
1.40876E+06,4,4,4920,50621,4280,640,47.6575,-122.006
1.378E+06,5,3.5,5150,12230,3700,1450,47.6249,-122.09
462500,6,3,2390,4000,2390,0,47.5173,-122.286
579950,4,2.75,2460,8643,2460,0,47.4828,-122.133
861111,4,2.5,3650,7090,3650,0,47.606,-122.052
1.45E+06,4,3.5,4300,108865,4300,0,47.6258,-122.005
290000,3,2.25,1610,3764,1610,0,47.3589,-122.083
535000,4,2.5,2610,4595,2610,0,47.7728,-122.235
585000,3,2.5,1750,1381,1750,0,47.6021,-122.294
670000,3,2.5,3310,5300,2440,870,47.5178,-122.389
3E+06,4,3.75,5090,14823,4180,910,47.62,-122.207
346000,3,2,1060,1184,730,330,47.5443,-122.385
1.325E+06,4,4,4420,16526,4420,0,47.5914,-122.027
999999,3,2.5,2100,4097,2100,0,47.5983,-122.2
599000,3,1.75,1650,1180,1650,0,47.6636,-122.319
332000,4,2.5,2380,5737,2380,0,47.2815,-122.356
336750,2,2.25,1170,1011,1170,0,47.5321,-122.073
370000,4,2.5,2531,6843,2531,0,47.385,-122.189
324000,3,2.25,998,904,798,200,47.6983,-122.367
338500,3,2.25,1333,1470,1333,0,47.7058,-122.302
1.88158E+06,5,3.5,4410,13000,2920,1490,47.5382,-122.111
402723,3,2.75,1160,1073,880,280,47.5788,-122.315
715000,4,3.25,2630,7770,2630,0,47.5459,-122.377
459000,3,1.5,1160,1031,1160,0,47.6538,-122.357
589999,3,2.5,2140,3628,1960,180,47.537,-122.074
405000,4,2.5,1980,5020,1980,0,47.5147,-122.19
509900,3,2.5,3030,9053,3030,0,47.4945,-122.149
327000,2,2,1490,1627,1190,300,47.5455,-122.375
1.057E+06,2,1.5,2370,184231,2370,0,47.4543,-121.778
327500,3,2.5,1820,1866,1570,250,47.4643,-122.346
249000,3,2,1260,1125,810,450,47.5262,-122.361
1.375E+06,5,4.5,4350,13405,4350,0,47.6018,-122.06
516500,1,1.25,1100,638,1100,0,47.6228,-122.307
465000,3,2.5,2050,15035,2050,0,47.3619,-122.122
388000,3,2.5,2198,6222,2198,0,47.3906,-122.304
549000,3,2.25,1230,1380,1230,0,47.6521,-122.4
553000,2,2,1400,1512,940,460,47.6719,-122.392
530000,3,2.5,1410,1250,1140,270,47.6515,-122.375
747450,3,2.5,2110,1339,1410,700,47.6088,-122.311
305000,2,2.5,1590,2656,1220,370,47.5489,-122.364
540000,5,2.5,3370,4850,3370,0,47.5078,-122.169
750000,5,4,4500,8130,4500,0,47.4832,-122.145
422000,4,2.5,2930,5973,2930,0,47.3846,-122.186
337000,4,2.5,2470,5100,2470,0,47.3622,-122.041
579950,5,2.75,3080,5752,3080,0,47.4922,-122.153
341780,4,2.75,2260,4440,2260,0,47.3507,-122.291
710200,4,3,1670,2642,1350,320,47.6397,-122.345
690000,3,3.25,1540,1428,1540,0,47.6648,-122.353
1.7E+06,4,3.5,3830,8963,3120,710,47.599,-122.197
329000,2,2.5,980,1020,980,0,47.6844,-122.387
330000,3,2.5,1450,5008,840,610,47.5435,-122.357
608500,4,3.5,2850,5577,1950,900,47.5252,-122.192
230000,3,1.75,1140,1201,1140,0,47.5637,-122.295
785000,4,3.5,3070,4684,2190,880,47.5316,-122.076
610950,3,3,1680,1570,1680,0,47.6572,-122.346
399950,3,2.5,3087,5002,3087,0,47.2974,-122.349
3.567E+06,5,4.5,4850,10584,3540,1310,47.5943,-122.11
579000,4,3.25,1900,2631,1250,650,47.5869,-122.311
362500,2,1.5,940,1768,940,0,47.5925,-122.295
645000,3,3.25,1730,1229,1320,410,47.6374,-122.369
594866,3,3,2780,6000,2780,0,47.5184,-121.886
625000,3,3,2780,6000,2780,0,47.5184,-121.886
490000,3,2.25,1500,1290,1220,280,47.6785,-122.375
399950,2,1,710,1157,710,0,47.6413,-122.329
380000,3,2.5,1260,900,940,320,47.5621,-122.384
270000,3,2.5,1870,5000,1870,0,47.3339,-122.055
505000,2,2.5,1430,1201,1430,0,47.6707,-122.381
385000,3,2.5,1520,1488,1520,0,47.7337,-122.309
414500,2,1.5,1210,1278,1020,190,47.6756,-122.375
347500,3,2.5,2540,4760,2540,0,47.3452,-122.022
1.2225E+06,4,3.5,4910,9444,3110,1800,47.6502,-122.066
572000,4,2.75,2770,3852,2770,0,47.5001,-122.232
475000,3,2.25,1190,1200,1190,0,47.6542,-122.346
1.088E+06,5,3.75,4170,8142,4170,0,47.5354,-122.181
350000,4,2.75,2500,5995,2500,0,47.3749,-122.107
520000,2,2.25,1530,981,1480,50,47.6533,-122.346
679950,5,2.75,3600,9437,3600,0,47.4822,-122.131
1.575E+06,4,3.25,3410,10125,3410,0,47.5653,-122.223
541800,4,2.5,3118,7866,3118,0,47.2931,-122.264
810000,4,3,3990,7838,3990,0,47.6857,-122.046
1.537E+06,5,3.75,4470,8088,4470,0,47.6321,-122.2
467000,3,2.5,1425,1179,1425,0,47.6963,-122.318
224000,3,1.75,1500,11968,1500,0,47.3095,-122.002
507250,3,2.5,2270,5536,2270,0,47.5389,-121.881
429000,3,2,1490,1126,1490,0,47.5699,-122.288
610685,4,2.5,2520,6023,2520,0,47.5137,-122.167
1.0075E+06,4,3.5,3510,7200,2600,910,47.5537,-122.398
475000,3,2.5,1310,1294,1180,130,47.5773,-122.409
360000,3,2.5,1530,1131,1530,0,47.6993,-122.346
400000,4,2.5,2310,5813,2310,0,47.5107,-122.362
402101,2,0.75,1020,1350,1020,0,47.5944,-122.299
400000,3,2.5,1600,2388,1600,0,47.5345,-122.069
325000,2,0.75,1020,1076,1020,0,47.5941,-122.299